State,Date,Pop_density,Case,Death,Cum_case,Cum_death,Order_stay,Order_mask,Unemp_num
Alabama,2020/3/1,95.00639423,0,0,0,0,No,No,1575
Alabama,2020/3/2,95.00639423,0,0,0,0,No,No,1575
Alabama,2020/3/3,95.00639423,0,0,0,0,No,No,1575
Alabama,2020/3/4,95.00639423,0,0,0,0,No,No,1663
Alabama,2020/3/5,95.00639423,0,0,0,0,No,No,1663
Alabama,2020/3/6,95.00639423,0,0,0,0,No,No,1663
Alabama,2020/3/7,95.00639423,0,0,0,0,No,No,1663
Alabama,2020/3/8,95.00639423,0,0,0,0,No,No,1663
Alabama,2020/3/9,95.00639423,0,0,0,0,No,No,1663
Alabama,2020/3/10,95.00639423,0,0,0,0,No,No,1663
Alabama,2020/3/11,95.00639423,0,0,0,0,No,No,1819
Alabama,2020/3/12,95.00639423,0,0,0,0,No,No,1819
Alabama,2020/3/13,95.00639423,6,0,6,0,No,No,1819
Alabama,2020/3/14,95.00639423,6,0,12,0,No,No,1819
Alabama,2020/3/15,95.00639423,11,0,23,0,No,No,1819
Alabama,2020/3/16,95.00639423,6,0,29,0,No,No,1819
Alabama,2020/3/17,95.00639423,10,0,39,0,No,No,1819
Alabama,2020/3/18,95.00639423,12,0,51,0,No,No,10892
Alabama,2020/3/19,95.00639423,27,0,78,0,No,No,10892
Alabama,2020/3/20,95.00639423,28,0,106,0,No,No,10892
Alabama,2020/3/21,95.00639423,25,0,131,0,No,No,10892
Alabama,2020/3/22,95.00639423,26,0,157,0,No,No,10892
Alabama,2020/3/23,95.00639423,39,0,196,0,No,No,10892
Alabama,2020/3/24,95.00639423,46,0,242,0,No,No,10892
Alabama,2020/3/25,95.00639423,144,1,386,1,No,No,80984
Alabama,2020/3/26,95.00639423,152,2,538,3,No,No,80984
Alabama,2020/3/27,95.00639423,101,1,639,4,No,No,80984
Alabama,2020/3/28,95.00639423,81,0,720,4,No,No,80984
Alabama,2020/3/29,95.00639423,110,1,830,5,No,No,80984
Alabama,2020/3/30,95.00639423,117,6,947,11,No,No,80984
Alabama,2020/3/31,95.00639423,52,3,999,14,No,No,80984
Alabama,2020/4/1,95.00639423,109,14,1108,28,No,No,106739
Alabama,2020/4/2,95.00639423,162,4,1270,32,No,No,106739
Alabama,2020/4/3,95.00639423,265,6,1535,38,No,No,106739
Alabama,2020/4/4,95.00639423,97,6,1632,44,Yes,No,106739
Alabama,2020/4/5,95.00639423,208,1,1840,45,Yes,No,106739
Alabama,2020/4/6,95.00639423,165,8,2005,53,Yes,No,106739
Alabama,2020/4/7,95.00639423,192,11,2197,64,Yes,No,106739
Alabama,2020/4/8,95.00639423,301,3,2498,67,Yes,No,77515
Alabama,2020/4/9,95.00639423,340,11,2838,78,Yes,No,77515
Alabama,2020/4/10,95.00639423,170,2,3008,80,Yes,No,77515
Alabama,2020/4/11,95.00639423,254,13,3262,93,Yes,No,77515
Alabama,2020/4/12,95.00639423,321,0,3583,93,Yes,No,77515
Alabama,2020/4/13,95.00639423,222,11,3805,104,Yes,No,77515
Alabama,2020/4/14,95.00639423,148,10,3953,114,Yes,No,77515
Alabama,2020/4/15,95.00639423,288,9,4241,123,Yes,No,66432
Alabama,2020/4/16,95.00639423,163,14,4404,137,Yes,No,66432
Alabama,2020/4/17,95.00639423,168,14,4572,151,Yes,No,66432
Alabama,2020/4/18,95.00639423,151,-4,4723,147,Yes,No,66432
Alabama,2020/4/19,95.00639423,180,13,4903,160,Yes,No,66432
Alabama,2020/4/20,95.00639423,175,4,5078,164,Yes,No,66432
Alabama,2020/4/21,95.00639423,249,22,5327,186,Yes,No,66432
Alabama,2020/4/22,95.00639423,283,15,5610,201,Yes,No,74966
Alabama,2020/4/23,95.00639423,222,-4,5832,197,Yes,No,74966
Alabama,2020/4/24,95.00639423,194,12,6026,209,Yes,No,74966
Alabama,2020/4/25,95.00639423,187,4,6213,213,Yes,No,74966
Alabama,2020/4/26,95.00639423,208,6,6421,219,Yes,No,74966
Alabama,2020/4/27,95.00639423,118,9,6539,228,Yes,No,74966
Alabama,2020/4/28,95.00639423,211,14,6750,242,Yes,No,74966
Alabama,2020/4/29,95.00639423,175,20,6925,262,Yes,No,28985
Alabama,2020/4/30,95.00639423,143,10,7068,272,Yes,No,28985
Alabama,2020/5/1,95.00639423,226,17,7294,289,No,No,28985
Alabama,2020/5/2,95.00639423,317,-1,7611,288,No,No,28985
Alabama,2020/5/3,95.00639423,277,2,7888,290,No,No,28985
Alabama,2020/5/4,95.00639423,224,8,8112,298,No,No,28985
Alabama,2020/5/5,95.00639423,325,17,8437,315,No,No,28985
Alabama,2020/5/6,95.00639423,254,28,8691,343,No,No,26666
Alabama,2020/5/7,95.00639423,355,26,9046,369,No,No,26666
Alabama,2020/5/8,95.00639423,339,14,9385,383,No,No,26666
Alabama,2020/5/9,95.00639423,283,7,9668,390,No,No,26666
Alabama,2020/5/10,95.00639423,221,3,9889,393,No,No,26666
Alabama,2020/5/11,95.00639423,275,10,10164,403,No,No,26666
Alabama,2020/5/12,95.00639423,300,32,10464,435,No,No,26666
Alabama,2020/5/13,95.00639423,236,15,10700,450,No,No,25150
Alabama,2020/5/14,95.00639423,401,23,11101,473,No,No,25150
Alabama,2020/5/15,95.00639423,272,10,11373,483,No,No,25150
Alabama,2020/5/16,95.00639423,301,2,11674,485,No,No,25150
Alabama,2020/5/17,95.00639423,97,3,11771,488,No,No,25150
Alabama,2020/5/18,95.00639423,315,1,12086,489,No,No,25150
Alabama,2020/5/19,95.00639423,290,15,12376,504,No,No,25150
Alabama,2020/5/20,95.00639423,676,18,13052,522,No,No,27919
Alabama,2020/5/21,95.00639423,362,7,13414,529,No,No,27919
Alabama,2020/5/22,95.00639423,256,12,13670,541,No,No,27919
Alabama,2020/5/23,95.00639423,479,8,14149,549,No,No,27919
Alabama,2020/5/24,95.00639423,329,2,14478,551,No,No,27919
Alabama,2020/5/25,95.00639423,508,15,14986,566,No,No,27919
Alabama,2020/5/26,95.00639423,664,14,15650,580,No,No,27919
Alabama,2020/5/27,95.00639423,382,3,16032,583,No,No,21335
Alabama,2020/5/28,95.00639423,498,8,16530,591,No,No,21335
Alabama,2020/5/29,95.00639423,501,19,17031,610,No,No,21335
Alabama,2020/5/30,95.00639423,328,8,17359,618,No,No,21335
Alabama,2020/5/31,95.00639423,593,12,17952,630,No,No,21335
Alabama,2020/6/1,95.00639423,582,16,18534,646,No,No,21335
Alabama,2020/6/2,95.00639423,237,7,18771,653,No,No,21335
Alabama,2020/6/3,95.00639423,80,0,18851,653,No,No,19949
Alabama,2020/6/4,95.00639423,221,0,19072,653,No,No,19949
Alabama,2020/6/5,95.00639423,315,23,19387,676,No,No,19949
Alabama,2020/6/6,95.00639423,656,13,20043,689,No,No,19949
Alabama,2020/6/7,95.00639423,457,3,20500,692,No,No,19949
Alabama,2020/6/8,95.00639423,425,26,20925,718,No,No,19949
Alabama,2020/6/9,95.00639423,497,11,21422,729,No,No,19949
Alabama,2020/6/10,95.00639423,567,15,21989,744,No,No,18367
Alabama,2020/6/11,95.00639423,856,11,22845,755,No,No,18367
Alabama,2020/6/12,95.00639423,865,14,23710,769,No,No,18367
Alabama,2020/6/13,95.00639423,891,4,24601,773,No,No,18367
Alabama,2020/6/14,95.00639423,1014,0,25615,773,No,No,18367
Alabama,2020/6/15,95.00639423,657,1,26272,774,No,No,18367
Alabama,2020/6/16,95.00639423,640,11,26912,785,No,No,18367
Alabama,2020/6/17,95.00639423,400,5,27312,790,No,No,18671
Alabama,2020/6/18,95.00639423,894,20,28206,810,No,No,18671
Alabama,2020/6/19,95.00639423,796,12,29002,822,No,No,18671
Alabama,2020/6/20,95.00639423,547,16,29549,838,No,No,18671
Alabama,2020/6/21,95.00639423,472,1,30021,839,No,No,18671
Alabama,2020/6/22,95.00639423,433,2,30454,841,No,No,18671
Alabama,2020/6/23,95.00639423,643,23,31097,864,No,No,18671
Alabama,2020/6/24,95.00639423,967,27,32064,891,No,No,18338
Alabama,2020/6/25,95.00639423,1142,5,33206,896,No,No,18338
Alabama,2020/6/26,95.00639423,977,11,34183,907,No,No,18338
Alabama,2020/6/27,95.00639423,900,12,35083,919,No,No,18338
Alabama,2020/6/28,95.00639423,358,0,35441,919,No,No,18338
Alabama,2020/6/29,95.00639423,1734,10,37175,929,No,No,18338
Alabama,2020/6/30,95.00639423,870,21,38045,950,No,No,18338
Alabama,2020/7/1,95.00639423,917,22,38962,972,No,No,19056
Alabama,2020/7/2,95.00639423,1149,13,40111,985,No,No,19056
Alabama,2020/7/3,95.00639423,1754,21,41865,1006,No,No,19056
Alabama,2020/7/4,95.00639423,997,1,42862,1007,No,No,19056
Alabama,2020/7/5,95.00639423,1091,0,43953,1007,No,No,19056
Alabama,2020/7/6,95.00639423,925,0,44878,1007,No,No,19056
Alabama,2020/7/7,95.00639423,907,26,45785,1033,No,No,19056
Alabama,2020/7/8,95.00639423,1177,25,46962,1058,No,No,20563
Alabama,2020/7/9,95.00639423,2212,10,49174,1068,No,No,20563
Alabama,2020/7/10,95.00639423,1334,36,50508,1104,No,No,20563
Alabama,2020/7/11,95.00639423,1439,10,51947,1114,No,No,20563
Alabama,2020/7/12,95.00639423,1640,7,53587,1121,No,No,20563
Alabama,2020/7/13,95.00639423,1958,3,55545,1124,No,No,20563
Alabama,2020/7/14,95.00639423,1710,40,57255,1164,No,No,20563
Alabama,2020/7/15,95.00639423,1812,47,59067,1211,No,No,23676
Alabama,2020/7/16,95.00639423,2021,19,61088,1230,No,Yes,23676
Alabama,2020/7/17,95.00639423,2003,35,63091,1265,No,Yes,23676
Alabama,2020/7/18,95.00639423,2143,21,65234,1286,No,Yes,23676
Alabama,2020/7/19,95.00639423,1777,1,67011,1287,No,Yes,23676
Alabama,2020/7/20,95.00639423,1880,4,68891,1291,No,Yes,23676
Alabama,2020/7/21,95.00639423,1467,12,70358,1303,No,Yes,23676
Alabama,2020/7/22,95.00639423,1455,61,71813,1364,No,Yes,17437
Alabama,2020/7/23,95.00639423,2399,33,74212,1397,No,Yes,17437
Alabama,2020/7/24,95.00639423,1793,41,76005,1438,No,Yes,17437
Alabama,2020/7/25,95.00639423,2125,18,78130,1456,No,Yes,17437
Alabama,2020/7/26,95.00639423,1164,17,79294,1473,No,Yes,17437
Alabama,2020/7/27,95.00639423,1821,18,81115,1491,No,Yes,17437
Alabama,2020/7/28,95.00639423,1251,0,82366,1491,No,Yes,17437
Alabama,2020/7/29,95.00639423,1416,47,83782,1538,No,Yes,11690
Alabama,2020/7/30,95.00639423,1980,27,85762,1565,No,Yes,11690
Alabama,2020/7/31,95.00639423,1961,15,87723,1580,No,Yes,11690
Alabama,2020/8/1,95.00639423,1626,23,89349,1603,No,Yes,11690
Alabama,2020/8/2,95.00639423,2095,24,91444,1627,No,Yes,11690
Alabama,2020/8/3,95.00639423,1217,6,92661,1633,No,Yes,11690
Alabama,2020/8/4,95.00639423,1041,33,93702,1666,No,Yes,11690
Alabama,2020/8/5,95.00639423,952,29,94654,1695,No,Yes,9467
Alabama,2020/8/6,95.00639423,1938,19,96592,1714,No,Yes,9467
Alabama,2020/8/7,95.00639423,1709,21,98301,1735,No,Yes,9467
Alabama,2020/8/8,95.00639423,1872,20,100173,1755,No,Yes,9467
Alabama,2020/8/9,95.00639423,1161,13,101334,1768,No,Yes,9467
Alabama,2020/8/10,95.00639423,1686,29,103020,1797,No,Yes,9467
Alabama,2020/8/11,95.00639423,831,50,103851,1847,No,Yes,9467
Alabama,2020/8/12,95.00639423,935,35,104786,1882,No,Yes,11047
Alabama,2020/8/13,95.00639423,771,8,105557,1890,No,Yes,11047
Alabama,2020/8/14,95.00639423,752,3,106309,1893,No,Yes,11047
Alabama,2020/8/15,95.00639423,1271,3,107580,1896,No,Yes,11047
Alabama,2020/8/16,95.00639423,853,2,108433,1898,No,Yes,11047
Alabama,2020/8/17,95.00639423,571,27,109004,1925,No,Yes,11047
Alabama,2020/8/18,95.00639423,1357,11,110361,1936,No,Yes,11047
Alabama,2020/8/19,95.00639423,1117,8,111478,1944,No,Yes,8676
Alabama,2020/8/20,95.00639423,971,30,112449,1974,No,Yes,8676
Alabama,2020/8/21,95.00639423,1183,22,113632,1996,No,Yes,8676
Alabama,2020/8/22,95.00639423,900,15,114532,2011,No,Yes,8676
Alabama,2020/8/23,95.00639423,528,2,115060,2013,No,Yes,8676
Alabama,2020/8/24,95.00639423,1650,11,116710,2024,No,Yes,8676
Alabama,2020/8/25,95.00639423,532,13,117242,2037,No,Yes,8676
Alabama,2020/8/26,95.00639423,2012,8,119254,2045,No,Yes,8511
Alabama,2020/8/27,95.00639423,1769,31,121023,2076,No,Yes,8511
Alabama,2020/8/28,95.00639423,1162,31,122185,2107,No,Yes,8511
Alabama,2020/8/29,95.00639423,1704,45,123889,2152,No,Yes,8511
Alabama,2020/8/30,95.00639423,1346,10,125235,2162,No,Yes,8511
Alabama,2020/8/31,95.00639423,823,20,126058,2182,No,Yes,8511
Alabama,2020/9/1,95.00639423,1558,18,127616,2200,No,Yes,8511
Alabama,2020/9/2,95.00639423,623,17,128239,2217,No,Yes,8901
Alabama,2020/9/3,95.00639423,1046,16,129285,2233,No,Yes,8901
Alabama,2020/9/4,95.00639423,1108,33,130393,2266,No,Yes,8901
Alabama,2020/9/5,95.00639423,1410,9,131803,2275,No,Yes,8901
Alabama,2020/9/6,95.00639423,511,1,132314,2276,No,Yes,8901
Alabama,2020/9/7,95.00639423,659,0,132973,2276,No,Yes,8901
Alabama,2020/9/8,95.00639423,633,1,133606,2277,No,Yes,8901
Alabama,2020/9/9,95.00639423,811,8,134417,2285,No,Yes,8848
Alabama,2020/9/10,95.00639423,1148,16,135565,2301,No,Yes,8848
Alabama,2020/9/11,95.00639423,1138,32,136703,2333,No,Yes,8848
Alabama,2020/9/12,95.00639423,943,17,137646,2350,No,Yes,8848
Alabama,2020/9/13,95.00639423,1109,1,138755,2351,No,Yes,8848
Alabama,2020/9/14,95.00639423,704,4,139459,2355,No,Yes,8848
Alabama,2020/9/15,95.00639423,701,32,140160,2387,No,Yes,8848
Alabama,2020/9/16,95.00639423,927,5,141087,2392,No,Yes,8679
Alabama,2020/9/17,95.00639423,670,9,141757,2401,No,Yes,8679
Alabama,2020/9/18,95.00639423,1106,27,142863,2428,No,Yes,8679
Alabama,2020/9/19,95.00639423,1301,9,144164,2437,No,Yes,8679
Alabama,2020/9/20,95.00639423,798,0,144962,2437,No,Yes,8679
Alabama,2020/9/21,95.00639423,818,2,145780,2439,No,Yes,8679
Alabama,2020/9/22,95.00639423,804,18,146584,2457,No,Yes,8679
Alabama,2020/9/23,95.00639423,569,31,147153,2488,No,Yes,8805
Alabama,2020/9/24,95.00639423,1053,18,148206,2506,No,Yes,8805
Alabama,2020/9/25,95.00639423,2452,-15,150658,2491,No,Yes,8805
Alabama,2020/9/26,95.00639423,933,10,151591,2501,No,Yes,8805
Alabama,2020/9/27,95.00639423,730,1,152321,2502,No,Yes,8805
Alabama,2020/9/28,95.00639423,662,-1,152983,2501,No,Yes,8805
Alabama,2020/9/29,95.00639423,571,16,153554,2517,No,Yes,8805
Alabama,2020/9/30,95.00639423,1147,23,154701,2540,No,Yes,7732
Alabama,2020/10/1,95.00639423,1043,8,155744,2548,No,Yes,7732
Alabama,2020/10/2,95.00639423,954,2,156698,2550,No,Yes,7732
Alabama,2020/10/3,95.00639423,1682,8,158380,2558,No,Yes,7732
Alabama,2020/10/4,95.00639423,789,0,159169,2558,No,Yes,7732
Alabama,2020/10/5,95.00639423,544,1,159713,2559,No,Yes,7732
Alabama,2020/10/6,95.00639423,764,21,160477,2580,No,Yes,7732
Alabama,2020/10/7,95.00639423,941,21,161418,2601,No,Yes,8581
Alabama,2020/10/8,95.00639423,557,36,161975,2637,No,Yes,8581
Alabama,2020/10/9,95.00639423,1490,16,163465,2653,No,Yes,8581
Alabama,2020/10/10,95.00639423,1061,11,164526,2664,No,Yes,8581
Alabama,2020/10/11,95.00639423,816,0,165342,2664,No,Yes,8581
Alabama,2020/10/12,95.00639423,734,1,166076,2665,No,Yes,8581
Alabama,2020/10/13,95.00639423,1117,0,167193,2665,No,Yes,8581
Alabama,2020/10/14,95.00639423,784,41,167977,2706,No,Yes,7964
Alabama,2020/10/15,95.00639423,1185,50,169162,2756,No,Yes,7964
Alabama,2020/10/16,95.00639423,1212,30,170374,2786,No,Yes,7964
Alabama,2020/10/17,95.00639423,1288,2,171662,2788,No,Yes,7964
Alabama,2020/10/18,95.00639423,964,0,172626,2788,No,Yes,7964
Alabama,2020/10/19,95.00639423,859,1,173485,2789,No,Yes,7964
Alabama,2020/10/20,95.00639423,1043,16,174528,2805,No,Yes,7964
Alabama,2020/10/21,95.00639423,1146,23,175674,2828,No,Yes,7126
Alabama,2020/10/22,95.00639423,1390,15,177064,2843,No,Yes,7126
Alabama,2020/10/23,95.00639423,3852,16,180916,2859,No,Yes,7126
Alabama,2020/10/24,95.00639423,2360,7,183276,2866,No,Yes,7126
Alabama,2020/10/25,95.00639423,1079,0,184355,2866,No,Yes,7126
Alabama,2020/10/26,95.00639423,967,0,185322,2866,No,Yes,7126
Alabama,2020/10/27,95.00639423,1115,26,186437,2892,No,Yes,7126
Alabama,2020/10/28,95.00639423,1269,19,187706,2911,No,Yes,7060
Alabama,2020/10/29,95.00639423,1443,3,189149,2914,No,Yes,7060
Alabama,2020/10/30,95.00639423,1347,18,190496,2932,No,Yes,7060
Alabama,2020/10/31,95.00639423,1789,35,192285,2967,No,Yes,7060
Alabama,2020/11/1,95.00639423,1700,6,193985,2973,No,Yes,7060
Alabama,2020/11/2,95.00639423,907,0,194892,2973,No,Yes,7060
Alabama,2020/11/3,95.00639423,1037,14,195929,2987,No,Yes,7060
Alabama,2020/11/4,95.00639423,1848,19,197777,3006,No,Yes,8764
Alabama,2020/11/5,95.00639423,1381,20,199158,3026,No,Yes,8764
Alabama,2020/11/6,95.00639423,1556,23,200714,3049,No,Yes,8764
Alabama,2020/11/7,95.00639423,1768,33,202482,3082,No,Yes,8764
Alabama,2020/11/8,95.00639423,1205,2,203687,3084,No,Yes,8764
Alabama,2020/11/9,95.00639423,1170,0,204857,3084,No,No,8764
Alabama,2020/11/10,95.00639423,1710,36,206567,3120,No,No,8764
Alabama,2020/11/11,95.00639423,2070,81,208637,3201,No,No,9262
Alabama,2020/11/12,95.00639423,2000,12,210637,3213,No,No,9262
Alabama,2020/11/13,95.00639423,2980,18,213617,3231,No,No,9262
Alabama,2020/11/14,95.00639423,2226,15,215843,3246,No,No,9262
Alabama,2020/11/15,95.00639423,1979,2,217822,3248,No,No,9262
Alabama,2020/11/16,95.00639423,1410,1,219232,3249,No,No,9262
Alabama,2020/11/17,95.00639423,1616,52,220848,3301,No,No,9262
Alabama,2020/11/18,95.00639423,2638,46,223486,3347,No,No,11813
Alabama,2020/11/19,95.00639423,2424,72,225910,3419,No,No,11813
Alabama,2020/11/20,95.00639423,2463,32,228373,3451,No,No,11813
Alabama,2020/11/21,95.00639423,2335,6,230708,3457,No,No,11813
Alabama,2020/11/22,95.00639423,1798,0,232506,3457,No,No,11813
Alabama,2020/11/23,95.00639423,1574,2,234080,3459,No,No,11813
Alabama,2020/11/24,95.00639423,2785,13,236865,3472,No,No,11813
Alabama,2020/11/25,95.00639423,2453,60,239318,3532,No,No,7061
Alabama,2020/11/26,95.00639423,2639,40,241957,3572,No,No,7061
Alabama,2020/11/27,95.00639423,917,0,242874,3572,No,No,7061
Alabama,2020/11/28,95.00639423,2119,0,244993,3572,No,No,7061
Alabama,2020/11/29,95.00639423,2236,5,247229,3577,No,No,7061
Alabama,2020/11/30,95.00639423,2295,1,249524,3578,No,No,7061
Alabama,2020/12/1,95.00639423,3376,60,252900,3638,No,No,7061
Alabama,2020/12/2,95.00639423,3928,73,256828,3711,No,No,7656
Alabama,2020/12/3,95.00639423,3531,65,260359,3776,No,No,7656
Alabama,2020/12/4,95.00639423,3840,55,264199,3831,No,No,7656
Alabama,2020/12/5,95.00639423,3390,46,267589,3877,No,No,7656
Alabama,2020/12/6,95.00639423,2288,12,269877,3889,No,No,7656
Alabama,2020/12/7,95.00639423,2352,3,272229,3892,No,No,7656
Alabama,2020/12/8,95.00639423,4436,50,276665,3942,No,No,7656
Alabama,2020/12/9,95.00639423,3522,43,280187,3985,No,No,7568
Alabama,2020/12/10,95.00639423,4735,49,284922,4034,No,No,7568
Alabama,2020/12/11,95.00639423,3853,52,288775,4086,No,No,7568
Alabama,2020/12/12,95.00639423,4066,16,292841,4102,No,No,7568
Alabama,2020/12/13,95.00639423,2790,0,295631,4102,No,No,7568
Alabama,2020/12/14,95.00639423,2264,0,297895,4102,No,No,7568
Alabama,2020/12/15,95.00639423,3638,22,301533,4124,No,No,7568
Alabama,2020/12/16,95.00639423,4107,74,305640,4198,No,No,7543
Alabama,2020/12/17,95.00639423,4695,56,310335,4254,No,No,7543
Alabama,2020/12/18,95.00639423,5348,42,315683,4296,No,No,7543
Alabama,2020/12/19,95.00639423,4221,93,319904,4389,No,No,7543
Alabama,2020/12/20,95.00639423,2548,0,322452,4389,No,No,7543
Alabama,2020/12/21,95.00639423,2380,0,324832,4389,No,No,7543
Alabama,2020/12/22,95.00639423,4979,63,329811,4452,No,No,7543
Alabama,2020/12/23,95.00639423,4758,135,334569,4587,No,No,5506
Alabama,2020/12/24,95.00639423,4232,89,338801,4676,No,No,5506
Alabama,2020/12/25,95.00639423,3625,4,342426,4680,No,No,5506
Alabama,2020/12/26,95.00639423,1032,5,343458,4685,No,No,5506
Alabama,2020/12/27,95.00639423,2170,6,345628,4691,No,No,5506
Alabama,2020/12/28,95.00639423,2269,21,347897,4712,No,No,5506
Alabama,2020/12/29,95.00639423,3907,25,351804,4737,No,No,5506
Alabama,2020/12/30,95.00639423,5016,37,356820,4774,No,No,10986
Alabama,2020/12/31,95.00639423,4406,53,361226,4827,No,No,10986
Alabama,2021/1/1,95.00639423,4521,45,365747,4872,No,No,10986
Alabama,2021/1/2,95.00639423,3711,0,369458,4872,No,No,10986
Alabama,2021/1/3,95.00639423,2476,1,371934,4873,No,No,10986
Alabama,2021/1/4,95.00639423,2161,5,374095,4878,No,No,10986
Alabama,2021/1/5,95.00639423,5498,8,379593,4886,No,No,10986
Alabama,2021/1/6,95.00639423,4591,108,384184,4994,No,No,14084
Alabama,2021/1/7,95.00639423,5046,86,389230,5080,No,No,14084
Alabama,2021/1/8,95.00639423,5057,111,394287,5191,No,No,14084
Alabama,2021/1/9,95.00639423,4863,108,399150,5299,No,No,14084
Alabama,2021/1/10,95.00639423,2750,35,401900,5334,No,No,14084
Alabama,2021/1/11,95.00639423,2100,13,404000,5347,No,No,14084
Alabama,2021/1/12,95.00639423,3848,226,407848,5573,No,No,14084
Alabama,2021/1/13,95.00639423,3147,187,410995,5760,No,No,11980
Alabama,2021/1/14,95.00639423,3588,185,414583,5945,No,No,11980
Alabama,2021/1/15,95.00639423,2945,85,417528,6030,No,No,11980
Alabama,2021/1/16,95.00639423,3153,89,420681,6119,No,No,11980
Alabama,2021/1/17,95.00639423,1917,1,422598,6120,No,No,11980
Alabama,2021/1/18,95.00639423,1430,1,424028,6121,No,No,11980
Alabama,2021/1/19,95.00639423,2515,5,426543,6126,No,No,11980
Alabama,2021/1/20,95.00639423,3112,157,429655,6283,No,No,11615
Alabama,2021/1/21,95.00639423,2881,96,432536,6379,No,No,11615
Alabama,2021/1/22,95.00639423,3551,107,436087,6486,No,No,11615
Alabama,2021/1/23,95.00639423,3355,171,439442,6657,No,No,11615
Alabama,2021/1/24,95.00639423,1728,3,441170,6660,No,No,11615
Alabama,2021/1/25,95.00639423,1839,2,443009,6662,No,No,11615
Alabama,2021/1/26,95.00639423,2900,234,445909,6896,No,No,11615
Alabama,2021/1/27,95.00639423,3177,276,449086,7172,No,No,12664
Alabama,2021/1/28,95.00639423,3648,168,452734,7340,No,No,12664
Alabama,2021/1/29,95.00639423,2848,226,455582,7566,No,No,12664
Alabama,2021/1/30,95.00639423,0,0,455582,7566,No,No,12664
Alabama,2021/1/31,95.00639423,4057,122,459639,7688,No,No,12664
Alabama,2021/2/1,95.00639423,1221,0,460860,7688,No,No,12664
Alabama,2021/2/2,95.00639423,2078,206,462938,7894,No,No,12664
Alabama,2021/2/3,95.00639423,2118,309,465056,8203,No,No,13464
Alabama,2021/2/4,95.00639423,2767,162,467823,8365,No,No,13464
Alabama,2021/2/5,95.00639423,1496,84,469319,8449,No,No,13464
Alabama,2021/2/6,95.00639423,1992,64,471311,8513,No,No,13464
Alabama,2021/2/7,95.00639423,1112,2,472423,8515,No,No,13464
Alabama,2021/2/8,95.00639423,925,8,473348,8523,No,No,13464
Alabama,2021/2/9,95.00639423,1318,56,474666,8579,No,No,13464
Alabama,2021/2/10,95.00639423,1401,309,476067,8888,No,No,12087
Alabama,2021/2/11,95.00639423,1503,133,477570,9021,No,No,12087
Alabama,2021/2/12,95.00639423,1097,159,478667,9180,No,No,12087
Alabama,2021/2/13,95.00639423,1189,62,479856,9242,No,No,12087
Alabama,2021/2/14,95.00639423,1075,0,480931,9242,No,No,12087
Alabama,2021/2/15,95.00639423,674,2,481605,9244,No,No,12087
Alabama,2021/2/16,95.00639423,883,13,482488,9257,No,No,12087
Alabama,2021/2/17,95.00639423,679,89,483167,9346,No,No,11395
Alabama,2021/2/18,95.00639423,1198,78,484365,9424,No,No,11395
Alabama,2021/2/19,95.00639423,847,149,485212,9573,No,No,11395
Alabama,2021/2/20,95.00639423,774,17,485986,9590,No,No,11395
Alabama,2021/2/21,95.00639423,857,2,486843,9592,No,No,11395
Alabama,2021/2/22,95.00639423,677,0,487520,9592,No,No,11395
Alabama,2021/2/23,95.00639423,1453,68,488973,9660,No,No,11395
Alabama,2021/2/24,95.00639423,1247,84,490220,9744,No,No,11395
Alabama,2021/2/25,95.00639423,890,87,491110,9831,No,No,11395
Alabama,2021/2/26,95.00639423,739,38,491849,9869,No,No,11395
Alabama,2021/2/27,95.00639423,834,61,492683,9930,No,No,11395
Alabama,2021/2/28,95.00639423,569,-1,493252,9929,No,No,11395
Alabama,2021/3/1,95.00639423,517,2,493769,9931,No,No,11395
Alabama,2021/3/2,95.00639423,652,60,494421,9991,No,No,11395
Alabama,2021/3/3,95.00639423,2733,38,497154,10029,No,No,11395
Alabama,2021/3/4,95.00639423,922,65,498076,10094,No,No,11395
Alaska,2020/3/1,1.240417664,0,0,0,0,No,No,1575
Alaska,2020/3/2,1.240417664,0,0,0,0,No,No,1575
Alaska,2020/3/3,1.240417664,0,0,0,0,No,No,1575
Alaska,2020/3/4,1.240417664,0,0,0,0,No,No,1663
Alaska,2020/3/5,1.240417664,0,0,0,0,No,No,1663
Alaska,2020/3/6,1.240417664,0,0,0,0,No,No,1663
Alaska,2020/3/7,1.240417664,0,0,0,0,No,No,1663
Alaska,2020/3/8,1.240417664,0,0,0,0,No,No,1663
Alaska,2020/3/9,1.240417664,0,0,0,0,No,No,1663
Alaska,2020/3/10,1.240417664,0,0,0,0,No,No,1663
Alaska,2020/3/11,1.240417664,0,0,0,0,No,No,1819
Alaska,2020/3/12,1.240417664,1,0,1,0,No,No,1819
Alaska,2020/3/13,1.240417664,0,0,1,0,No,No,1819
Alaska,2020/3/14,1.240417664,0,0,1,0,No,No,1819
Alaska,2020/3/15,1.240417664,0,0,1,0,No,No,1819
Alaska,2020/3/16,1.240417664,2,0,3,0,No,No,1819
Alaska,2020/3/17,1.240417664,3,0,6,0,No,No,1819
Alaska,2020/3/18,1.240417664,3,0,9,0,No,No,10892
Alaska,2020/3/19,1.240417664,3,0,12,0,No,No,10892
Alaska,2020/3/20,1.240417664,2,0,14,0,No,No,10892
Alaska,2020/3/21,1.240417664,7,0,21,0,No,No,10892
Alaska,2020/3/22,1.240417664,1,0,22,0,No,No,10892
Alaska,2020/3/23,1.240417664,14,0,36,0,No,No,10892
Alaska,2020/3/24,1.240417664,6,0,42,0,No,No,10892
Alaska,2020/3/25,1.240417664,17,0,59,0,No,No,80984
Alaska,2020/3/26,1.240417664,10,0,69,0,No,No,80984
Alaska,2020/3/27,1.240417664,16,1,85,1,No,No,80984
Alaska,2020/3/28,1.240417664,17,0,102,1,Yes,No,80984
Alaska,2020/3/29,1.240417664,12,1,114,2,Yes,No,80984
Alaska,2020/3/30,1.240417664,6,0,120,2,Yes,No,80984
Alaska,2020/3/31,1.240417664,13,0,133,2,Yes,No,80984
Alaska,2020/4/1,1.240417664,10,0,143,2,Yes,No,106739
Alaska,2020/4/2,1.240417664,3,0,146,2,Yes,No,106739
Alaska,2020/4/3,1.240417664,10,0,156,2,Yes,No,106739
Alaska,2020/4/4,1.240417664,13,1,169,3,Yes,No,106739
Alaska,2020/4/5,1.240417664,14,1,183,4,Yes,No,106739
Alaska,2020/4/6,1.240417664,6,0,189,4,Yes,No,106739
Alaska,2020/4/7,1.240417664,22,0,211,4,Yes,No,106739
Alaska,2020/4/8,1.240417664,13,1,224,5,Yes,No,77515
Alaska,2020/4/9,1.240417664,9,0,233,5,Yes,No,77515
Alaska,2020/4/10,1.240417664,11,0,244,5,Yes,No,77515
Alaska,2020/4/11,1.240417664,11,1,255,6,Yes,No,77515
Alaska,2020/4/12,1.240417664,15,0,270,6,Yes,No,77515
Alaska,2020/4/13,1.240417664,5,0,275,6,Yes,No,77515
Alaska,2020/4/14,1.240417664,8,1,283,7,Yes,No,77515
Alaska,2020/4/15,1.240417664,8,0,291,7,Yes,No,66432
Alaska,2020/4/16,1.240417664,7,0,298,7,Yes,No,66432
Alaska,2020/4/17,1.240417664,9,0,307,7,Yes,No,66432
Alaska,2020/4/18,1.240417664,5,0,312,7,Yes,No,66432
Alaska,2020/4/19,1.240417664,5,0,317,7,Yes,No,66432
Alaska,2020/4/20,1.240417664,2,0,319,7,Yes,No,66432
Alaska,2020/4/21,1.240417664,8,0,327,7,Yes,No,66432
Alaska,2020/4/22,1.240417664,6,0,333,7,Yes,No,74966
Alaska,2020/4/23,1.240417664,2,0,335,7,Yes,No,74966
Alaska,2020/4/24,1.240417664,2,0,337,7,Yes,No,74966
Alaska,2020/4/25,1.240417664,0,0,337,7,Yes,No,74966
Alaska,2020/4/26,1.240417664,2,0,339,7,Yes,No,74966
Alaska,2020/4/27,1.240417664,4,0,343,7,Yes,No,74966
Alaska,2020/4/28,1.240417664,6,0,349,7,No,No,74966
Alaska,2020/4/29,1.240417664,4,0,353,7,No,No,28985
Alaska,2020/4/30,1.240417664,0,0,353,7,No,No,28985
Alaska,2020/5/1,1.240417664,9,0,362,7,No,No,28985
Alaska,2020/5/2,1.240417664,1,0,363,7,No,No,28985
Alaska,2020/5/3,1.240417664,3,0,366,7,No,No,28985
Alaska,2020/5/4,1.240417664,2,0,368,7,No,No,28985
Alaska,2020/5/5,1.240417664,1,0,369,7,No,No,28985
Alaska,2020/5/6,1.240417664,1,1,370,8,No,No,26666
Alaska,2020/5/7,1.240417664,3,0,373,8,No,No,26666
Alaska,2020/5/8,1.240417664,3,0,376,8,No,No,26666
Alaska,2020/5/9,1.240417664,1,0,377,8,No,No,26666
Alaska,2020/5/10,1.240417664,1,0,378,8,No,No,26666
Alaska,2020/5/11,1.240417664,2,0,380,8,No,No,26666
Alaska,2020/5/12,1.240417664,3,0,383,8,No,No,26666
Alaska,2020/5/13,1.240417664,0,0,383,8,No,No,25150
Alaska,2020/5/14,1.240417664,4,0,387,8,No,No,25150
Alaska,2020/5/15,1.240417664,1,0,388,8,No,No,25150
Alaska,2020/5/16,1.240417664,4,0,392,8,No,No,25150
Alaska,2020/5/17,1.240417664,4,0,396,8,No,No,25150
Alaska,2020/5/18,1.240417664,3,0,399,8,No,No,25150
Alaska,2020/5/19,1.240417664,0,0,399,8,No,No,25150
Alaska,2020/5/20,1.240417664,3,0,402,8,No,No,27919
Alaska,2020/5/21,1.240417664,0,0,402,8,No,No,27919
Alaska,2020/5/22,1.240417664,2,0,404,8,No,No,27919
Alaska,2020/5/23,1.240417664,5,0,409,8,No,No,27919
Alaska,2020/5/24,1.240417664,0,0,409,8,No,No,27919
Alaska,2020/5/25,1.240417664,3,0,412,8,No,No,27919
Alaska,2020/5/26,1.240417664,4,0,416,8,No,No,27919
Alaska,2020/5/27,1.240417664,1,0,417,8,No,No,21335
Alaska,2020/5/28,1.240417664,13,0,430,8,No,No,21335
Alaska,2020/5/29,1.240417664,6,0,436,8,No,No,21335
Alaska,2020/5/30,1.240417664,5,0,441,8,No,No,21335
Alaska,2020/5/31,1.240417664,28,0,469,8,No,No,21335
Alaska,2020/6/1,1.240417664,7,0,476,8,No,No,21335
Alaska,2020/6/2,1.240417664,21,0,497,8,No,No,21335
Alaska,2020/6/3,1.240417664,19,0,516,8,No,No,19949
Alaska,2020/6/4,1.240417664,26,0,542,8,No,No,19949
Alaska,2020/6/5,1.240417664,23,0,565,8,No,No,19949
Alaska,2020/6/6,1.240417664,14,0,579,8,No,No,19949
Alaska,2020/6/7,1.240417664,9,0,588,8,No,No,19949
Alaska,2020/6/8,1.240417664,19,0,607,8,No,No,19949
Alaska,2020/6/9,1.240417664,13,1,620,9,No,No,19949
Alaska,2020/6/10,1.240417664,22,0,642,9,No,No,18367
Alaska,2020/6/11,1.240417664,24,0,666,9,No,No,18367
Alaska,2020/6/12,1.240417664,22,1,688,10,No,No,18367
Alaska,2020/6/13,1.240417664,34,0,722,10,No,No,18367
Alaska,2020/6/14,1.240417664,12,0,734,10,No,No,18367
Alaska,2020/6/15,1.240417664,4,0,738,10,No,No,18367
Alaska,2020/6/16,1.240417664,13,0,751,10,No,No,18367
Alaska,2020/6/17,1.240417664,25,0,776,10,No,No,18671
Alaska,2020/6/18,1.240417664,19,0,795,10,No,No,18671
Alaska,2020/6/19,1.240417664,26,0,821,10,No,No,18671
Alaska,2020/6/20,1.240417664,24,0,845,10,No,No,18671
Alaska,2020/6/21,1.240417664,14,0,859,10,No,No,18671
Alaska,2020/6/22,1.240417664,10,0,869,10,No,No,18671
Alaska,2020/6/23,1.240417664,36,0,905,10,No,No,18671
Alaska,2020/6/24,1.240417664,21,0,926,10,No,No,18338
Alaska,2020/6/25,1.240417664,45,0,971,10,No,No,18338
Alaska,2020/6/26,1.240417664,30,2,1001,12,No,No,18338
Alaska,2020/6/27,1.240417664,26,0,1027,12,No,No,18338
Alaska,2020/6/28,1.240417664,33,0,1060,12,No,No,18338
Alaska,2020/6/29,1.240417664,25,0,1085,12,No,No,18338
Alaska,2020/6/30,1.240417664,47,0,1132,12,No,No,18338
Alaska,2020/7/1,1.240417664,42,0,1174,12,No,No,19056
Alaska,2020/7/2,1.240417664,50,0,1224,12,No,No,19056
Alaska,2020/7/3,1.240417664,60,1,1284,13,No,No,19056
Alaska,2020/7/4,1.240417664,55,1,1339,14,No,No,19056
Alaska,2020/7/5,1.240417664,32,0,1371,14,No,No,19056
Alaska,2020/7/6,1.240417664,30,0,1401,14,No,No,19056
Alaska,2020/7/7,1.240417664,22,1,1423,15,No,No,19056
Alaska,2020/7/8,1.240417664,49,0,1472,15,No,No,20563
Alaska,2020/7/9,1.240417664,49,0,1521,15,No,No,20563
Alaska,2020/7/10,1.240417664,58,0,1579,15,No,No,20563
Alaska,2020/7/11,1.240417664,77,0,1656,15,No,No,20563
Alaska,2020/7/12,1.240417664,116,0,1772,15,No,No,20563
Alaska,2020/7/13,1.240417664,71,0,1843,15,No,No,20563
Alaska,2020/7/14,1.240417664,54,0,1897,15,No,No,20563
Alaska,2020/7/15,1.240417664,61,0,1958,15,No,No,23676
Alaska,2020/7/16,1.240417664,76,0,2034,15,No,No,23676
Alaska,2020/7/17,1.240417664,49,0,2083,15,No,No,23676
Alaska,2020/7/18,1.240417664,74,1,2157,16,No,No,23676
Alaska,2020/7/19,1.240417664,118,0,2275,16,No,No,23676
Alaska,2020/7/20,1.240417664,137,0,2412,16,No,No,23676
Alaska,2020/7/21,1.240417664,111,0,2523,16,No,No,23676
Alaska,2020/7/22,1.240417664,94,1,2617,17,No,No,17437
Alaska,2020/7/23,1.240417664,65,0,2682,17,No,No,17437
Alaska,2020/7/24,1.240417664,64,0,2746,17,No,No,17437
Alaska,2020/7/25,1.240417664,120,1,2866,18,No,No,17437
Alaska,2020/7/26,1.240417664,234,0,3100,18,No,No,17437
Alaska,2020/7/27,1.240417664,104,1,3204,19,No,No,17437
Alaska,2020/7/28,1.240417664,144,1,3348,20,No,No,17437
Alaska,2020/7/29,1.240417664,92,0,3440,20,No,No,11690
Alaska,2020/7/30,1.240417664,117,1,3557,21,No,No,11690
Alaska,2020/7/31,1.240417664,118,0,3675,21,No,No,11690
Alaska,2020/8/1,1.240417664,150,1,3825,22,No,No,11690
Alaska,2020/8/2,1.240417664,157,0,3982,22,No,No,11690
Alaska,2020/8/3,1.240417664,80,1,4062,23,No,No,11690
Alaska,2020/8/4,1.240417664,61,0,4123,23,No,No,11690
Alaska,2020/8/5,1.240417664,58,0,4181,23,No,No,9467
Alaska,2020/8/6,1.240417664,40,0,4221,23,No,No,9467
Alaska,2020/8/7,1.240417664,65,0,4286,23,No,No,9467
Alaska,2020/8/8,1.240417664,85,1,4371,24,No,No,9467
Alaska,2020/8/9,1.240417664,100,0,4471,24,No,No,9467
Alaska,2020/8/10,1.240417664,66,0,4537,24,No,No,9467
Alaska,2020/8/11,1.240417664,50,0,4587,24,No,No,9467
Alaska,2020/8/12,1.240417664,66,1,4653,25,No,No,11047
Alaska,2020/8/13,1.240417664,95,0,4748,25,No,No,11047
Alaska,2020/8/14,1.240417664,119,0,4867,25,No,No,11047
Alaska,2020/8/15,1.240417664,85,1,4952,26,No,No,11047
Alaska,2020/8/16,1.240417664,106,0,5058,26,No,No,11047
Alaska,2020/8/17,1.240417664,50,0,5108,26,No,No,11047
Alaska,2020/8/18,1.240417664,67,1,5175,27,No,No,11047
Alaska,2020/8/19,1.240417664,70,0,5245,27,No,No,8676
Alaska,2020/8/20,1.240417664,85,0,5330,27,No,No,8676
Alaska,2020/8/21,1.240417664,71,1,5401,28,No,No,8676
Alaska,2020/8/22,1.240417664,91,1,5492,29,No,No,8676
Alaska,2020/8/23,1.240417664,64,1,5556,30,No,No,8676
Alaska,2020/8/24,1.240417664,70,0,5626,30,No,No,8676
Alaska,2020/8/25,1.240417664,-5,3,5621,33,No,No,8676
Alaska,2020/8/26,1.240417664,50,1,5671,34,No,No,8511
Alaska,2020/8/27,1.240417664,81,0,5752,34,No,No,8511
Alaska,2020/8/28,1.240417664,122,0,5874,34,No,No,8511
Alaska,2020/8/29,1.240417664,111,0,5985,34,No,No,8511
Alaska,2020/8/30,1.240417664,51,0,6036,34,No,No,8511
Alaska,2020/8/31,1.240417664,39,0,6075,34,No,No,8511
Alaska,2020/9/1,1.240417664,34,2,6109,36,No,No,8511
Alaska,2020/9/2,1.240417664,72,0,6181,36,No,No,8901
Alaska,2020/9/3,1.240417664,106,1,6287,37,No,No,8901
Alaska,2020/9/4,1.240417664,129,0,6416,37,No,No,8901
Alaska,2020/9/5,1.240417664,98,2,6514,39,No,No,8901
Alaska,2020/9/6,1.240417664,89,0,6603,39,No,No,8901
Alaska,2020/9/7,1.240417664,34,0,6637,39,No,No,8901
Alaska,2020/9/8,1.240417664,33,0,6670,39,No,No,8901
Alaska,2020/9/9,1.240417664,65,0,6735,39,No,No,8848
Alaska,2020/9/10,1.240417664,125,0,6860,39,No,No,8848
Alaska,2020/9/11,1.240417664,108,1,6968,40,No,No,8848
Alaska,2020/9/12,1.240417664,106,1,7074,41,No,No,8848
Alaska,2020/9/13,1.240417664,62,0,7136,41,No,No,8848
Alaska,2020/9/14,1.240417664,77,0,7213,41,No,No,8848
Alaska,2020/9/15,1.240417664,43,0,7256,41,No,No,8848
Alaska,2020/9/16,1.240417664,52,0,7308,41,No,No,8679
Alaska,2020/9/17,1.240417664,105,0,7413,41,No,No,8679
Alaska,2020/9/18,1.240417664,115,1,7528,42,No,No,8679
Alaska,2020/9/19,1.240417664,85,0,7613,42,No,No,8679
Alaska,2020/9/20,1.240417664,91,0,7704,42,No,No,8679
Alaska,2020/9/21,1.240417664,71,0,7775,42,No,No,8679
Alaska,2020/9/22,1.240417664,46,0,7821,42,No,No,8679
Alaska,2020/9/23,1.240417664,54,0,7875,42,No,No,8805
Alaska,2020/9/24,1.240417664,140,1,8015,43,No,No,8805
Alaska,2020/9/25,1.240417664,118,5,8133,48,No,No,8805
Alaska,2020/9/26,1.240417664,111,0,8244,48,No,No,8805
Alaska,2020/9/27,1.240417664,115,4,8359,52,No,No,8805
Alaska,2020/9/28,1.240417664,118,0,8477,52,No,No,8805
Alaska,2020/9/29,1.240417664,125,0,8602,52,No,No,8805
Alaska,2020/9/30,1.240417664,105,0,8707,52,No,No,7732
Alaska,2020/10/1,1.240417664,131,1,8838,53,No,No,7732
Alaska,2020/10/2,1.240417664,126,0,8964,53,No,No,7732
Alaska,2020/10/3,1.240417664,147,1,9111,54,No,No,7732
Alaska,2020/10/4,1.240417664,189,0,9300,54,No,No,7732
Alaska,2020/10/5,1.240417664,211,0,9511,54,No,No,7732
Alaska,2020/10/6,1.240417664,145,0,9656,54,No,No,7732
Alaska,2020/10/7,1.240417664,128,1,9784,55,No,No,8581
Alaska,2020/10/8,1.240417664,135,1,9919,56,No,No,8581
Alaska,2020/10/9,1.240417664,180,0,10099,56,No,No,8581
Alaska,2020/10/10,1.240417664,251,0,10350,56,No,No,8581
Alaska,2020/10/11,1.240417664,258,0,10608,56,No,No,8581
Alaska,2020/10/12,1.240417664,197,0,10805,56,No,No,8581
Alaska,2020/10/13,1.240417664,155,0,10960,56,No,No,8581
Alaska,2020/10/14,1.240417664,143,4,11103,60,No,No,7964
Alaska,2020/10/15,1.240417664,165,1,11268,61,No,No,7964
Alaska,2020/10/16,1.240417664,228,1,11496,62,No,No,7964
Alaska,2020/10/17,1.240417664,214,1,11710,63,No,No,7964
Alaska,2020/10/18,1.240417664,224,0,11934,63,No,No,7964
Alaska,2020/10/19,1.240417664,204,0,12138,63,No,No,7964
Alaska,2020/10/20,1.240417664,211,0,12349,63,No,No,7964
Alaska,2020/10/21,1.240417664,210,1,12559,64,No,No,7126
Alaska,2020/10/22,1.240417664,231,0,12790,64,No,No,7126
Alaska,2020/10/23,1.240417664,277,0,13067,64,No,No,7126
Alaska,2020/10/24,1.240417664,372,0,13439,64,No,No,7126
Alaska,2020/10/25,1.240417664,529,0,13968,64,No,No,7126
Alaska,2020/10/26,1.240417664,348,0,14316,64,No,No,7126
Alaska,2020/10/27,1.240417664,383,2,14699,66,No,No,7126
Alaska,2020/10/28,1.240417664,354,1,15053,67,No,No,7060
Alaska,2020/10/29,1.240417664,364,5,15417,72,No,No,7060
Alaska,2020/10/30,1.240417664,386,4,15803,76,No,No,7060
Alaska,2020/10/31,1.240417664,444,1,16247,77,No,No,7060
Alaska,2020/11/1,1.240417664,350,1,16597,78,No,No,7060
Alaska,2020/11/2,1.240417664,351,1,16948,79,No,No,7060
Alaska,2020/11/3,1.240417664,391,0,17339,79,No,No,7060
Alaska,2020/11/4,1.240417664,411,0,17750,79,No,No,8764
Alaska,2020/11/5,1.240417664,314,0,18064,79,No,No,8764
Alaska,2020/11/6,1.240417664,525,0,18589,79,No,No,8764
Alaska,2020/11/7,1.240417664,605,0,19194,79,No,No,8764
Alaska,2020/11/8,1.240417664,518,0,19712,79,No,No,8764
Alaska,2020/11/9,1.240417664,473,0,20185,79,No,No,8764
Alaska,2020/11/10,1.240417664,530,8,20715,87,No,No,8764
Alaska,2020/11/11,1.240417664,496,3,21211,90,No,No,9262
Alaska,2020/11/12,1.240417664,478,0,21689,90,No,No,9262
Alaska,2020/11/13,1.240417664,593,1,22282,91,No,No,9262
Alaska,2020/11/14,1.240417664,747,1,23029,92,No,No,9262
Alaska,2020/11/15,1.240417664,659,0,23688,92,No,No,9262
Alaska,2020/11/16,1.240417664,580,0,24268,92,No,Yes,9262
Alaska,2020/11/17,1.240417664,641,2,24909,94,No,Yes,9262
Alaska,2020/11/18,1.240417664,545,0,25454,94,No,Yes,11813
Alaska,2020/11/19,1.240417664,492,1,25946,95,No,Yes,11813
Alaska,2020/11/20,1.240417664,457,0,26403,95,No,Yes,11813
Alaska,2020/11/21,1.240417664,676,0,27079,95,No,Yes,11813
Alaska,2020/11/22,1.240417664,550,2,27629,97,No,Yes,11813
Alaska,2020/11/23,1.240417664,499,0,28128,97,No,Yes,11813
Alaska,2020/11/24,1.240417664,580,13,28708,110,No,Yes,11813
Alaska,2020/11/25,1.240417664,678,0,29386,110,No,Yes,7061
Alaska,2020/11/26,1.240417664,554,3,29940,113,No,Yes,7061
Alaska,2020/11/27,1.240417664,672,0,30612,113,No,Yes,7061
Alaska,2020/11/28,1.240417664,667,2,31279,115,No,Yes,7061
Alaska,2020/11/29,1.240417664,617,0,31896,115,No,Yes,7061
Alaska,2020/11/30,1.240417664,511,0,32407,115,No,Yes,7061
Alaska,2020/12/1,1.240417664,504,1,32911,116,No,Yes,7061
Alaska,2020/12/2,1.240417664,703,0,33614,116,No,Yes,7656
Alaska,2020/12/3,1.240417664,763,8,34377,124,No,Yes,7656
Alaska,2020/12/4,1.240417664,761,11,35138,135,No,Yes,7656
Alaska,2020/12/5,1.240417664,945,1,36083,136,No,Yes,7656
Alaska,2020/12/6,1.240417664,764,0,36847,136,No,Yes,7656
Alaska,2020/12/7,1.240417664,503,3,37350,139,No,Yes,7656
Alaska,2020/12/8,1.240417664,573,0,37923,139,No,Yes,7656
Alaska,2020/12/9,1.240417664,587,4,38510,143,No,Yes,7568
Alaska,2020/12/10,1.240417664,636,5,39146,148,No,Yes,7568
Alaska,2020/12/11,1.240417664,627,3,39773,151,No,Yes,7568
Alaska,2020/12/12,1.240417664,520,18,40293,169,No,Yes,7568
Alaska,2020/12/13,1.240417664,641,0,40934,169,No,Yes,7568
Alaska,2020/12/14,1.240417664,429,0,41363,169,No,Yes,7568
Alaska,2020/12/15,1.240417664,282,3,41645,172,No,Yes,7568
Alaska,2020/12/16,1.240417664,611,2,42256,174,No,Yes,7543
Alaska,2020/12/17,1.240417664,383,2,42639,176,No,Yes,7543
Alaska,2020/12/18,1.240417664,493,0,43132,176,No,Yes,7543
Alaska,2020/12/19,1.240417664,336,1,43468,177,No,Yes,7543
Alaska,2020/12/20,1.240417664,181,-1,43649,176,No,Yes,7543
Alaska,2020/12/21,1.240417664,152,0,43801,176,No,Yes,7543
Alaska,2020/12/22,1.240417664,440,10,44241,186,No,Yes,7543
Alaska,2020/12/23,1.240417664,361,3,44602,189,No,Yes,5506
Alaska,2020/12/24,1.240417664,274,2,44876,191,No,Yes,5506
Alaska,2020/12/25,1.240417664,0,0,44876,191,No,Yes,5506
Alaska,2020/12/26,1.240417664,371,1,45247,192,No,Yes,5506
Alaska,2020/12/27,1.240417664,300,0,45547,192,No,Yes,5506
Alaska,2020/12/28,1.240417664,127,0,45674,192,No,Yes,5506
Alaska,2020/12/29,1.240417664,182,1,45856,193,No,Yes,5506
Alaska,2020/12/30,1.240417664,385,2,46241,195,No,Yes,10986
Alaska,2020/12/31,1.240417664,499,3,46740,198,No,Yes,10986
Alaska,2021/1/1,1.240417664,0,0,46740,198,No,Yes,10986
Alaska,2021/1/2,1.240417664,809,9,47549,207,No,Yes,10986
Alaska,2021/1/3,1.240417664,297,0,47846,207,No,Yes,10986
Alaska,2021/1/4,1.240417664,264,2,48110,209,No,Yes,10986
Alaska,2021/1/5,1.240417664,192,0,48302,209,No,Yes,10986
Alaska,2021/1/6,1.240417664,334,2,48636,211,No,Yes,14084
Alaska,2021/1/7,1.240417664,325,3,48961,214,No,Yes,14084
Alaska,2021/1/8,1.240417664,405,0,49366,214,No,Yes,14084
Alaska,2021/1/9,1.240417664,315,1,49681,215,No,Yes,14084
Alaska,2021/1/10,1.240417664,254,0,49935,215,No,Yes,14084
Alaska,2021/1/11,1.240417664,176,0,50111,215,No,Yes,14084
Alaska,2021/1/12,1.240417664,132,1,50243,216,No,Yes,14084
Alaska,2021/1/13,1.240417664,283,1,50526,217,No,Yes,11980
Alaska,2021/1/14,1.240417664,335,2,50861,219,No,Yes,11980
Alaska,2021/1/15,1.240417664,302,1,51163,220,No,Yes,11980
Alaska,2021/1/16,1.240417664,184,0,51347,220,No,Yes,11980
Alaska,2021/1/17,1.240417664,283,0,51630,220,No,Yes,11980
Alaska,2021/1/18,1.240417664,155,0,51785,220,No,Yes,11980
Alaska,2021/1/19,1.240417664,129,1,51914,221,No,Yes,11980
Alaska,2021/1/20,1.240417664,167,23,52081,244,No,Yes,11615
Alaska,2021/1/21,1.240417664,201,1,52282,245,No,Yes,11615
Alaska,2021/1/22,1.240417664,290,0,52572,245,No,Yes,11615
Alaska,2021/1/23,1.240417664,248,5,52820,250,No,Yes,11615
Alaska,2021/1/24,1.240417664,162,0,52982,250,No,Yes,11615
Alaska,2021/1/25,1.240417664,79,0,53061,250,No,Yes,11615
Alaska,2021/1/26,1.240417664,82,1,53143,251,No,Yes,11615
Alaska,2021/1/27,1.240417664,179,1,53322,252,No,Yes,12664
Alaska,2021/1/28,1.240417664,202,1,53524,253,No,Yes,12664
Alaska,2021/1/29,1.240417664,181,0,53705,253,No,Yes,12664
Alaska,2021/1/30,1.240417664,146,0,53851,253,No,Yes,12664
Alaska,2021/1/31,1.240417664,134,0,53985,253,No,Yes,12664
Alaska,2021/2/1,1.240417664,106,0,54091,253,No,Yes,12664
Alaska,2021/2/2,1.240417664,132,16,54223,269,No,Yes,12664
Alaska,2021/2/3,1.240417664,224,0,54447,269,No,Yes,13464
Alaska,2021/2/4,1.240417664,184,0,54631,269,No,Yes,13464
Alaska,2021/2/5,1.240417664,249,0,54880,269,No,Yes,13464
Alaska,2021/2/6,1.240417664,0,0,54880,269,No,Yes,13464
Alaska,2021/2/7,1.240417664,0,0,54880,269,No,Yes,13464
Alaska,2021/2/8,1.240417664,494,0,55374,269,No,Yes,13464
Alaska,2021/2/9,1.240417664,126,0,55500,269,No,Yes,13464
Alaska,2021/2/10,1.240417664,201,0,55701,269,No,Yes,12087
Alaska,2021/2/11,1.240417664,149,0,55850,269,No,Yes,12087
Alaska,2021/2/12,1.240417664,158,2,56008,271,No,Yes,12087
Alaska,2021/2/13,1.240417664,0,0,56008,271,No,Yes,12087
Alaska,2021/2/14,1.240417664,0,0,56008,271,No,Yes,12087
Alaska,2021/2/15,1.240417664,0,0,56008,271,No,Yes,12087
Alaska,2021/2/16,1.240417664,496,5,56504,276,No,Yes,12087
Alaska,2021/2/17,1.240417664,55,1,56559,277,No,Yes,11395
Alaska,2021/2/18,1.240417664,209,0,56768,277,No,Yes,11395
Alaska,2021/2/19,1.240417664,211,1,56979,278,No,Yes,11395
Alaska,2021/2/20,1.240417664,0,0,56979,278,No,Yes,11395
Alaska,2021/2/21,1.240417664,0,0,56979,278,No,Yes,11395
Alaska,2021/2/22,1.240417664,337,1,57316,279,No,Yes,11395
Alaska,2021/2/23,1.240417664,55,0,57371,279,No,Yes,11395
Alaska,2021/2/24,1.240417664,179,0,57550,279,No,Yes,11395
Alaska,2021/2/25,1.240417664,185,0,57735,279,No,Yes,11395
Alaska,2021/2/26,1.240417664,111,0,57846,279,No,Yes,11395
Alaska,2021/2/27,1.240417664,0,0,57846,279,No,Yes,11395
Alaska,2021/2/28,1.240417664,0,0,57846,279,No,Yes,11395
Alaska,2021/3/1,1.240417664,383,10,58229,289,No,Yes,11395
Alaska,2021/3/2,1.240417664,154,1,58383,290,No,Yes,11395
Alaska,2021/3/3,1.240417664,191,1,58574,291,No,Yes,11395
Alaska,2021/3/4,1.240417664,148,0,58722,291,No,Yes,11395
Arizona,2020/3/1,63.89940215,1,0,1,0,No,No,1575
Arizona,2020/3/2,63.89940215,0,0,1,0,No,No,1575
Arizona,2020/3/3,63.89940215,1,0,2,0,No,No,1575
Arizona,2020/3/4,63.89940215,0,0,2,0,No,No,1663
Arizona,2020/3/5,63.89940215,0,0,2,0,No,No,1663
Arizona,2020/3/6,63.89940215,1,0,3,0,No,No,1663
Arizona,2020/3/7,63.89940215,2,0,5,0,No,No,1663
Arizona,2020/3/8,63.89940215,0,0,5,0,No,No,1663
Arizona,2020/3/9,63.89940215,1,0,6,0,No,No,1663
Arizona,2020/3/10,63.89940215,0,0,6,0,No,No,1663
Arizona,2020/3/11,63.89940215,3,0,9,0,No,No,1819
Arizona,2020/3/12,63.89940215,0,0,9,0,No,No,1819
Arizona,2020/3/13,63.89940215,0,0,9,0,No,No,1819
Arizona,2020/3/14,63.89940215,3,0,12,0,No,No,1819
Arizona,2020/3/15,63.89940215,1,0,13,0,No,No,1819
Arizona,2020/3/16,63.89940215,5,0,18,0,No,No,1819
Arizona,2020/3/17,63.89940215,2,0,20,0,No,No,1819
Arizona,2020/3/18,63.89940215,8,0,28,0,No,No,10892
Arizona,2020/3/19,63.89940215,19,0,47,0,No,No,10892
Arizona,2020/3/20,63.89940215,23,1,70,1,No,No,10892
Arizona,2020/3/21,63.89940215,34,0,104,1,No,No,10892
Arizona,2020/3/22,63.89940215,49,1,153,2,No,No,10892
Arizona,2020/3/23,63.89940215,81,0,234,2,No,No,10892
Arizona,2020/3/24,63.89940215,92,4,326,6,No,No,10892
Arizona,2020/3/25,63.89940215,76,0,402,6,No,No,80984
Arizona,2020/3/26,63.89940215,106,2,508,8,No,No,80984
Arizona,2020/3/27,63.89940215,157,7,665,15,No,No,80984
Arizona,2020/3/28,63.89940215,108,0,773,15,No,No,80984
Arizona,2020/3/29,63.89940215,157,3,930,18,No,No,80984
Arizona,2020/3/30,63.89940215,239,2,1169,20,No,No,80984
Arizona,2020/3/31,63.89940215,129,4,1298,24,Yes,No,80984
Arizona,2020/4/1,63.89940215,115,5,1413,29,Yes,No,106739
Arizona,2020/4/2,63.89940215,187,6,1600,35,Yes,No,106739
Arizona,2020/4/3,63.89940215,169,6,1769,41,Yes,No,106739
Arizona,2020/4/4,63.89940215,250,12,2019,53,Yes,No,106739
Arizona,2020/4/5,63.89940215,250,11,2269,64,Yes,No,106739
Arizona,2020/4/6,63.89940215,197,3,2466,67,Yes,No,106739
Arizona,2020/4/7,63.89940215,111,10,2577,77,Yes,No,106739
Arizona,2020/4/8,63.89940215,149,3,2726,80,Yes,No,77515
Arizona,2020/4/9,63.89940215,292,9,3018,89,Yes,No,77515
Arizona,2020/4/10,63.89940215,94,8,3112,97,Yes,No,77515
Arizona,2020/4/11,63.89940215,281,15,3393,112,Yes,No,77515
Arizona,2020/4/12,63.89940215,146,5,3539,117,Yes,No,77515
Arizona,2020/4/13,63.89940215,163,5,3702,122,Yes,No,77515
Arizona,2020/4/14,63.89940215,104,9,3806,131,Yes,No,77515
Arizona,2020/4/15,63.89940215,156,11,3962,142,Yes,No,66432
Arizona,2020/4/16,63.89940215,272,10,4234,152,Yes,No,66432
Arizona,2020/4/17,63.89940215,273,22,4507,174,Yes,No,66432
Arizona,2020/4/18,63.89940215,212,7,4719,181,Yes,No,66432
Arizona,2020/4/19,63.89940215,210,7,4929,188,Yes,No,66432
Arizona,2020/4/20,63.89940215,135,3,5064,191,Yes,No,66432
Arizona,2020/4/21,63.89940215,187,22,5251,213,Yes,No,66432
Arizona,2020/4/22,63.89940215,208,23,5459,236,Yes,No,74966
Arizona,2020/4/23,63.89940215,310,21,5769,257,Yes,No,74966
Arizona,2020/4/24,63.89940215,276,11,6045,268,Yes,No,74966
Arizona,2020/4/25,63.89940215,235,7,6280,275,Yes,No,74966
Arizona,2020/4/26,63.89940215,246,2,6526,277,Yes,No,74966
Arizona,2020/4/27,63.89940215,190,0,6716,277,Yes,No,74966
Arizona,2020/4/28,63.89940215,232,20,6948,297,Yes,No,74966
Arizona,2020/4/29,63.89940215,254,11,7202,308,Yes,No,28985
Arizona,2020/4/30,63.89940215,446,12,7648,320,Yes,No,28985
Arizona,2020/5/1,63.89940215,314,10,7962,330,Yes,No,28985
Arizona,2020/5/2,63.89940215,402,23,8364,353,Yes,No,28985
Arizona,2020/5/3,63.89940215,276,9,8640,362,Yes,No,28985
Arizona,2020/5/4,63.89940215,279,0,8919,362,Yes,No,28985
Arizona,2020/5/5,63.89940215,386,33,9305,395,Yes,No,28985
Arizona,2020/5/6,63.89940215,402,31,9707,426,Yes,No,26666
Arizona,2020/5/7,63.89940215,238,24,9945,450,Yes,No,26666
Arizona,2020/5/8,63.89940215,581,67,10526,517,Yes,No,26666
Arizona,2020/5/9,63.89940215,434,15,10960,532,Yes,No,26666
Arizona,2020/5/10,63.89940215,159,4,11119,536,Yes,No,26666
Arizona,2020/5/11,63.89940215,261,6,11380,542,Yes,No,26666
Arizona,2020/5/12,63.89940215,356,20,11736,562,Yes,No,26666
Arizona,2020/5/13,63.89940215,440,32,12176,594,Yes,No,25150
Arizona,2020/5/14,63.89940215,498,30,12674,624,Yes,No,25150
Arizona,2020/5/15,63.89940215,495,27,13169,651,Yes,No,25150
Arizona,2020/5/16,63.89940215,462,28,13631,679,No,No,25150
Arizona,2020/5/17,63.89940215,306,1,13937,680,No,No,25150
Arizona,2020/5/18,63.89940215,233,6,14170,686,No,No,25150
Arizona,2020/5/19,63.89940215,396,18,14566,704,No,No,25150
Arizona,2020/5/20,63.89940215,331,43,14897,747,No,No,27919
Arizona,2020/5/21,63.89940215,418,16,15315,763,No,No,27919
Arizona,2020/5/22,63.89940215,293,12,15608,775,No,No,27919
Arizona,2020/5/23,63.89940215,432,24,16040,799,No,No,27919
Arizona,2020/5/24,63.89940215,299,1,16339,800,No,No,27919
Arizona,2020/5/25,63.89940215,222,6,16561,806,No,No,27919
Arizona,2020/5/26,63.89940215,222,1,16783,807,No,No,27919
Arizona,2020/5/27,63.89940215,479,24,17262,831,No,No,21335
Arizona,2020/5/28,63.89940215,501,26,17763,857,No,No,21335
Arizona,2020/5/29,63.89940215,702,28,18465,885,No,No,21335
Arizona,2020/5/30,63.89940215,790,18,19255,903,No,No,21335
Arizona,2020/5/31,63.89940215,681,3,19936,906,No,No,21335
Arizona,2020/6/1,63.89940215,187,12,20123,918,No,No,21335
Arizona,2020/6/2,63.89940215,1127,25,21250,943,No,No,21335
Arizona,2020/6/3,63.89940215,995,40,22245,983,No,No,19949
Arizona,2020/6/4,63.89940215,573,17,22818,1000,No,No,19949
Arizona,2020/6/5,63.89940215,1551,16,24369,1016,No,No,19949
Arizona,2020/6/6,63.89940215,1148,30,25517,1046,No,No,19949
Arizona,2020/6/7,63.89940215,1407,2,26924,1048,No,No,19949
Arizona,2020/6/8,63.89940215,837,4,27761,1052,No,No,19949
Arizona,2020/6/9,63.89940215,635,22,28396,1074,No,No,19949
Arizona,2020/6/10,63.89940215,1585,26,29981,1100,No,No,18367
Arizona,2020/6/11,63.89940215,1544,30,31525,1130,No,No,18367
Arizona,2020/6/12,63.89940215,1642,27,33167,1157,No,No,18367
Arizona,2020/6/13,63.89940215,1606,33,34773,1190,No,No,18367
Arizona,2020/6/14,63.89940215,1180,4,35953,1194,No,No,18367
Arizona,2020/6/15,63.89940215,1052,10,37005,1204,No,No,18367
Arizona,2020/6/16,63.89940215,2293,24,39298,1228,No,No,18367
Arizona,2020/6/17,63.89940215,1861,24,41159,1252,No,Yes,18671
Arizona,2020/6/18,63.89940215,2572,35,43731,1287,No,Yes,18671
Arizona,2020/6/19,63.89940215,3183,35,46914,1322,No,Yes,18671
Arizona,2020/6/20,63.89940215,3284,25,50198,1347,No,Yes,18671
Arizona,2020/6/21,63.89940215,2468,3,52666,1350,No,Yes,18671
Arizona,2020/6/22,63.89940215,2101,4,54767,1354,No,Yes,18671
Arizona,2020/6/23,63.89940215,3630,44,58397,1398,No,Yes,18671
Arizona,2020/6/24,63.89940215,1810,69,60207,1467,No,Yes,18338
Arizona,2020/6/25,63.89940215,3090,28,63297,1495,No,Yes,18338
Arizona,2020/6/26,63.89940215,3379,42,66676,1537,No,Yes,18338
Arizona,2020/6/27,63.89940215,3476,44,70152,1581,No,Yes,18338
Arizona,2020/6/28,63.89940215,3809,13,73961,1594,No,Yes,18338
Arizona,2020/6/29,63.89940215,641,4,74602,1598,No,Yes,18338
Arizona,2020/6/30,63.89940215,4797,47,79399,1645,No,Yes,18338
Arizona,2020/7/1,63.89940215,4753,81,84152,1726,No,Yes,19056
Arizona,2020/7/2,63.89940215,3343,40,87495,1766,No,Yes,19056
Arizona,2020/7/3,63.89940215,4399,36,91894,1802,No,Yes,19056
Arizona,2020/7/4,63.89940215,2722,19,94616,1821,No,Yes,19056
Arizona,2020/7/5,63.89940215,3510,8,98126,1829,No,Yes,19056
Arizona,2020/7/6,63.89940215,3416,3,101542,1832,No,Yes,19056
Arizona,2020/7/7,63.89940215,3617,101,105159,1933,No,Yes,19056
Arizona,2020/7/8,63.89940215,3551,40,108710,1973,No,Yes,20563
Arizona,2020/7/9,63.89940215,4073,74,112783,2047,No,Yes,20563
Arizona,2020/7/10,63.89940215,4164,46,116947,2093,No,Yes,20563
Arizona,2020/7/11,63.89940215,3044,65,119991,2158,No,Yes,20563
Arizona,2020/7/12,63.89940215,2488,81,122479,2239,No,Yes,20563
Arizona,2020/7/13,63.89940215,1438,11,123917,2250,No,Yes,20563
Arizona,2020/7/14,63.89940215,4209,91,128126,2341,No,Yes,20563
Arizona,2020/7/15,63.89940215,3285,101,131411,2442,No,Yes,23676
Arizona,2020/7/16,63.89940215,3319,64,134730,2506,No,Yes,23676
Arizona,2020/7/17,63.89940215,3845,91,138575,2597,No,Yes,23676
Arizona,2020/7/18,63.89940215,2758,136,141333,2733,No,Yes,23676
Arizona,2020/7/19,63.89940215,2311,35,143644,2768,No,Yes,23676
Arizona,2020/7/20,63.89940215,1676,27,145320,2795,No,Yes,23676
Arizona,2020/7/21,63.89940215,3410,123,148730,2918,No,Yes,23676
Arizona,2020/7/22,63.89940215,1929,58,150659,2976,No,Yes,17437
Arizona,2020/7/23,63.89940215,2370,91,153029,3067,No,Yes,17437
Arizona,2020/7/24,63.89940215,3363,89,156392,3156,No,Yes,17437
Arizona,2020/7/25,63.89940215,3663,132,160055,3288,No,Yes,17437
Arizona,2020/7/26,63.89940215,1986,25,162041,3313,No,Yes,17437
Arizona,2020/7/27,63.89940215,1877,7,163918,3320,No,Yes,17437
Arizona,2020/7/28,63.89940215,2076,104,165994,3424,No,Yes,17437
Arizona,2020/7/29,63.89940215,2367,46,168361,3470,No,Yes,11690
Arizona,2020/7/30,63.89940215,2544,158,170905,3628,No,Yes,11690
Arizona,2020/7/31,63.89940215,3203,67,174108,3695,No,Yes,11690
Arizona,2020/8/1,63.89940215,2911,58,177019,3753,No,Yes,11690
Arizona,2020/8/2,63.89940215,1454,16,178473,3769,No,Yes,11690
Arizona,2020/8/3,63.89940215,1033,16,179506,3785,No,Yes,11690
Arizona,2020/8/4,63.89940215,1031,65,180537,3850,No,Yes,11690
Arizona,2020/8/5,63.89940215,1693,83,182230,3933,No,Yes,9467
Arizona,2020/8/6,63.89940215,1514,72,183744,4005,No,Yes,9467
Arizona,2020/8/7,63.89940215,1360,80,185104,4085,No,Yes,9467
Arizona,2020/8/8,63.89940215,1122,55,186226,4140,No,Yes,9467
Arizona,2020/8/9,63.89940215,860,12,187086,4152,No,Yes,9467
Arizona,2020/8/10,63.89940215,548,5,187634,4157,No,Yes,9467
Arizona,2020/8/11,63.89940215,1146,48,188780,4205,No,Yes,9467
Arizona,2020/8/12,63.89940215,742,143,189522,4348,No,Yes,11047
Arizona,2020/8/13,63.89940215,1328,37,190850,4385,No,Yes,11047
Arizona,2020/8/14,63.89940215,960,41,191810,4426,No,Yes,11047
Arizona,2020/8/15,63.89940215,860,71,192670,4497,No,Yes,11047
Arizona,2020/8/16,63.89940215,884,12,193554,4509,No,Yes,11047
Arizona,2020/8/17,63.89940215,473,0,194027,4509,No,Yes,11047
Arizona,2020/8/18,63.89940215,904,26,194931,4535,No,Yes,11047
Arizona,2020/8/19,63.89940215,637,108,195568,4643,No,Yes,8676
Arizona,2020/8/20,63.89940215,737,45,196305,4688,No,Yes,8676
Arizona,2020/8/21,63.89940215,620,10,196925,4698,No,Yes,8676
Arizona,2020/8/22,63.89940215,984,62,197909,4760,No,Yes,8676
Arizona,2020/8/23,63.89940215,208,15,198117,4775,No,Yes,8676
Arizona,2020/8/24,63.89940215,304,0,198421,4775,No,Yes,8676
Arizona,2020/8/25,63.89940215,872,21,199293,4796,No,Yes,8676
Arizona,2020/8/26,63.89940215,202,103,199495,4899,No,Yes,8511
Arizona,2020/8/27,63.89940215,677,33,200172,4932,No,Yes,8511
Arizona,2020/8/28,63.89940215,522,48,200694,4980,No,Yes,8511
Arizona,2020/8/29,63.89940215,623,30,201317,5010,No,Yes,8511
Arizona,2020/8/30,63.89940215,378,23,201695,5033,No,Yes,8511
Arizona,2020/8/31,63.89940215,171,-2,201866,5031,No,Yes,8511
Arizona,2020/9/1,63.89940215,509,17,202375,5048,No,Yes,8511
Arizona,2020/9/2,63.89940215,523,22,202898,5070,No,Yes,8901
Arizona,2020/9/3,63.89940215,1066,63,203964,5133,No,Yes,8901
Arizona,2020/9/4,63.89940215,722,41,204686,5174,No,Yes,8901
Arizona,2020/9/5,63.89940215,832,33,205518,5207,No,Yes,8901
Arizona,2020/9/6,63.89940215,254,14,205772,5221,No,Yes,8901
Arizona,2020/9/7,63.89940215,199,-2,205971,5219,No,Yes,8901
Arizona,2020/9/8,63.89940215,77,2,206048,5221,No,Yes,8901
Arizona,2020/9/9,63.89940215,500,32,206548,5253,No,Yes,8848
Arizona,2020/9/10,63.89940215,454,22,207002,5275,No,Yes,8848
Arizona,2020/9/11,63.89940215,523,15,207525,5290,No,Yes,8848
Arizona,2020/9/12,63.89940215,603,26,208128,5316,No,Yes,8848
Arizona,2020/9/13,63.89940215,386,6,208514,5322,No,Yes,8848
Arizona,2020/9/14,63.89940215,212,0,208726,5322,No,Yes,8848
Arizona,2020/9/15,63.89940215,489,24,209215,5346,No,Yes,8848
Arizona,2020/9/16,63.89940215,696,30,209911,5376,No,Yes,8679
Arizona,2020/9/17,63.89940215,1752,35,211663,5411,No,Yes,8679
Arizona,2020/9/18,63.89940215,2000,44,213663,5455,No,Yes,8679
Arizona,2020/9/19,63.89940215,-112,16,213551,5471,No,Yes,8679
Arizona,2020/9/20,63.89940215,467,9,214018,5480,No,Yes,8679
Arizona,2020/9/21,63.89940215,233,2,214251,5482,No,Yes,8679
Arizona,2020/9/22,63.89940215,595,19,214846,5501,No,Yes,8679
Arizona,2020/9/23,63.89940215,438,25,215284,5526,No,Yes,8805
Arizona,2020/9/24,63.89940215,568,34,215852,5560,No,Yes,8805
Arizona,2020/9/25,63.89940215,515,28,216367,5588,No,Yes,8805
Arizona,2020/9/26,63.89940215,459,35,216826,5623,No,Yes,8805
Arizona,2020/9/27,63.89940215,411,0,217237,5623,No,Yes,8805
Arizona,2020/9/28,63.89940215,276,1,217513,5624,No,Yes,8805
Arizona,2020/9/29,63.89940215,672,8,218185,5632,No,Yes,8805
Arizona,2020/9/30,63.89940215,326,22,218511,5654,No,Yes,7732
Arizona,2020/10/1,63.89940215,703,20,219214,5674,No,Yes,7732
Arizona,2020/10/2,63.89940215,564,19,219778,5693,No,Yes,7732
Arizona,2020/10/3,63.89940215,625,12,220403,5705,No,Yes,7732
Arizona,2020/10/4,63.89940215,354,1,220757,5706,No,Yes,7732
Arizona,2020/10/5,63.89940215,334,1,221091,5707,No,Yes,7732
Arizona,2020/10/6,63.89940215,846,6,221937,5713,No,Yes,7732
Arizona,2020/10/7,63.89940215,621,20,222558,5733,No,Yes,8581
Arizona,2020/10/8,63.89940215,849,10,223407,5743,No,Yes,8581
Arizona,2020/10/9,63.89940215,694,3,224101,5746,No,Yes,8581
Arizona,2020/10/10,63.89940215,884,13,224985,5759,No,Yes,8581
Arizona,2020/10/11,63.89940215,590,0,225575,5759,No,Yes,8581
Arizona,2020/10/12,63.89940215,497,0,226072,5759,No,Yes,8581
Arizona,2020/10/13,63.89940215,677,8,226749,5767,No,Yes,8581
Arizona,2020/10/14,63.89940215,911,5,227660,5772,No,Yes,7964
Arizona,2020/10/15,63.89940215,1088,17,228748,5789,No,Yes,7964
Arizona,2020/10/16,63.89940215,760,17,229508,5806,No,Yes,7964
Arizona,2020/10/17,63.89940215,904,18,230412,5824,No,Yes,7964
Arizona,2020/10/18,63.89940215,737,3,231149,5827,No,Yes,7964
Arizona,2020/10/19,63.89940215,784,3,231933,5830,No,Yes,7964
Arizona,2020/10/20,63.89940215,1006,7,232939,5837,No,Yes,7964
Arizona,2020/10/21,63.89940215,1009,17,233948,5854,No,Yes,7126
Arizona,2020/10/22,63.89940215,966,5,234914,5859,No,Yes,7126
Arizona,2020/10/23,63.89940215,996,6,235910,5865,No,Yes,7126
Arizona,2020/10/24,63.89940215,988,5,236898,5870,No,Yes,7126
Arizona,2020/10/25,63.89940215,1302,4,238200,5874,No,Yes,7126
Arizona,2020/10/26,63.89940215,993,1,239193,5875,No,Yes,7126
Arizona,2020/10/27,63.89940215,965,16,240158,5891,No,Yes,7126
Arizona,2020/10/28,63.89940215,1101,15,241259,5906,No,Yes,7060
Arizona,2020/10/29,63.89940215,1251,14,242510,5920,No,Yes,7060
Arizona,2020/10/30,63.89940215,1589,14,244099,5934,No,Yes,7060
Arizona,2020/10/31,63.89940215,1863,45,245962,5979,No,Yes,7060
Arizona,2020/11/1,63.89940215,1522,2,247484,5981,No,Yes,7060
Arizona,2020/11/2,63.89940215,809,1,248293,5982,No,Yes,7060
Arizona,2020/11/3,63.89940215,1548,40,249841,6022,No,Yes,7060
Arizona,2020/11/4,63.89940215,1012,37,250853,6059,No,Yes,8764
Arizona,2020/11/5,63.89940215,1990,28,252843,6087,No,Yes,8764
Arizona,2020/11/6,63.89940215,2118,24,254961,6111,No,Yes,8764
Arizona,2020/11/7,63.89940215,2423,36,257384,6147,No,Yes,8764
Arizona,2020/11/8,63.89940215,1915,17,259299,6164,No,Yes,8764
Arizona,2020/11/9,63.89940215,1347,0,260646,6164,No,Yes,8764
Arizona,2020/11/10,63.89940215,2799,34,263445,6198,No,Yes,8764
Arizona,2020/11/11,63.89940215,1750,30,265195,6228,No,Yes,9262
Arizona,2020/11/12,63.89940215,1449,12,266644,6240,No,Yes,9262
Arizona,2020/11/13,63.89940215,3952,17,270596,6257,No,Yes,9262
Arizona,2020/11/14,63.89940215,2804,43,273400,6300,No,Yes,9262
Arizona,2020/11/15,63.89940215,2123,2,275523,6302,No,Yes,9262
Arizona,2020/11/16,63.89940215,1656,0,277179,6302,No,Yes,9262
Arizona,2020/11/17,63.89940215,4105,18,281284,6320,No,Yes,9262
Arizona,2020/11/18,63.89940215,3270,45,284554,6365,No,Yes,11813
Arizona,2020/11/19,63.89940215,4253,19,288807,6384,No,Yes,11813
Arizona,2020/11/20,63.89940215,4073,43,292880,6427,No,Yes,11813
Arizona,2020/11/21,63.89940215,4117,32,296997,6459,No,Yes,11813
Arizona,2020/11/22,63.89940215,2701,5,299698,6464,No,Yes,11813
Arizona,2020/11/23,63.89940215,3490,1,303188,6465,No,Yes,11813
Arizona,2020/11/24,63.89940215,4755,50,307943,6515,No,Yes,11813
Arizona,2020/11/25,63.89940215,3784,14,311727,6529,No,Yes,7061
Arizona,2020/11/26,63.89940215,2599,39,314326,6568,No,Yes,7061
Arizona,2020/11/27,63.89940215,4369,20,318695,6588,No,Yes,7061
Arizona,2020/11/28,63.89940215,4079,36,322774,6624,No,Yes,7061
Arizona,2020/11/29,63.89940215,3221,11,325995,6635,No,Yes,7061
Arizona,2020/11/30,63.89940215,1051,5,327046,6640,No,Yes,7061
Arizona,2020/12/1,63.89940215,11208,52,338254,6692,No,Yes,7061
Arizona,2020/12/2,63.89940215,4671,63,342925,6755,No,Yes,7656
Arizona,2020/12/3,63.89940215,5209,79,348134,6834,No,Yes,7656
Arizona,2020/12/4,63.89940215,6920,51,355054,6885,No,Yes,7656
Arizona,2020/12/5,63.89940215,6132,55,361186,6940,No,Yes,7656
Arizona,2020/12/6,63.89940215,3090,10,364276,6950,No,Yes,7656
Arizona,2020/12/7,63.89940215,2088,0,366364,6950,No,Yes,7656
Arizona,2020/12/8,63.89940215,13298,35,379662,6985,No,Yes,7656
Arizona,2020/12/9,63.89940215,4579,96,384241,7081,No,Yes,7568
Arizona,2020/12/10,63.89940215,5806,92,390047,7173,No,Yes,7568
Arizona,2020/12/11,63.89940215,8103,77,398150,7250,No,Yes,7568
Arizona,2020/12/12,63.89940215,7506,90,405656,7340,No,Yes,7568
Arizona,2020/12/13,63.89940215,2990,17,408646,7357,No,Yes,7568
Arizona,2020/12/14,63.89940215,11813,1,420459,7358,No,Yes,7568
Arizona,2020/12/15,63.89940215,6662,70,427121,7428,No,Yes,7568
Arizona,2020/12/16,63.89940215,4209,130,431330,7558,No,Yes,7543
Arizona,2020/12/17,63.89940215,7184,153,438514,7711,No,Yes,7543
Arizona,2020/12/18,63.89940215,5524,108,444038,7819,No,Yes,7543
Arizona,2020/12/19,63.89940215,6769,137,450807,7956,No,Yes,7543
Arizona,2020/12/20,63.89940215,2794,15,453601,7971,No,Yes,7543
Arizona,2020/12/21,63.89940215,7744,1,461345,7972,No,Yes,7543
Arizona,2020/12/22,63.89940215,9006,161,470351,8133,No,Yes,7543
Arizona,2020/12/23,63.89940215,5355,51,475706,8184,No,Yes,5506
Arizona,2020/12/24,63.89940215,7796,117,483502,8301,No,Yes,5506
Arizona,2020/12/25,63.89940215,3491,108,486993,8409,No,Yes,5506
Arizona,2020/12/26,63.89940215,6284,15,493277,8424,No,Yes,5506
Arizona,2020/12/27,63.89940215,1212,3,494489,8427,No,Yes,5506
Arizona,2020/12/28,63.89940215,10127,42,504616,8469,No,Yes,5506
Arizona,2020/12/29,63.89940215,5932,178,510548,8647,No,Yes,5506
Arizona,2020/12/30,63.89940215,4818,79,515366,8726,No,Yes,10986
Arizona,2020/12/31,63.89940215,8463,153,523829,8879,No,Yes,10986
Arizona,2021/1/1,63.89940215,6438,136,530267,9015,No,Yes,10986
Arizona,2021/1/2,63.89940215,8895,46,539162,9061,No,Yes,10986
Arizona,2021/1/3,63.89940215,17222,0,556384,9061,No,Yes,10986
Arizona,2021/1/4,63.89940215,5158,3,561542,9064,No,Yes,10986
Arizona,2021/1/5,63.89940215,10134,290,571676,9354,No,Yes,10986
Arizona,2021/1/6,63.89940215,6947,113,578623,9467,No,Yes,14084
Arizona,2021/1/7,63.89940215,9760,297,588383,9764,No,Yes,14084
Arizona,2021/1/8,63.89940215,13763,206,602146,9970,No,Yes,14084
Arizona,2021/1/9,63.89940215,9754,113,611900,10083,No,Yes,14084
Arizona,2021/1/10,63.89940215,6646,58,618546,10141,No,Yes,14084
Arizona,2021/1/11,63.89940215,9225,6,627771,10147,No,Yes,14084
Arizona,2021/1/12,63.89940215,10968,390,638739,10537,No,Yes,14084
Arizona,2021/1/13,63.89940215,4944,152,643683,10689,No,Yes,11980
Arizona,2021/1/14,63.89940215,9863,187,653546,10876,No,Yes,11980
Arizona,2021/1/15,63.89940215,9051,184,662597,11060,No,Yes,11980
Arizona,2021/1/16,63.89940215,7637,188,670234,11248,No,Yes,11980
Arizona,2021/1/17,63.89940215,3648,18,673882,11266,No,Yes,11980
Arizona,2021/1/18,63.89940215,5400,-1,679282,11265,No,Yes,11980
Arizona,2021/1/19,63.89940215,6746,1,686028,11266,No,Yes,11980
Arizona,2021/1/20,63.89940215,7678,298,693706,11564,No,Yes,11615
Arizona,2021/1/21,63.89940215,9543,249,703249,11813,No,Yes,11615
Arizona,2021/1/22,63.89940215,7024,201,710273,12014,No,Yes,11615
Arizona,2021/1/23,63.89940215,7320,156,717593,12170,No,Yes,11615
Arizona,2021/1/24,63.89940215,4981,68,722574,12238,No,Yes,11615
Arizona,2021/1/25,63.89940215,5657,1,728231,12239,No,Yes,11615
Arizona,2021/1/26,63.89940215,6382,250,734613,12489,No,Yes,11615
Arizona,2021/1/27,63.89940215,5986,179,740599,12668,No,Yes,12664
Arizona,2021/1/28,63.89940215,5377,193,745976,12861,No,Yes,12664
Arizona,2021/1/29,63.89940215,4811,186,750787,13047,No,Yes,12664
Arizona,2021/1/30,63.89940215,5240,64,756027,13111,No,Yes,12664
Arizona,2021/1/31,63.89940215,2549,9,758576,13120,No,Yes,12664
Arizona,2021/2/1,63.89940215,3882,4,762458,13124,No,Yes,12664
Arizona,2021/2/2,63.89940215,3987,291,766445,13415,No,Yes,12664
Arizona,2021/2/3,63.89940215,2852,178,769297,13593,No,Yes,13464
Arizona,2021/2/4,63.89940215,4339,199,773636,13792,No,Yes,13464
Arizona,2021/2/5,63.89940215,3402,173,777038,13965,No,Yes,13464
Arizona,2021/2/6,63.89940215,3162,74,780200,14039,No,Yes,13464
Arizona,2021/2/7,63.89940215,672,12,780872,14051,No,Yes,13464
Arizona,2021/2/8,63.89940215,2357,4,783229,14055,No,Yes,13464
Arizona,2021/2/9,63.89940215,5311,262,788540,14317,No,Yes,13464
Arizona,2021/2/10,63.89940215,1731,190,790271,14507,No,Yes,12087
Arizona,2021/2/11,63.89940215,2424,183,792695,14690,No,Yes,12087
Arizona,2021/2/12,63.89940215,1529,153,794224,14843,No,Yes,12087
Arizona,2021/2/13,63.89940215,1870,114,796094,14957,No,Yes,12087
Arizona,2021/2/14,63.89940215,1443,21,797537,14978,No,Yes,12087
Arizona,2021/2/15,63.89940215,1308,0,798845,14978,No,Yes,12087
Arizona,2021/2/16,63.89940215,1099,3,799944,14981,No,Yes,12087
Arizona,2021/2/17,63.89940215,1797,103,801741,15084,No,Yes,11395
Arizona,2021/2/18,63.89940215,1417,210,803158,15294,No,Yes,11395
Arizona,2021/2/19,63.89940215,1879,145,805037,15439,No,Yes,11395
Arizona,2021/2/20,63.89940215,2126,41,807163,15480,No,Yes,11395
Arizona,2021/2/21,63.89940215,1084,25,808247,15505,No,Yes,11395
Arizona,2021/2/22,63.89940215,1652,-3,809899,15502,No,Yes,11395
Arizona,2021/2/23,63.89940215,1661,149,811560,15651,No,Yes,11395
Arizona,2021/2/24,63.89940215,1093,42,812653,15693,No,Yes,11395
Arizona,2021/2/25,63.89940215,1245,128,813898,15821,No,Yes,11395
Arizona,2021/2/26,63.89940215,1447,76,815345,15897,No,Yes,11395
Arizona,2021/2/27,63.89940215,989,70,816334,15967,No,Yes,11395
Arizona,2021/2/28,63.89940215,898,13,817232,15980,No,Yes,11395
Arizona,2021/3/1,63.89940215,1036,-1,818268,15979,No,Yes,11395
Arizona,2021/3/2,63.89940215,1013,86,819281,16065,No,Yes,11395
Arizona,2021/3/3,63.89940215,1280,24,820561,16089,No,Yes,11395
Arizona,2021/3/4,63.89940215,913,96,821474,16185,No,Yes,11395
Arkansas,2020/3/1,56.8281862,0,0,0,0,No,No,1575
Arkansas,2020/3/2,56.8281862,0,0,0,0,No,No,1575
Arkansas,2020/3/3,56.8281862,0,0,0,0,No,No,1575
Arkansas,2020/3/4,56.8281862,0,0,0,0,No,No,1663
Arkansas,2020/3/5,56.8281862,0,0,0,0,No,No,1663
Arkansas,2020/3/6,56.8281862,0,0,0,0,No,No,1663
Arkansas,2020/3/7,56.8281862,0,0,0,0,No,No,1663
Arkansas,2020/3/8,56.8281862,0,0,0,0,No,No,1663
Arkansas,2020/3/9,56.8281862,0,0,0,0,No,No,1663
Arkansas,2020/3/10,56.8281862,0,0,0,0,No,No,1663
Arkansas,2020/3/11,56.8281862,1,0,1,0,No,No,1819
Arkansas,2020/3/12,56.8281862,5,0,6,0,No,No,1819
Arkansas,2020/3/13,56.8281862,1,0,7,0,No,No,1819
Arkansas,2020/3/14,56.8281862,2,0,9,0,No,No,1819
Arkansas,2020/3/15,56.8281862,7,0,16,0,No,No,1819
Arkansas,2020/3/16,56.8281862,6,0,22,0,No,No,1819
Arkansas,2020/3/17,56.8281862,0,0,22,0,No,No,1819
Arkansas,2020/3/18,56.8281862,11,0,33,0,No,No,10892
Arkansas,2020/3/19,56.8281862,29,0,62,0,No,No,10892
Arkansas,2020/3/20,56.8281862,38,0,100,0,No,No,10892
Arkansas,2020/3/21,56.8281862,18,0,118,0,No,No,10892
Arkansas,2020/3/22,56.8281862,47,0,165,0,No,No,10892
Arkansas,2020/3/23,56.8281862,36,0,201,0,No,No,10892
Arkansas,2020/3/24,56.8281862,30,2,231,2,No,No,10892
Arkansas,2020/3/25,56.8281862,76,0,307,2,No,No,80984
Arkansas,2020/3/26,56.8281862,43,1,350,3,No,No,80984
Arkansas,2020/3/27,56.8281862,35,0,385,3,No,No,80984
Arkansas,2020/3/28,56.8281862,24,2,409,5,No,No,80984
Arkansas,2020/3/29,56.8281862,40,1,449,6,No,No,80984
Arkansas,2020/3/30,56.8281862,59,1,508,7,No,No,80984
Arkansas,2020/3/31,56.8281862,56,1,564,8,No,No,80984
Arkansas,2020/4/1,56.8281862,60,2,624,10,No,No,106739
Arkansas,2020/4/2,56.8281862,59,2,683,12,No,No,106739
Arkansas,2020/4/3,56.8281862,55,0,738,12,No,No,106739
Arkansas,2020/4/4,56.8281862,5,2,743,14,No,No,106739
Arkansas,2020/4/5,56.8281862,110,2,853,16,No,No,106739
Arkansas,2020/4/6,56.8281862,74,0,927,16,No,No,106739
Arkansas,2020/4/7,56.8281862,70,2,997,18,No,No,106739
Arkansas,2020/4/8,56.8281862,80,0,1077,18,No,No,77515
Arkansas,2020/4/9,56.8281862,69,3,1146,21,No,No,77515
Arkansas,2020/4/10,56.8281862,56,3,1202,24,No,No,77515
Arkansas,2020/4/11,56.8281862,26,1,1228,25,No,No,77515
Arkansas,2020/4/12,56.8281862,52,2,1280,27,No,No,77515
Arkansas,2020/4/13,56.8281862,195,3,1475,30,No,No,77515
Arkansas,2020/4/14,56.8281862,23,2,1498,32,No,No,77515
Arkansas,2020/4/15,56.8281862,101,2,1599,34,No,No,66432
Arkansas,2020/4/16,56.8281862,21,3,1620,37,No,No,66432
Arkansas,2020/4/17,56.8281862,75,0,1695,37,No,No,66432
Arkansas,2020/4/18,56.8281862,82,1,1777,38,No,No,66432
Arkansas,2020/4/19,56.8281862,4,1,1781,39,No,No,66432
Arkansas,2020/4/20,56.8281862,190,3,1971,42,No,No,66432
Arkansas,2020/4/21,56.8281862,291,1,2262,43,No,No,66432
Arkansas,2020/4/22,56.8281862,130,1,2392,44,No,No,74966
Arkansas,2020/4/23,56.8281862,207,1,2599,45,No,No,74966
Arkansas,2020/4/24,56.8281862,211,2,2810,47,No,No,74966
Arkansas,2020/4/25,56.8281862,99,1,2909,48,No,No,74966
Arkansas,2020/4/26,56.8281862,92,2,3001,50,No,No,74966
Arkansas,2020/4/27,56.8281862,68,1,3069,51,No,No,74966
Arkansas,2020/4/28,56.8281862,58,6,3127,57,No,No,74966
Arkansas,2020/4/29,56.8281862,80,2,3207,59,No,No,28985
Arkansas,2020/4/30,56.8281862,74,2,3281,61,No,No,28985
Arkansas,2020/5/1,56.8281862,29,3,3310,64,No,No,28985
Arkansas,2020/5/2,56.8281862,62,8,3372,72,No,No,28985
Arkansas,2020/5/3,56.8281862,59,4,3431,76,No,No,28985
Arkansas,2020/5/4,56.8281862,38,4,3469,80,No,No,28985
Arkansas,2020/5/5,56.8281862,56,3,3525,83,No,No,28985
Arkansas,2020/5/6,56.8281862,86,4,3611,87,No,No,26666
Arkansas,2020/5/7,56.8281862,83,1,3694,88,No,No,26666
Arkansas,2020/5/8,56.8281862,53,0,3747,88,No,No,26666
Arkansas,2020/5/9,56.8281862,0,0,3747,88,No,No,26666
Arkansas,2020/5/10,56.8281862,265,3,4012,91,No,No,26666
Arkansas,2020/5/11,56.8281862,31,3,4043,94,No,No,26666
Arkansas,2020/5/12,56.8281862,121,1,4164,95,No,No,26666
Arkansas,2020/5/13,56.8281862,72,2,4236,97,No,No,25150
Arkansas,2020/5/14,56.8281862,130,1,4366,98,No,No,25150
Arkansas,2020/5/15,56.8281862,97,0,4463,98,No,No,25150
Arkansas,2020/5/16,56.8281862,115,0,4578,98,No,No,25150
Arkansas,2020/5/17,56.8281862,181,0,4759,98,No,No,25150
Arkansas,2020/5/18,56.8281862,54,2,4813,100,No,No,25150
Arkansas,2020/5/19,56.8281862,110,2,4923,102,No,No,25150
Arkansas,2020/5/20,56.8281862,80,5,5003,107,No,No,27919
Arkansas,2020/5/21,56.8281862,455,3,5458,110,No,No,27919
Arkansas,2020/5/22,56.8281862,154,3,5612,113,No,No,27919
Arkansas,2020/5/23,56.8281862,163,2,5775,115,No,No,27919
Arkansas,2020/5/24,56.8281862,147,1,5922,116,No,No,27919
Arkansas,2020/5/25,56.8281862,107,1,6029,117,No,No,27919
Arkansas,2020/5/26,56.8281862,151,2,6180,119,No,No,27919
Arkansas,2020/5/27,56.8281862,97,1,6277,120,No,No,21335
Arkansas,2020/5/28,56.8281862,261,5,6538,125,No,No,21335
Arkansas,2020/5/29,56.8281862,239,7,6777,132,No,No,21335
Arkansas,2020/5/30,56.8281862,236,1,7013,133,No,No,21335
Arkansas,2020/5/31,56.8281862,240,0,7253,133,No,No,21335
Arkansas,2020/6/1,56.8281862,190,0,7443,133,No,No,21335
Arkansas,2020/6/2,56.8281862,375,3,7818,136,No,No,21335
Arkansas,2020/6/3,56.8281862,249,6,8067,142,No,No,19949
Arkansas,2020/6/4,56.8281862,358,9,8425,151,No,No,19949
Arkansas,2020/6/5,56.8281862,226,1,8651,152,No,No,19949
Arkansas,2020/6/6,56.8281862,450,2,9101,154,No,No,19949
Arkansas,2020/6/7,56.8281862,325,0,9426,154,No,No,19949
Arkansas,2020/6/8,56.8281862,314,1,9740,155,No,No,19949
Arkansas,2020/6/9,56.8281862,340,6,10080,161,No,No,19949
Arkansas,2020/6/10,56.8281862,288,4,10368,165,No,No,18367
Arkansas,2020/6/11,56.8281862,448,6,10816,171,No,No,18367
Arkansas,2020/6/12,56.8281862,731,5,11547,176,No,No,18367
Arkansas,2020/6/13,56.8281862,548,1,12095,177,No,No,18367
Arkansas,2020/6/14,56.8281862,406,2,12501,179,No,No,18367
Arkansas,2020/6/15,56.8281862,416,3,12917,182,No,No,18367
Arkansas,2020/6/16,56.8281862,274,6,13191,188,No,No,18367
Arkansas,2020/6/17,56.8281862,415,9,13606,197,No,No,18671
Arkansas,2020/6/18,56.8281862,322,11,13928,208,No,No,18671
Arkansas,2020/6/19,56.8281862,703,6,14631,214,No,No,18671
Arkansas,2020/6/20,56.8281862,511,10,15142,224,No,No,18671
Arkansas,2020/6/21,56.8281862,419,1,15561,225,No,No,18671
Arkansas,2020/6/22,56.8281862,522,2,16083,227,No,No,18671
Arkansas,2020/6/23,56.8281862,595,10,16678,237,No,No,18671
Arkansas,2020/6/24,56.8281862,697,3,17375,240,No,No,18338
Arkansas,2020/6/25,56.8281862,687,0,18062,240,No,No,18338
Arkansas,2020/6/26,56.8281862,678,9,18740,249,No,No,18338
Arkansas,2020/6/27,56.8281862,570,10,19310,259,No,No,18338
Arkansas,2020/6/28,56.8281862,508,5,19818,264,No,No,18338
Arkansas,2020/6/29,56.8281862,439,1,20257,265,No,No,18338
Arkansas,2020/6/30,56.8281862,520,5,20777,270,No,No,18338
Arkansas,2020/7/1,56.8281862,420,7,21197,277,No,No,19056
Arkansas,2020/7/2,56.8281862,878,2,22075,279,No,No,19056
Arkansas,2020/7/3,56.8281862,547,2,22622,281,No,No,19056
Arkansas,2020/7/4,56.8281862,587,5,23209,286,No,No,19056
Arkansas,2020/7/5,56.8281862,605,1,23814,287,No,No,19056
Arkansas,2020/7/6,56.8281862,439,5,24253,292,No,No,19056
Arkansas,2020/7/7,56.8281862,259,9,24512,301,No,No,19056
Arkansas,2020/7/8,56.8281862,734,4,25246,305,No,No,20563
Arkansas,2020/7/9,56.8281862,806,4,26052,309,No,No,20563
Arkansas,2020/7/10,56.8281862,751,4,26803,313,No,No,20563
Arkansas,2020/7/11,56.8281862,1061,6,27864,319,No,No,20563
Arkansas,2020/7/12,56.8281862,503,2,28367,321,No,No,20563
Arkansas,2020/7/13,56.8281862,572,2,28939,323,No,No,20563
Arkansas,2020/7/14,56.8281862,794,8,29733,331,No,No,20563
Arkansas,2020/7/15,56.8281862,564,4,30297,335,No,No,23676
Arkansas,2020/7/16,56.8281862,817,6,31114,341,No,No,23676
Arkansas,2020/7/17,56.8281862,648,12,31762,353,No,No,23676
Arkansas,2020/7/18,56.8281862,771,4,32533,357,No,No,23676
Arkansas,2020/7/19,56.8281862,695,0,33228,357,No,No,23676
Arkansas,2020/7/20,56.8281862,699,6,33927,363,No,Yes,23676
Arkansas,2020/7/21,56.8281862,728,11,34655,374,No,Yes,23676
Arkansas,2020/7/22,56.8281862,591,6,35246,380,No,Yes,17437
Arkansas,2020/7/23,56.8281862,1013,6,36259,386,No,Yes,17437
Arkansas,2020/7/24,56.8281862,990,8,37249,394,No,Yes,17437
Arkansas,2020/7/25,56.8281862,732,5,37981,399,No,Yes,17437
Arkansas,2020/7/26,56.8281862,642,2,38623,401,No,Yes,17437
Arkansas,2020/7/27,56.8281862,824,7,39447,408,No,Yes,17437
Arkansas,2020/7/28,56.8281862,734,20,40181,428,No,Yes,17437
Arkansas,2020/7/29,56.8281862,787,6,40968,434,No,Yes,11690
Arkansas,2020/7/30,56.8281862,791,8,41759,442,No,Yes,11690
Arkansas,2020/7/31,56.8281862,752,11,42511,453,No,Yes,11690
Arkansas,2020/8/1,56.8281862,662,5,43173,458,No,Yes,11690
Arkansas,2020/8/2,56.8281862,637,6,43810,464,No,Yes,11690
Arkansas,2020/8/3,56.8281862,787,11,44597,475,No,Yes,11690
Arkansas,2020/8/4,56.8281862,784,15,45381,490,No,Yes,11690
Arkansas,2020/8/5,56.8281862,912,18,46293,508,No,Yes,9467
Arkansas,2020/8/6,56.8281862,735,7,47028,515,No,Yes,9467
Arkansas,2020/8/7,56.8281862,1011,6,48039,521,No,Yes,9467
Arkansas,2020/8/8,56.8281862,772,14,48811,535,No,Yes,9467
Arkansas,2020/8/9,56.8281862,572,9,49383,544,No,Yes,9467
Arkansas,2020/8/10,56.8281862,645,11,50028,555,No,Yes,9467
Arkansas,2020/8/11,56.8281862,383,11,50411,566,No,Yes,9467
Arkansas,2020/8/12,56.8281862,703,7,51114,573,No,Yes,11047
Arkansas,2020/8/13,56.8281862,652,9,51766,582,No,Yes,11047
Arkansas,2020/8/14,56.8281862,626,5,52392,587,No,Yes,11047
Arkansas,2020/8/15,56.8281862,-400,13,51992,600,No,Yes,11047
Arkansas,2020/8/16,56.8281862,673,-1,52665,599,No,Yes,11047
Arkansas,2020/8/17,56.8281862,412,4,53077,603,No,Yes,11047
Arkansas,2020/8/18,56.8281862,410,16,53487,619,No,Yes,11047
Arkansas,2020/8/19,56.8281862,729,12,54216,631,No,Yes,8676
Arkansas,2020/8/20,56.8281862,549,10,54765,641,No,Yes,8676
Arkansas,2020/8/21,56.8281862,887,22,55652,663,No,Yes,8676
Arkansas,2020/8/22,56.8281862,547,11,56199,674,No,Yes,8676
Arkansas,2020/8/23,56.8281862,375,13,56574,687,No,Yes,8676
Arkansas,2020/8/24,56.8281862,320,9,56894,696,No,Yes,8676
Arkansas,2020/8/25,56.8281862,480,15,57374,711,No,Yes,8676
Arkansas,2020/8/26,56.8281862,649,21,58023,732,No,Yes,8511
Arkansas,2020/8/27,56.8281862,722,7,58745,739,No,Yes,8511
Arkansas,2020/8/28,56.8281862,838,17,59583,756,No,Yes,8511
Arkansas,2020/8/29,56.8281862,795,16,60378,772,No,Yes,8511
Arkansas,2020/8/30,56.8281862,478,12,60856,784,No,Yes,8511
Arkansas,2020/8/31,56.8281862,368,13,61224,797,No,Yes,8511
Arkansas,2020/9/1,56.8281862,273,17,61497,814,No,Yes,8511
Arkansas,2020/9/2,56.8281862,615,27,62112,841,No,Yes,8901
Arkansas,2020/9/3,56.8281862,1392,20,63504,861,No,Yes,8901
Arkansas,2020/9/4,56.8281862,1174,12,64678,873,No,Yes,8901
Arkansas,2020/9/5,56.8281862,548,9,65226,882,No,Yes,8901
Arkansas,2020/9/6,56.8281862,698,12,65924,894,No,Yes,8901
Arkansas,2020/9/7,56.8281862,356,14,66280,908,No,Yes,8901
Arkansas,2020/9/8,56.8281862,477,9,66757,917,No,Yes,8901
Arkansas,2020/9/9,56.8281862,498,11,67255,928,No,Yes,8848
Arkansas,2020/9/10,56.8281862,548,12,67803,940,No,Yes,8848
Arkansas,2020/9/11,56.8281862,1184,13,68987,953,No,Yes,8848
Arkansas,2020/9/12,56.8281862,723,16,69710,969,No,Yes,8848
Arkansas,2020/9/13,56.8281862,509,12,70219,981,No,Yes,8848
Arkansas,2020/9/14,56.8281862,408,11,70627,992,No,Yes,8848
Arkansas,2020/9/15,56.8281862,870,158,71497,1150,No,Yes,8848
Arkansas,2020/9/16,56.8281862,722,7,72219,1157,No,Yes,8679
Arkansas,2020/9/17,56.8281862,992,9,73211,1166,No,Yes,8679
Arkansas,2020/9/18,56.8281862,871,7,74082,1173,No,Yes,8679
Arkansas,2020/9/19,56.8281862,1078,8,75160,1181,No,Yes,8679
Arkansas,2020/9/20,56.8281862,563,0,75723,1181,No,Yes,8679
Arkansas,2020/9/21,56.8281862,641,16,76364,1197,No,Yes,8679
Arkansas,2020/9/22,56.8281862,617,12,76981,1209,No,Yes,8679
Arkansas,2020/9/23,56.8281862,982,20,77963,1229,No,Yes,8805
Arkansas,2020/9/24,56.8281862,1086,17,79049,1246,No,Yes,8805
Arkansas,2020/9/25,56.8281862,897,20,79946,1266,No,Yes,8805
Arkansas,2020/9/26,56.8281862,809,19,80755,1285,No,Yes,8805
Arkansas,2020/9/27,56.8281862,487,23,81242,1308,No,Yes,8805
Arkansas,2020/9/28,56.8281862,807,21,82049,1329,No,Yes,8805
Arkansas,2020/9/29,56.8281862,706,21,82755,1350,No,Yes,8805
Arkansas,2020/9/30,56.8281862,942,19,83697,1369,No,Yes,7732
Arkansas,2020/10/1,56.8281862,1124,15,84821,1384,No,Yes,7732
Arkansas,2020/10/2,56.8281862,958,7,85779,1391,No,Yes,7732
Arkansas,2020/10/3,56.8281862,746,16,86525,1407,No,Yes,7732
Arkansas,2020/10/4,56.8281862,488,18,87013,1425,No,Yes,7732
Arkansas,2020/10/5,56.8281862,417,22,87430,1447,No,Yes,7732
Arkansas,2020/10/6,56.8281862,641,22,88071,1469,No,Yes,7732
Arkansas,2020/10/7,56.8281862,809,13,88880,1482,No,Yes,8581
Arkansas,2020/10/8,56.8281862,1265,21,90145,1503,No,Yes,8581
Arkansas,2020/10/9,56.8281862,1167,27,91312,1530,No,Yes,8581
Arkansas,2020/10/10,56.8281862,908,22,92220,1552,No,Yes,8581
Arkansas,2020/10/11,56.8281862,613,17,92833,1569,No,Yes,8581
Arkansas,2020/10/12,56.8281862,654,17,93487,1586,No,Yes,8581
Arkansas,2020/10/13,56.8281862,680,25,94167,1611,No,Yes,8581
Arkansas,2020/10/14,56.8281862,1079,23,95246,1634,No,Yes,7964
Arkansas,2020/10/15,56.8281862,1278,11,96524,1645,No,Yes,7964
Arkansas,2020/10/16,56.8281862,1015,20,97539,1665,No,Yes,7964
Arkansas,2020/10/17,56.8281862,883,19,98422,1684,No,Yes,7964
Arkansas,2020/10/18,56.8281862,644,20,99066,1704,No,Yes,7964
Arkansas,2020/10/19,56.8281862,531,10,99597,1714,No,Yes,7964
Arkansas,2020/10/20,56.8281862,844,14,100441,1728,No,Yes,7964
Arkansas,2020/10/21,56.8281862,1155,23,101596,1751,No,Yes,7126
Arkansas,2020/10/22,56.8281862,1202,21,102798,1772,No,Yes,7126
Arkansas,2020/10/23,56.8281862,1337,10,104135,1782,No,Yes,7126
Arkansas,2020/10/24,56.8281862,1183,15,105318,1797,No,Yes,7126
Arkansas,2020/10/25,56.8281862,797,15,106115,1812,No,Yes,7126
Arkansas,2020/10/26,56.8281862,612,21,106727,1833,No,Yes,7126
Arkansas,2020/10/27,56.8281862,952,24,107679,1857,No,Yes,7126
Arkansas,2020/10/28,56.8281862,961,18,108640,1875,No,Yes,7060
Arkansas,2020/10/29,56.8281862,1072,19,109712,1894,No,Yes,7060
Arkansas,2020/10/30,56.8281862,1162,6,110874,1900,No,Yes,7060
Arkansas,2020/10/31,56.8281862,1316,25,112190,1925,No,Yes,7060
Arkansas,2020/11/1,56.8281862,867,33,113057,1958,No,Yes,7060
Arkansas,2020/11/2,56.8281862,584,27,113641,1985,No,Yes,7060
Arkansas,2020/11/3,56.8281862,878,18,114519,2003,No,Yes,7060
Arkansas,2020/11/4,56.8281862,1293,23,115812,2026,No,Yes,8764
Arkansas,2020/11/5,56.8281862,1548,11,117360,2037,No,Yes,8764
Arkansas,2020/11/6,56.8281862,1870,19,119230,2056,No,Yes,8764
Arkansas,2020/11/7,56.8281862,1598,12,120828,2068,No,Yes,8764
Arkansas,2020/11/8,56.8281862,1038,17,121866,2085,No,Yes,8764
Arkansas,2020/11/9,56.8281862,945,23,122811,2108,No,Yes,8764
Arkansas,2020/11/10,56.8281862,1424,4,124235,2112,No,Yes,8764
Arkansas,2020/11/11,56.8281862,1962,14,126197,2126,No,Yes,9262
Arkansas,2020/11/12,56.8281862,1809,18,128006,2144,No,Yes,9262
Arkansas,2020/11/13,56.8281862,2312,4,130318,2148,No,Yes,9262
Arkansas,2020/11/14,56.8281862,1848,11,132166,2159,No,Yes,9262
Arkansas,2020/11/15,56.8281862,874,24,133040,2183,No,Yes,9262
Arkansas,2020/11/16,56.8281862,1308,42,134348,2225,No,Yes,9262
Arkansas,2020/11/17,56.8281862,1554,20,135902,2245,No,Yes,9262
Arkansas,2020/11/18,56.8281862,1715,30,137617,2275,No,Yes,11813
Arkansas,2020/11/19,56.8281862,2238,22,139855,2297,No,Yes,11813
Arkansas,2020/11/20,56.8281862,2061,24,141916,2321,No,Yes,11813
Arkansas,2020/11/21,56.8281862,1905,16,143821,2337,No,Yes,11813
Arkansas,2020/11/22,56.8281862,1352,20,145173,2357,No,Yes,11813
Arkansas,2020/11/23,56.8281862,1017,30,146190,2387,No,Yes,11813
Arkansas,2020/11/24,56.8281862,2122,18,148312,2405,No,Yes,11813
Arkansas,2020/11/25,56.8281862,1965,20,150277,2425,No,Yes,7061
Arkansas,2020/11/26,56.8281862,2348,11,152625,2436,No,Yes,7061
Arkansas,2020/11/27,56.8281862,1052,0,153677,2436,No,Yes,7061
Arkansas,2020/11/28,56.8281862,1349,13,155026,2449,No,Yes,7061
Arkansas,2020/11/29,56.8281862,1221,21,156247,2470,No,Yes,7061
Arkansas,2020/11/30,56.8281862,1112,32,157359,2502,No,Yes,7061
Arkansas,2020/12/1,56.8281862,1950,10,159309,2512,No,Yes,7061
Arkansas,2020/12/2,56.8281862,2212,10,161521,2522,No,Yes,7656
Arkansas,2020/12/3,56.8281862,2789,33,164310,2555,No,Yes,7656
Arkansas,2020/12/4,56.8281862,2827,31,167137,2586,No,Yes,7656
Arkansas,2020/12/5,56.8281862,2245,34,169382,2620,No,Yes,7656
Arkansas,2020/12/6,56.8281862,1542,40,170924,2660,No,Yes,7656
Arkansas,2020/12/7,56.8281862,1118,53,172042,2713,No,Yes,7656
Arkansas,2020/12/8,56.8281862,2283,39,174325,2752,No,Yes,7656
Arkansas,2020/12/9,56.8281862,2327,34,176652,2786,No,Yes,7568
Arkansas,2020/12/10,56.8281862,2202,34,178854,2820,No,Yes,7568
Arkansas,2020/12/11,56.8281862,2770,55,181624,2875,No,Yes,7568
Arkansas,2020/12/12,56.8281862,2628,36,184252,2911,No,Yes,7568
Arkansas,2020/12/13,56.8281862,1450,34,185702,2945,No,Yes,7568
Arkansas,2020/12/14,56.8281862,1355,45,187057,2990,No,Yes,7568
Arkansas,2020/12/15,56.8281862,2141,26,189198,3016,No,Yes,7568
Arkansas,2020/12/16,56.8281862,2306,58,191504,3074,No,Yes,7543
Arkansas,2020/12/17,56.8281862,3039,38,194543,3112,No,Yes,7543
Arkansas,2020/12/18,56.8281862,2878,27,197421,3139,No,Yes,7543
Arkansas,2020/12/19,56.8281862,2693,52,200114,3191,No,Yes,7543
Arkansas,2020/12/20,56.8281862,1536,46,201650,3237,No,Yes,7543
Arkansas,2020/12/21,56.8281862,1457,58,203107,3295,No,Yes,7543
Arkansas,2020/12/22,56.8281862,1941,43,205048,3338,No,Yes,7543
Arkansas,2020/12/23,56.8281862,2893,38,207941,3376,No,Yes,5506
Arkansas,2020/12/24,56.8281862,3204,30,211145,3406,No,Yes,5506
Arkansas,2020/12/25,56.8281862,2122,32,213267,3438,No,Yes,5506
Arkansas,2020/12/26,56.8281862,702,3,213969,3441,No,Yes,5506
Arkansas,2020/12/27,56.8281862,908,41,214877,3482,No,Yes,5506
Arkansas,2020/12/28,56.8281862,1651,55,216528,3537,No,Yes,5506
Arkansas,2020/12/29,56.8281862,2718,66,219246,3603,No,Yes,5506
Arkansas,2020/12/30,56.8281862,3184,34,222430,3637,No,Yes,10986
Arkansas,2020/12/31,56.8281862,2708,39,225138,3676,No,Yes,10986
Arkansas,2021/1/1,56.8281862,4304,35,229442,3711,No,Yes,10986
Arkansas,2021/1/2,56.8281862,2000,18,231442,3729,No,Yes,10986
Arkansas,2021/1/3,56.8281862,2033,20,233475,3749,No,Yes,10986
Arkansas,2021/1/4,56.8281862,1306,51,234781,3800,No,Yes,10986
Arkansas,2021/1/5,56.8281862,4107,36,238888,3836,No,Yes,10986
Arkansas,2021/1/6,56.8281862,3705,65,242593,3901,No,Yes,14084
Arkansas,2021/1/7,56.8281862,3323,25,245916,3926,No,Yes,14084
Arkansas,2021/1/8,56.8281862,2944,40,248860,3966,No,Yes,14084
Arkansas,2021/1/9,56.8281862,2886,44,251746,4010,No,Yes,14084
Arkansas,2021/1/10,56.8281862,3330,33,255076,4043,No,Yes,14084
Arkansas,2021/1/11,56.8281862,1268,38,256344,4081,No,Yes,14084
Arkansas,2021/1/12,56.8281862,3209,40,259553,4121,No,Yes,14084
Arkansas,2021/1/13,56.8281862,2467,65,262020,4186,No,Yes,11980
Arkansas,2021/1/14,56.8281862,2491,42,264511,4228,No,Yes,11980
Arkansas,2021/1/15,56.8281862,3124,35,267635,4263,No,Yes,11980
Arkansas,2021/1/16,56.8281862,2543,30,270178,4293,No,Yes,11980
Arkansas,2021/1/17,56.8281862,976,18,271154,4311,No,Yes,11980
Arkansas,2021/1/18,56.8281862,1109,32,272263,4343,No,Yes,11980
Arkansas,2021/1/19,56.8281862,1331,43,273594,4386,No,Yes,11980
Arkansas,2021/1/20,56.8281862,2520,55,276114,4441,No,Yes,11615
Arkansas,2021/1/21,56.8281862,3106,55,279220,4496,No,Yes,11615
Arkansas,2021/1/22,56.8281862,2162,53,281382,4549,No,Yes,11615
Arkansas,2021/1/23,56.8281862,1613,14,282995,4563,No,Yes,11615
Arkansas,2021/1/24,56.8281862,1071,43,284066,4606,No,Yes,11615
Arkansas,2021/1/25,56.8281862,636,44,284702,4650,No,Yes,11615
Arkansas,2021/1/26,56.8281862,2485,40,287187,4690,No,Yes,11615
Arkansas,2021/1/27,56.8281862,1777,52,288964,4742,No,Yes,12664
Arkansas,2021/1/28,56.8281862,1892,42,290856,4784,No,Yes,12664
Arkansas,2021/1/29,56.8281862,1707,47,292563,4831,No,Yes,12664
Arkansas,2021/1/30,56.8281862,1824,7,294387,4838,No,Yes,12664
Arkansas,2021/1/31,56.8281862,881,30,295268,4868,No,Yes,12664
Arkansas,2021/2/1,56.8281862,1226,27,296494,4895,No,Yes,12664
Arkansas,2021/2/2,56.8281862,1510,44,298004,4939,No,Yes,12664
Arkansas,2021/2/3,56.8281862,2426,46,300430,4985,No,Yes,13464
Arkansas,2021/2/4,56.8281862,2469,24,302899,5009,No,Yes,13464
Arkansas,2021/2/5,56.8281862,1824,41,304723,5050,No,Yes,13464
Arkansas,2021/2/6,56.8281862,1341,11,306064,5061,No,Yes,13464
Arkansas,2021/2/7,56.8281862,672,15,306736,5076,No,Yes,13464
Arkansas,2021/2/8,56.8281862,637,30,307373,5106,No,Yes,13464
Arkansas,2021/2/9,56.8281862,1475,42,308848,5148,No,Yes,13464
Arkansas,2021/2/10,56.8281862,1092,26,309940,5174,No,Yes,12087
Arkansas,2021/2/11,56.8281862,1103,25,311043,5199,No,Yes,12087
Arkansas,2021/2/12,56.8281862,565,13,311608,5212,No,Yes,12087
Arkansas,2021/2/13,56.8281862,954,40,312562,5252,No,Yes,12087
Arkansas,2021/2/14,56.8281862,466,13,313028,5265,No,Yes,12087
Arkansas,2021/2/15,56.8281862,320,10,313348,5275,No,Yes,12087
Arkansas,2021/2/16,56.8281862,177,12,313525,5287,No,Yes,12087
Arkansas,2021/2/17,56.8281862,667,26,314192,5313,No,Yes,11395
Arkansas,2021/2/18,56.8281862,253,10,314445,5323,No,Yes,11395
Arkansas,2021/2/19,56.8281862,268,13,314713,5336,No,Yes,11395
Arkansas,2021/2/20,56.8281862,517,12,315230,5348,No,Yes,11395
Arkansas,2021/2/21,56.8281862,284,9,315514,5357,No,Yes,11395
Arkansas,2021/2/22,56.8281862,245,6,315759,5363,No,Yes,11395
Arkansas,2021/2/23,56.8281862,834,14,316593,5377,No,Yes,11395
Arkansas,2021/2/24,56.8281862,803,10,317396,5387,No,Yes,11395
Arkansas,2021/2/25,56.8281862,726,10,318122,5397,No,Yes,11395
Arkansas,2021/2/26,56.8281862,516,10,318638,5407,No,Yes,11395
Arkansas,2021/2/27,56.8281862,557,10,319195,5417,No,Yes,11395
Arkansas,2021/2/28,56.8281862,3220,-174,322415,5243,No,Yes,11395
Arkansas,2021/3/1,56.8281862,94,7,322509,5250,No,Yes,11395
Arkansas,2021/3/2,56.8281862,440,4,322949,5254,No,Yes,11395
Arkansas,2021/3/3,56.8281862,404,7,323353,5261,No,Yes,11395
Arkansas,2021/3/4,56.8281862,403,12,323756,5273,No,Yes,11395
California,2020/3/1,248.9852924,33,0,33,0,No,No,1575
California,2020/3/2,248.9852924,5,0,38,0,No,No,1575
California,2020/3/3,248.9852924,7,0,45,0,No,No,1575
California,2020/3/4,248.9852924,10,1,55,1,No,No,1663
California,2020/3/5,248.9852924,12,0,67,1,No,No,1663
California,2020/3/6,248.9852924,14,0,81,1,No,No,1663
California,2020/3/7,248.9852924,19,0,100,1,No,No,1663
California,2020/3/8,248.9852924,12,0,112,1,No,No,1663
California,2020/3/9,248.9852924,60,1,172,2,No,No,1663
California,2020/3/10,248.9852924,7,1,179,3,No,No,1663
California,2020/3/11,248.9852924,23,1,202,4,No,No,1819
California,2020/3/12,248.9852924,50,0,252,4,No,No,1819
California,2020/3/13,248.9852924,68,1,320,5,No,No,1819
California,2020/3/14,248.9852924,61,0,381,5,No,No,1819
California,2020/3/15,248.9852924,97,1,478,6,No,No,1819
California,2020/3/16,248.9852924,110,5,588,11,No,No,1819
California,2020/3/17,248.9852924,144,3,732,14,No,No,1819
California,2020/3/18,248.9852924,161,3,893,17,No,No,10892
California,2020/3/19,248.9852924,174,2,1067,19,No,No,10892
California,2020/3/20,248.9852924,216,5,1283,24,No,No,10892
California,2020/3/21,248.9852924,261,4,1544,28,No,No,10892
California,2020/3/22,248.9852924,307,7,1851,35,No,No,10892
California,2020/3/23,248.9852924,389,4,2240,39,No,No,10892
California,2020/3/24,248.9852924,404,13,2644,52,No,No,10892
California,2020/3/25,248.9852924,539,16,3183,68,No,No,80984
California,2020/3/26,248.9852924,877,15,4060,83,No,No,80984
California,2020/3/27,248.9852924,855,21,4915,104,No,No,80984
California,2020/3/28,248.9852924,651,18,5566,122,No,No,80984
California,2020/3/29,248.9852924,755,10,6321,132,No,No,80984
California,2020/3/30,248.9852924,1100,15,7421,147,No,No,80984
California,2020/3/31,248.9852924,1162,37,8583,184,No,No,80984
California,2020/4/1,248.9852924,1274,28,9857,212,No,No,106739
California,2020/4/2,248.9852924,1333,35,11190,247,No,No,106739
California,2020/4/3,248.9852924,1379,35,12569,282,No,No,106739
California,2020/4/4,248.9852924,1227,41,13796,323,No,No,106739
California,2020/4/5,248.9852924,1406,28,15202,351,No,No,106739
California,2020/4/6,248.9852924,1159,35,16361,386,No,No,106739
California,2020/4/7,248.9852924,1179,61,17540,447,No,No,106739
California,2020/4/8,248.9852924,1503,59,19043,506,No,No,77515
California,2020/4/9,248.9852924,1148,42,20191,548,No,No,77515
California,2020/4/10,248.9852924,1175,46,21366,594,No,No,77515
California,2020/4/11,248.9852924,1055,38,22421,632,No,No,77515
California,2020/4/12,248.9852924,902,44,23323,676,No,No,77515
California,2020/4/13,248.9852924,1011,49,24334,725,No,No,77515
California,2020/4/14,248.9852924,1424,53,25758,778,No,No,77515
California,2020/4/15,248.9852924,1349,107,27107,885,No,No,66432
California,2020/4/16,248.9852924,1035,86,28142,971,No,No,66432
California,2020/4/17,248.9852924,1256,79,29398,1050,No,No,66432
California,2020/4/18,248.9852924,1431,96,30829,1146,No,No,66432
California,2020/4/19,248.9852924,715,30,31544,1176,No,No,66432
California,2020/4/20,248.9852924,2318,47,33862,1223,No,No,66432
California,2020/4/21,248.9852924,1982,93,35844,1316,No,No,66432
California,2020/4/22,248.9852924,1729,109,37573,1425,No,No,74966
California,2020/4/23,248.9852924,1961,123,39534,1548,No,No,74966
California,2020/4/24,248.9852924,1834,71,41368,1619,No,No,74966
California,2020/4/25,248.9852924,1222,73,42590,1692,No,No,74966
California,2020/4/26,248.9852924,1101,24,43691,1716,No,No,74966
California,2020/4/27,248.9852924,1517,84,45208,1800,No,No,74966
California,2020/4/28,248.9852924,1362,84,46570,1884,No,No,74966
California,2020/4/29,248.9852924,2334,77,48904,1961,No,No,28985
California,2020/4/30,248.9852924,1566,96,50470,2057,No,No,28985
California,2020/5/1,248.9852924,1848,90,52318,2147,No,No,28985
California,2020/5/2,248.9852924,1435,66,53753,2213,No,No,28985
California,2020/5/3,248.9852924,1319,22,55072,2235,No,No,28985
California,2020/5/4,248.9852924,1261,62,56333,2297,No,No,28985
California,2020/5/5,248.9852924,2515,89,58848,2386,No,No,28985
California,2020/5/6,248.9852924,1939,92,60787,2478,No,No,26666
California,2020/5/7,248.9852924,1694,83,62481,2561,No,No,26666
California,2020/5/8,248.9852924,2135,89,64616,2650,No,No,26666
California,2020/5/9,248.9852924,2208,82,66824,2732,No,No,26666
California,2020/5/10,248.9852924,1227,37,68051,2769,No,No,26666
California,2020/5/11,248.9852924,1463,51,69514,2820,No,No,26666
California,2020/5/12,248.9852924,1636,82,71150,2902,No,No,26666
California,2020/5/13,248.9852924,2068,112,73218,3014,No,No,25150
California,2020/5/14,248.9852924,1729,25,74947,3039,No,No,25150
California,2020/5/15,248.9852924,2068,153,77015,3192,No,No,25150
California,2020/5/16,248.9852924,1918,62,78933,3254,No,No,25150
California,2020/5/17,248.9852924,1433,36,80366,3290,No,No,25150
California,2020/5/18,248.9852924,1577,32,81943,3322,No,No,25150
California,2020/5/19,248.9852924,2038,100,83981,3422,No,No,25150
California,2020/5/20,248.9852924,2144,92,86125,3514,No,No,27919
California,2020/5/21,248.9852924,2363,110,88488,3624,No,No,27919
California,2020/5/22,248.9852924,2313,66,90801,3690,No,No,27919
California,2020/5/23,248.9852924,2014,78,92815,3768,No,No,27919
California,2020/5/24,248.9852924,1928,22,94743,3790,No,No,27919
California,2020/5/25,248.9852924,2274,18,97017,3808,No,No,27919
California,2020/5/26,248.9852924,2907,51,99924,3859,No,No,27919
California,2020/5/27,248.9852924,1949,102,101873,3961,No,No,21335
California,2020/5/28,248.9852924,2198,81,104071,4042,No,No,21335
California,2020/5/29,248.9852924,2972,102,107043,4144,No,No,21335
California,2020/5/30,248.9852924,3057,70,110100,4214,No,No,21335
California,2020/5/31,248.9852924,3014,28,113114,4242,No,No,21335
California,2020/6/1,248.9852924,2529,45,115643,4287,No,No,21335
California,2020/6/2,248.9852924,2438,73,118081,4360,No,No,21335
California,2020/6/3,248.9852924,2326,62,120407,4422,No,No,19949
California,2020/6/4,248.9852924,2510,62,122917,4484,No,No,19949
California,2020/6/5,248.9852924,3593,66,126510,4550,No,No,19949
California,2020/6/6,248.9852924,2637,76,129147,4626,No,No,19949
California,2020/6/7,248.9852924,2850,27,131997,4653,No,No,19949
California,2020/6/8,248.9852924,2290,26,134287,4679,No,No,19949
California,2020/6/9,248.9852924,2958,96,137245,4775,No,No,19949
California,2020/6/10,248.9852924,2894,94,140139,4869,No,No,18367
California,2020/6/11,248.9852924,3570,72,143709,4941,No,No,18367
California,2020/6/12,248.9852924,3576,45,147285,4986,No,No,18367
California,2020/6/13,248.9852924,3149,73,150434,5059,No,No,18367
California,2020/6/14,248.9852924,2519,30,152953,5089,No,No,18367
California,2020/6/15,248.9852924,2709,31,155662,5120,No,No,18367
California,2020/6/16,248.9852924,3469,82,159131,5202,No,No,18367
California,2020/6/17,248.9852924,4250,81,163381,5283,No,No,18671
California,2020/6/18,248.9852924,3754,76,167135,5359,No,Yes,18671
California,2020/6/19,248.9852924,3708,66,170843,5425,No,Yes,18671
California,2020/6/20,248.9852924,4011,70,174854,5495,No,Yes,18671
California,2020/6/21,248.9852924,3953,22,178807,5517,No,Yes,18671
California,2020/6/22,248.9852924,5813,44,184620,5561,No,Yes,18671
California,2020/6/23,248.9852924,6419,76,191039,5637,No,Yes,18671
California,2020/6/24,248.9852924,4850,91,195889,5728,No,Yes,18338
California,2020/6/25,248.9852924,5524,82,201413,5810,No,Yes,18338
California,2020/6/26,248.9852924,5614,62,207027,5872,No,Yes,18338
California,2020/6/27,248.9852924,4426,30,211453,5902,No,Yes,18338
California,2020/6/28,248.9852924,5502,35,216955,5937,No,Yes,18338
California,2020/6/29,248.9852924,7040,42,223995,5979,No,Yes,18338
California,2020/6/30,248.9852924,8158,104,232153,6083,No,Yes,18338
California,2020/7/1,248.9852924,7611,85,239764,6168,No,Yes,19056
California,2020/7/2,248.9852924,8434,95,248198,6263,No,Yes,19056
California,2020/7/3,248.9852924,8100,52,256298,6315,No,Yes,19056
California,2020/7/4,248.9852924,8878,14,265176,6329,No,Yes,19056
California,2020/7/5,248.9852924,6411,40,271587,6369,No,Yes,19056
California,2020/7/6,248.9852924,6282,83,277869,6452,No,Yes,19056
California,2020/7/7,248.9852924,9897,111,287766,6563,No,Yes,19056
California,2020/7/8,248.9852924,8538,145,296304,6708,No,Yes,20563
California,2020/7/9,248.9852924,7212,117,303516,6825,No,Yes,20563
California,2020/7/10,248.9852924,7989,111,311505,6936,No,Yes,20563
California,2020/7/11,248.9852924,8525,76,320030,7012,No,Yes,20563
California,2020/7/12,248.9852924,7646,30,327676,7042,No,Yes,20563
California,2020/7/13,248.9852924,8530,44,336206,7086,No,Yes,20563
California,2020/7/14,248.9852924,10387,141,346593,7227,No,Yes,20563
California,2020/7/15,248.9852924,8904,141,355497,7368,No,Yes,23676
California,2020/7/16,248.9852924,9264,122,364761,7490,No,Yes,23676
California,2020/7/17,248.9852924,10161,117,374922,7607,No,Yes,23676
California,2020/7/18,248.9852924,8272,90,383194,7697,No,Yes,23676
California,2020/7/19,248.9852924,8266,13,391460,7710,No,Yes,23676
California,2020/7/20,248.9852924,8735,54,400195,7764,No,Yes,23676
California,2020/7/21,248.9852924,10171,119,410366,7883,No,Yes,23676
California,2020/7/22,248.9852924,12162,155,422528,8038,No,Yes,17437
California,2020/7/23,248.9852924,10647,152,433175,8190,No,Yes,17437
California,2020/7/24,248.9852924,9921,135,443096,8325,No,Yes,17437
California,2020/7/25,248.9852924,10231,103,453327,8428,No,Yes,17437
California,2020/7/26,248.9852924,6011,23,459338,8451,No,Yes,17437
California,2020/7/27,248.9852924,7765,93,467103,8544,No,Yes,17437
California,2020/7/28,248.9852924,7848,172,474951,8716,No,Yes,17437
California,2020/7/29,248.9852924,11088,168,486039,8884,No,Yes,11690
California,2020/7/30,248.9852924,8230,125,494269,9009,No,Yes,11690
California,2020/7/31,248.9852924,8004,213,502273,9222,No,Yes,11690
California,2020/8/1,248.9852924,7234,143,509507,9365,No,Yes,11690
California,2020/8/2,248.9852924,6430,34,515937,9399,No,Yes,11690
California,2020/8/3,248.9852924,6298,101,522235,9500,No,Yes,11690
California,2020/8/4,248.9852924,5023,196,527258,9696,No,Yes,11690
California,2020/8/5,248.9852924,5518,170,532776,9866,No,Yes,9467
California,2020/8/6,248.9852924,8237,148,541013,10014,No,Yes,9467
California,2020/8/7,248.9852924,7129,183,548142,10197,No,Yes,9467
California,2020/8/8,248.9852924,8016,102,556158,10299,No,Yes,9467
California,2020/8/9,248.9852924,7086,66,563244,10365,No,Yes,9467
California,2020/8/10,248.9852924,11023,95,574267,10460,No,Yes,9467
California,2020/8/11,248.9852924,11811,194,586078,10654,No,Yes,9467
California,2020/8/12,248.9852924,9019,154,595097,10808,No,Yes,11047
California,2020/8/13,248.9852924,8115,187,603212,10995,No,Yes,11047
California,2020/8/14,248.9852924,10031,151,613243,11146,No,Yes,11047
California,2020/8/15,248.9852924,8738,83,621981,11229,No,Yes,11047
California,2020/8/16,248.9852924,6527,16,628508,11245,No,Yes,11047
California,2020/8/17,248.9852924,6483,89,634991,11334,No,Yes,11047
California,2020/8/18,248.9852924,5508,189,640499,11523,No,Yes,11047
California,2020/8/19,248.9852924,6243,163,646742,11686,No,Yes,8676
California,2020/8/20,248.9852924,6659,115,653401,11801,No,Yes,8676
California,2020/8/21,248.9852924,6590,183,659991,11984,No,Yes,8676
California,2020/8/22,248.9852924,5334,153,665325,12137,No,Yes,8676
California,2020/8/23,248.9852924,4619,15,669944,12152,No,Yes,8676
California,2020/8/24,248.9852924,6292,98,676236,12250,No,Yes,8676
California,2020/8/25,248.9852924,6084,159,682320,12409,No,Yes,8676
California,2020/8/26,248.9852924,5292,138,687612,12547,No,Yes,8511
California,2020/8/27,248.9852924,5350,149,692962,12696,No,Yes,8511
California,2020/8/28,248.9852924,5427,140,698389,12836,No,Yes,8511
California,2020/8/29,248.9852924,4110,70,702499,12906,No,Yes,8511
California,2020/8/30,248.9852924,4090,33,706589,12939,No,Yes,8511
California,2020/8/31,248.9852924,5952,81,712541,13020,No,Yes,8511
California,2020/9/1,248.9852924,4087,129,716628,13149,No,Yes,8511
California,2020/9/2,248.9852924,5407,181,722035,13330,No,Yes,8901
California,2020/9/3,248.9852924,5363,167,727398,13497,No,Yes,8901
California,2020/9/4,248.9852924,5293,147,732691,13644,No,Yes,8901
California,2020/9/5,248.9852924,4382,64,737073,13708,No,Yes,8901
California,2020/9/6,248.9852924,3160,22,740233,13730,No,Yes,8901
California,2020/9/7,248.9852924,2456,33,742689,13763,No,Yes,8901
California,2020/9/8,248.9852924,3424,80,746113,13843,No,Yes,8901
California,2020/9/9,248.9852924,3083,147,749196,13990,No,Yes,8848
California,2020/9/10,248.9852924,3821,104,753017,14094,No,Yes,8848
California,2020/9/11,248.9852924,4108,171,757125,14265,No,Yes,8848
California,2020/9/12,248.9852924,3456,68,760581,14333,No,Yes,8848
California,2020/9/13,248.9852924,2808,53,763389,14386,No,Yes,8848
California,2020/9/14,248.9852924,3673,72,767062,14458,No,Yes,8848
California,2020/9/15,248.9852924,2855,148,769917,14606,No,Yes,8848
California,2020/9/16,248.9852924,3401,110,773318,14716,No,Yes,8679
California,2020/9/17,248.9852924,3626,91,776944,14807,No,Yes,8679
California,2020/9/18,248.9852924,4492,105,781436,14912,No,Yes,8679
California,2020/9/19,248.9852924,3640,111,785076,15023,No,Yes,8679
California,2020/9/20,248.9852924,3001,-5,788077,15018,No,Yes,8679
California,2020/9/21,248.9852924,4140,51,792217,15069,No,Yes,8679
California,2020/9/22,248.9852924,2860,140,795077,15209,No,Yes,8679
California,2020/9/23,248.9852924,3273,104,798350,15313,No,Yes,8805
California,2020/9/24,248.9852924,3321,76,801671,15389,No,Yes,8805
California,2020/9/25,248.9852924,4062,144,805733,15533,No,Yes,8805
California,2020/9/26,248.9852924,3481,55,809214,15588,No,Yes,8805
California,2020/9/27,248.9852924,2484,20,811698,15608,No,Yes,8805
California,2020/9/28,248.9852924,3098,33,814796,15641,No,Yes,8805
California,2020/9/29,248.9852924,3143,150,817939,15791,No,Yes,8805
California,2020/9/30,248.9852924,3186,107,821125,15898,No,Yes,7732
California,2020/10/1,248.9852924,3181,91,824306,15989,No,Yes,7732
California,2020/10/2,248.9852924,4058,85,828364,16074,No,Yes,7732
California,2020/10/3,248.9852924,3130,48,831494,16122,No,Yes,7732
California,2020/10/4,248.9852924,3141,28,834635,16150,No,Yes,7732
California,2020/10/5,248.9852924,3085,29,837720,16179,No,Yes,7732
California,2020/10/6,248.9852924,2602,72,840322,16251,No,Yes,7732
California,2020/10/7,248.9852924,3410,107,843732,16358,No,Yes,8581
California,2020/10/8,248.9852924,3652,67,847384,16425,No,Yes,8581
California,2020/10/9,248.9852924,3844,77,851228,16502,No,Yes,8581
California,2020/10/10,248.9852924,3074,66,854302,16568,No,Yes,8581
California,2020/10/11,248.9852924,2774,13,857076,16581,No,Yes,8581
California,2020/10/12,248.9852924,2883,13,859959,16594,No,Yes,8581
California,2020/10/13,248.9852924,3655,56,863614,16650,No,Yes,8581
California,2020/10/14,248.9852924,3480,102,867094,16752,No,Yes,7964
California,2020/10/15,248.9852924,3286,87,870380,16839,No,Yes,7964
California,2020/10/16,248.9852924,3721,62,874101,16901,No,Yes,7964
California,2020/10/17,248.9852924,2156,39,876257,16940,No,Yes,7964
California,2020/10/18,248.9852924,2137,39,878394,16979,No,Yes,7964
California,2020/10/19,248.9852924,4271,8,882665,16987,No,Yes,7964
California,2020/10/20,248.9852924,4428,80,887093,17067,No,Yes,7964
California,2020/10/21,248.9852924,3060,122,890153,17189,No,Yes,7126
California,2020/10/22,248.9852924,6271,77,896424,17266,No,Yes,7126
California,2020/10/23,248.9852924,5901,50,902325,17316,No,Yes,7126
California,2020/10/24,248.9852924,4319,29,906644,17345,No,Yes,7126
California,2020/10/25,248.9852924,2700,13,909344,17358,No,Yes,7126
California,2020/10/26,248.9852924,4355,40,913699,17398,No,Yes,7126
California,2020/10/27,248.9852924,4928,80,918627,17478,No,Yes,7126
California,2020/10/28,248.9852924,4053,63,922680,17541,No,Yes,7060
California,2020/10/29,248.9852924,4213,26,926893,17567,No,Yes,7060
California,2020/10/30,248.9852924,4933,60,931826,17627,No,Yes,7060
California,2020/10/31,248.9852924,3422,34,935248,17661,No,Yes,7060
California,2020/11/1,248.9852924,3635,10,938883,17671,No,Yes,7060
California,2020/11/2,248.9852924,5258,29,944141,17700,No,Yes,7060
California,2020/11/3,248.9852924,5242,51,949383,17751,No,Yes,7060
California,2020/11/4,248.9852924,5241,67,954624,17818,No,Yes,8764
California,2020/11/5,248.9852924,6260,48,960884,17866,No,Yes,8764
California,2020/11/6,248.9852924,6713,73,967597,17939,No,Yes,8764
California,2020/11/7,248.9852924,5204,25,972801,17964,No,Yes,8764
California,2020/11/8,248.9852924,6043,11,978844,17975,No,Yes,8764
California,2020/11/9,248.9852924,6754,60,985598,18035,No,Yes,8764
California,2020/11/10,248.9852924,8743,38,994341,18073,No,Yes,8764
California,2020/11/11,248.9852924,5157,36,999498,18109,No,Yes,9262
California,2020/11/12,248.9852924,9689,32,1009187,18141,No,Yes,9262
California,2020/11/13,248.9852924,9865,77,1019052,18218,No,Yes,9262
California,2020/11/14,248.9852924,7964,36,1027016,18254,No,Yes,9262
California,2020/11/15,248.9852924,8965,11,1035981,18265,No,Yes,9262
California,2020/11/16,248.9852924,11379,39,1047360,18304,No,Yes,9262
California,2020/11/17,248.9852924,10736,56,1058096,18360,No,Yes,9262
California,2020/11/18,248.9852924,11421,107,1069517,18467,No,Yes,11813
California,2020/11/19,248.9852924,13157,88,1082674,18555,No,Yes,11813
California,2020/11/20,248.9852924,13727,94,1096401,18649,No,Yes,11813
California,2020/11/21,248.9852924,13443,60,1109844,18709,No,Yes,11813
California,2020/11/22,248.9852924,8808,17,1118652,18726,No,Yes,11813
California,2020/11/23,248.9852924,17815,42,1136467,18768,No,Yes,11813
California,2020/11/24,248.9852924,16538,107,1153005,18875,No,Yes,11813
California,2020/11/25,248.9852924,14144,107,1167149,18982,No,Yes,7061
California,2020/11/26,248.9852924,8988,43,1176137,19025,No,Yes,7061
California,2020/11/27,248.9852924,16934,75,1193071,19100,No,Yes,7061
California,2020/11/28,248.9852924,13207,32,1206278,19132,No,Yes,7061
California,2020/11/29,248.9852924,13218,19,1219496,19151,No,Yes,7061
California,2020/11/30,248.9852924,17696,58,1237192,19209,No,Yes,7061
California,2020/12/1,248.9852924,16675,118,1253867,19327,No,Yes,7061
California,2020/12/2,248.9852924,18174,113,1272041,19440,No,Yes,7656
California,2020/12/3,248.9852924,21846,146,1293887,19586,No,Yes,7656
California,2020/12/4,248.9852924,24252,205,1318139,19791,No,Yes,7656
California,2020/12/5,248.9852924,25006,85,1343145,19876,No,Yes,7656
California,2020/12/6,248.9852924,28795,61,1371940,19937,No,Yes,7656
California,2020/12/7,248.9852924,27227,115,1399167,20052,No,Yes,7656
California,2020/12/8,248.9852924,26265,186,1425432,20238,No,Yes,7656
California,2020/12/9,248.9852924,31782,228,1457214,20466,No,Yes,7568
California,2020/12/10,248.9852924,33839,170,1491053,20636,No,Yes,7568
California,2020/12/11,248.9852924,37124,218,1528177,20854,No,Yes,7568
California,2020/12/12,248.9852924,26686,104,1554863,20958,No,Yes,7568
California,2020/12/13,248.9852924,35807,85,1590670,21043,No,Yes,7568
California,2020/12/14,248.9852924,30200,153,1620870,21196,No,Yes,7568
California,2020/12/15,248.9852924,34216,287,1655086,21483,No,Yes,7568
California,2020/12/16,248.9852924,60941,398,1716027,21881,No,Yes,7543
California,2020/12/17,248.9852924,45314,274,1761341,22155,No,Yes,7543
California,2020/12/18,248.9852924,48244,341,1809585,22496,No,Yes,7543
California,2020/12/19,248.9852924,37358,155,1846943,22651,No,Yes,7543
California,2020/12/20,248.9852924,42885,85,1889828,22736,No,Yes,7543
California,2020/12/21,248.9852924,43255,244,1933083,22980,No,Yes,7543
California,2020/12/22,248.9852924,35347,274,1968430,23254,No,Yes,7543
California,2020/12/23,248.9852924,44758,379,2013188,23633,No,Yes,5506
California,2020/12/24,248.9852924,34731,311,2047919,23944,No,Yes,5506
California,2020/12/25,248.9852924,16772,20,2064691,23964,No,Yes,5506
California,2020/12/26,248.9852924,64987,257,2129678,24221,No,Yes,5506
California,2020/12/27,248.9852924,37555,62,2167233,24283,No,Yes,5506
California,2020/12/28,248.9852924,41720,246,2208953,24529,No,Yes,5506
California,2020/12/29,248.9852924,34166,425,2243119,24954,No,Yes,5506
California,2020/12/30,248.9852924,32386,437,2275505,25391,No,Yes,10986
California,2020/12/31,248.9852924,32264,574,2307769,25965,No,Yes,10986
California,2021/1/1,248.9852924,37957,271,2345726,26236,No,Yes,10986
California,2021/1/2,248.9852924,52197,306,2397923,26542,No,Yes,10986
California,2021/1/3,248.9852924,35915,93,2433838,26635,No,Yes,10986
California,2021/1/4,248.9852924,40723,360,2474561,26995,No,Yes,10986
California,2021/1/5,248.9852924,37261,491,2511822,27486,No,Yes,10986
California,2021/1/6,248.9852924,36672,554,2548494,28040,No,Yes,14084
California,2021/1/7,248.9852924,40397,512,2588891,28552,No,Yes,14084
California,2021/1/8,248.9852924,50923,674,2639814,29226,No,Yes,14084
California,2021/1/9,248.9852924,47271,473,2687085,29699,No,Yes,14084
California,2021/1/10,248.9852924,42440,301,2729525,30000,No,Yes,14084
California,2021/1/11,248.9852924,40540,381,2770065,30381,No,Yes,14084
California,2021/1/12,248.9852924,45868,724,2815933,31105,No,Yes,14084
California,2021/1/13,248.9852924,41654,548,2857587,31653,No,Yes,11980
California,2021/1/14,248.9852924,40684,593,2898271,32246,No,Yes,11980
California,2021/1/15,248.9852924,39105,701,2937376,32947,No,Yes,11980
California,2021/1/16,248.9852924,37590,446,2974966,33393,No,Yes,11980
California,2021/1/17,248.9852924,31617,200,3006583,33593,No,Yes,11980
California,2021/1/18,248.9852924,25424,149,3032007,33742,No,Yes,11980
California,2021/1/19,248.9852924,39112,648,3071119,34390,No,Yes,11980
California,2021/1/20,248.9852924,19220,611,3090339,35001,No,Yes,11615
California,2021/1/21,248.9852924,25572,703,3115911,35704,No,Yes,11615
California,2021/1/22,248.9852924,25017,622,3140928,36326,No,Yes,11615
California,2021/1/23,248.9852924,23004,492,3163932,36818,No,Yes,11615
California,2021/1/24,248.9852924,21680,300,3185612,37118,No,Yes,11615
California,2021/1/25,248.9852924,26876,381,3212488,37499,No,Yes,11615
California,2021/1/26,248.9852924,21600,722,3234088,38221,No,Yes,11615
California,2021/1/27,248.9852924,18628,706,3252716,38927,No,Yes,12664
California,2021/1/28,248.9852924,19633,600,3272349,39527,No,Yes,12664
California,2021/1/29,248.9852924,19735,665,3292084,40192,No,Yes,12664
California,2021/1/30,248.9852924,17546,502,3309630,40694,No,Yes,12664
California,2021/1/31,248.9852924,13983,234,3323613,40928,No,Yes,12664
California,2021/2/1,248.9852924,17584,356,3341197,41284,No,Yes,12664
California,2021/2/2,248.9852924,12842,574,3354039,41858,No,Yes,12664
California,2021/2/3,248.9852924,12558,576,3366597,42434,No,Yes,13464
California,2021/2/4,248.9852924,14681,628,3381278,43062,No,Yes,13464
California,2021/2/5,248.9852924,14017,569,3395295,43631,No,Yes,13464
California,2021/2/6,248.9852924,11595,356,3406890,43987,No,Yes,13464
California,2021/2/7,248.9852924,10209,165,3417099,44152,No,Yes,13464
California,2021/2/8,248.9852924,13586,288,3430685,44440,No,Yes,13464
California,2021/2/9,248.9852924,10492,533,3441177,44973,No,Yes,13464
California,2021/2/10,248.9852924,8597,463,3449774,45436,No,Yes,12087
California,2021/2/11,248.9852924,10546,540,3460320,45976,No,Yes,12087
California,2021/2/12,248.9852924,9533,459,3469853,46435,No,Yes,12087
California,2021/2/13,248.9852924,9176,430,3479029,46865,No,Yes,12087
California,2021/2/14,248.9852924,5955,190,3484984,47055,No,Yes,12087
California,2021/2/15,248.9852924,5012,60,3489996,47115,No,Yes,12087
California,2021/2/16,248.9852924,8764,331,3498760,47446,No,Yes,12087
California,2021/2/17,248.9852924,6272,456,3505032,47902,No,Yes,11395
California,2021/2/18,248.9852924,7849,432,3512881,48334,No,Yes,11395
California,2021/2/19,248.9852924,7880,460,3520761,48794,No,Yes,11395
California,2021/2/20,248.9852924,6067,317,3526828,49111,No,Yes,11395
California,2021/2/21,248.9852924,4646,229,3531474,49340,No,Yes,11395
California,2021/2/22,248.9852924,4972,191,3536446,49531,No,Yes,11395
California,2021/2/23,248.9852924,6260,338,3542706,49869,No,Yes,11395
California,2021/2/24,248.9852924,5853,1084,3548559,50953,No,Yes,11395
California,2021/2/25,248.9852924,5636,432,3554195,51385,No,Yes,11395
California,2021/2/26,248.9852924,6891,409,3561086,51794,No,Yes,11395
California,2021/2/27,248.9852924,4410,185,3565496,51979,No,Yes,11395
California,2021/2/28,248.9852924,3495,234,3568991,52213,No,Yes,11395
California,2021/3/1,248.9852924,4190,274,3573181,52487,No,Yes,11395
California,2021/3/2,248.9852924,4316,287,3577497,52774,No,Yes,11395
California,2021/3/3,248.9852924,4403,292,3581900,53066,No,Yes,11395
California,2021/3/4,248.9852924,5255,391,3587155,53457,No,Yes,11395
Colorado,2020/3/1,55.24126354,0,0,0,0,No,No,1575
Colorado,2020/3/2,55.24126354,0,0,0,0,No,No,1575
Colorado,2020/3/3,55.24126354,0,0,0,0,No,No,1575
Colorado,2020/3/4,55.24126354,0,0,0,0,No,No,1663
Colorado,2020/3/5,55.24126354,2,0,2,0,No,No,1663
Colorado,2020/3/6,55.24126354,6,0,8,0,No,No,1663
Colorado,2020/3/7,55.24126354,0,0,8,0,No,No,1663
Colorado,2020/3/8,55.24126354,0,0,8,0,No,No,1663
Colorado,2020/3/9,55.24126354,4,0,12,0,No,No,1663
Colorado,2020/3/10,55.24126354,5,0,17,0,No,No,1663
Colorado,2020/3/11,55.24126354,17,0,34,0,No,No,1819
Colorado,2020/3/12,55.24126354,15,1,49,1,No,No,1819
Colorado,2020/3/13,55.24126354,29,1,78,2,No,No,1819
Colorado,2020/3/14,55.24126354,25,0,103,2,No,No,1819
Colorado,2020/3/15,55.24126354,33,0,136,2,No,No,1819
Colorado,2020/3/16,55.24126354,25,0,161,2,No,No,1819
Colorado,2020/3/17,55.24126354,22,1,183,3,No,No,1819
Colorado,2020/3/18,55.24126354,33,0,216,3,No,No,10892
Colorado,2020/3/19,55.24126354,62,2,278,5,No,No,10892
Colorado,2020/3/20,55.24126354,86,0,364,5,No,No,10892
Colorado,2020/3/21,55.24126354,111,1,475,6,No,No,10892
Colorado,2020/3/22,55.24126354,116,1,591,7,No,No,10892
Colorado,2020/3/23,55.24126354,130,3,721,10,No,No,10892
Colorado,2020/3/24,55.24126354,191,1,912,11,No,No,10892
Colorado,2020/3/25,55.24126354,174,8,1086,19,No,No,80984
Colorado,2020/3/26,55.24126354,346,5,1432,24,Yes,No,80984
Colorado,2020/3/27,55.24126354,303,7,1735,31,Yes,No,80984
Colorado,2020/3/28,55.24126354,326,13,2061,44,Yes,No,80984
Colorado,2020/3/29,55.24126354,254,3,2315,47,Yes,No,80984
Colorado,2020/3/30,55.24126354,313,4,2628,51,Yes,No,80984
Colorado,2020/3/31,55.24126354,362,18,2990,69,Yes,No,80984
Colorado,2020/4/1,55.24126354,356,11,3346,80,Yes,No,106739
Colorado,2020/4/2,55.24126354,382,16,3728,96,Yes,No,106739
Colorado,2020/4/3,55.24126354,454,14,4182,110,Yes,No,106739
Colorado,2020/4/4,55.24126354,392,16,4574,126,Yes,No,106739
Colorado,2020/4/5,55.24126354,376,14,4950,140,Yes,No,106739
Colorado,2020/4/6,55.24126354,222,10,5172,150,Yes,No,106739
Colorado,2020/4/7,55.24126354,257,29,5429,179,Yes,No,106739
Colorado,2020/4/8,55.24126354,226,13,5655,192,Yes,No,77515
Colorado,2020/4/9,55.24126354,547,35,6202,227,Yes,No,77515
Colorado,2020/4/10,55.24126354,308,26,6510,253,Yes,No,77515
Colorado,2020/4/11,55.24126354,383,21,6893,274,Yes,No,77515
Colorado,2020/4/12,55.24126354,410,16,7303,290,Yes,No,77515
Colorado,2020/4/13,55.24126354,388,18,7691,308,Yes,No,77515
Colorado,2020/4/14,55.24126354,250,21,7941,329,Yes,No,77515
Colorado,2020/4/15,55.24126354,339,26,8280,355,Yes,No,66432
Colorado,2020/4/16,55.24126354,395,19,8675,374,Yes,No,66432
Colorado,2020/4/17,55.24126354,372,15,9047,389,Yes,No,66432
Colorado,2020/4/18,55.24126354,386,20,9433,409,Yes,No,66432
Colorado,2020/4/19,55.24126354,297,12,9730,421,Yes,No,66432
Colorado,2020/4/20,55.24126354,376,27,10106,448,Yes,No,66432
Colorado,2020/4/21,55.24126354,341,36,10447,484,Yes,No,66432
Colorado,2020/4/22,55.24126354,431,42,10878,526,Yes,No,74966
Colorado,2020/4/23,55.24126354,384,31,11262,557,Yes,No,74966
Colorado,2020/4/24,55.24126354,993,115,12255,672,Yes,No,74966
Colorado,2020/4/25,55.24126354,712,-2,12967,670,Yes,No,74966
Colorado,2020/4/26,55.24126354,473,8,13440,678,Yes,No,74966
Colorado,2020/4/27,55.24126354,364,27,13804,705,No,No,74966
Colorado,2020/4/28,55.24126354,435,29,14239,734,No,No,74966
Colorado,2020/4/29,55.24126354,441,30,14680,764,No,No,28985
Colorado,2020/4/30,55.24126354,527,11,15207,775,No,No,28985
Colorado,2020/5/1,55.24126354,454,43,15661,818,No,No,28985
Colorado,2020/5/2,55.24126354,457,12,16118,830,No,No,28985
Colorado,2020/5/3,55.24126354,409,10,16527,840,No,No,28985
Colorado,2020/5/4,55.24126354,272,9,16799,849,No,No,28985
Colorado,2020/5/5,55.24126354,457,52,17256,901,No,No,28985
Colorado,2020/5/6,55.24126354,464,18,17720,919,No,No,26666
Colorado,2020/5/7,55.24126354,544,23,18264,942,No,No,26666
Colorado,2020/5/8,55.24126354,455,16,18719,958,No,No,26666
Colorado,2020/5/9,55.24126354,548,7,19267,965,No,No,26666
Colorado,2020/5/10,55.24126354,328,4,19595,969,No,No,26666
Colorado,2020/5/11,55.24126354,198,17,19793,986,No,No,26666
Colorado,2020/5/12,55.24126354,310,23,20103,1009,No,No,26666
Colorado,2020/5/13,55.24126354,339,53,20442,1062,No,No,25150
Colorado,2020/5/14,55.24126354,371,29,20813,1091,No,No,25150
Colorado,2020/5/15,55.24126354,394,59,21207,1150,No,No,25150
Colorado,2020/5/16,55.24126354,397,42,21604,1192,No,No,25150
Colorado,2020/5/17,55.24126354,305,23,21909,1215,No,No,25150
Colorado,2020/5/18,55.24126354,265,9,22174,1224,No,No,25150
Colorado,2020/5/19,55.24126354,280,33,22454,1257,No,No,25150
Colorado,2020/5/20,55.24126354,315,42,22769,1299,No,No,27919
Colorado,2020/5/21,55.24126354,392,11,23161,1310,No,No,27919
Colorado,2020/5/22,55.24126354,295,14,23456,1324,No,No,27919
Colorado,2020/5/23,55.24126354,476,3,23932,1327,No,No,27919
Colorado,2020/5/24,55.24126354,208,5,24140,1332,No,No,27919
Colorado,2020/5/25,55.24126354,116,1,24256,1333,No,No,27919
Colorado,2020/5/26,55.24126354,297,19,24553,1352,No,No,27919
Colorado,2020/5/27,55.24126354,222,41,24775,1393,No,No,21335
Colorado,2020/5/28,55.24126354,341,29,25116,1422,No,No,21335
Colorado,2020/5/29,55.24126354,486,15,25602,1437,No,No,21335
Colorado,2020/5/30,55.24126354,482,6,26084,1443,No,No,21335
Colorado,2020/5/31,55.24126354,280,2,26364,1445,No,No,21335
Colorado,2020/6/1,55.24126354,199,13,26563,1458,No,No,21335
Colorado,2020/6/2,55.24126354,211,16,26774,1474,No,No,21335
Colorado,2020/6/3,55.24126354,272,20,27046,1494,No,No,19949
Colorado,2020/6/4,55.24126354,300,18,27346,1512,No,No,19949
Colorado,2020/6/5,55.24126354,255,12,27601,1524,No,No,19949
Colorado,2020/6/6,55.24126354,233,3,27834,1527,No,No,19949
Colorado,2020/6/7,55.24126354,153,0,27987,1527,No,No,19949
Colorado,2020/6/8,55.24126354,182,16,28169,1543,No,No,19949
Colorado,2020/6/9,55.24126354,164,10,28333,1553,No,No,19949
Colorado,2020/6/10,55.24126354,151,20,28484,1573,No,No,18367
Colorado,2020/6/11,55.24126354,148,10,28632,1583,No,No,18367
Colorado,2020/6/12,55.24126354,175,12,28807,1595,No,No,18367
Colorado,2020/6/13,55.24126354,195,3,29002,1598,No,No,18367
Colorado,2020/6/14,55.24126354,113,1,29115,1599,No,No,18367
Colorado,2020/6/15,55.24126354,169,6,29284,1605,No,No,18367
Colorado,2020/6/16,55.24126354,143,12,29427,1617,No,No,18367
Colorado,2020/6/17,55.24126354,231,14,29658,1631,No,No,18671
Colorado,2020/6/18,55.24126354,228,7,29886,1638,No,No,18671
Colorado,2020/6/19,55.24126354,286,5,30172,1643,No,No,18671
Colorado,2020/6/20,55.24126354,162,4,30334,1647,No,No,18671
Colorado,2020/6/21,55.24126354,190,0,30524,1647,No,No,18671
Colorado,2020/6/22,55.24126354,165,4,30689,1651,No,No,18671
Colorado,2020/6/23,55.24126354,188,14,30877,1665,No,No,18671
Colorado,2020/6/24,55.24126354,262,2,31139,1667,No,No,18338
Colorado,2020/6/25,55.24126354,324,2,31463,1669,No,No,18338
Colorado,2020/6/26,55.24126354,317,4,31780,1673,No,No,18338
Colorado,2020/6/27,55.24126354,226,1,32006,1674,No,No,18338
Colorado,2020/6/28,55.24126354,284,2,32290,1676,No,No,18338
Colorado,2020/6/29,55.24126354,205,6,32495,1682,No,No,18338
Colorado,2020/6/30,55.24126354,203,8,32698,1690,No,No,18338
Colorado,2020/7/1,55.24126354,314,7,33012,1697,No,No,19056
Colorado,2020/7/2,55.24126354,323,4,33335,1701,No,No,19056
Colorado,2020/7/3,55.24126354,272,0,33607,1701,No,No,19056
Colorado,2020/7/4,55.24126354,293,2,33900,1703,No,No,19056
Colorado,2020/7/5,55.24126354,200,0,34100,1703,No,No,19056
Colorado,2020/7/6,55.24126354,216,1,34316,1704,No,No,19056
Colorado,2020/7/7,55.24126354,401,5,34717,1709,No,No,19056
Colorado,2020/7/8,55.24126354,468,-2,35185,1707,No,No,20563
Colorado,2020/7/9,55.24126354,419,0,35604,1707,No,No,20563
Colorado,2020/7/10,55.24126354,606,17,36210,1724,No,No,20563
Colorado,2020/7/11,55.24126354,423,1,36633,1725,No,No,20563
Colorado,2020/7/12,55.24126354,300,1,36933,1726,No,No,20563
Colorado,2020/7/13,55.24126354,370,2,37303,1728,No,No,20563
Colorado,2020/7/14,55.24126354,458,11,37761,1739,No,No,20563
Colorado,2020/7/15,55.24126354,479,6,38240,1745,No,No,23676
Colorado,2020/7/16,55.24126354,577,1,38817,1746,No,Yes,23676
Colorado,2020/7/17,55.24126354,592,7,39409,1753,No,Yes,23676
Colorado,2020/7/18,55.24126354,402,0,39811,1753,No,Yes,23676
Colorado,2020/7/19,55.24126354,371,0,40182,1753,No,Yes,23676
Colorado,2020/7/20,55.24126354,467,6,40649,1759,No,Yes,23676
Colorado,2020/7/21,55.24126354,503,5,41152,1764,No,Yes,23676
Colorado,2020/7/22,55.24126354,595,8,41747,1772,No,Yes,17437
Colorado,2020/7/23,55.24126354,662,16,42409,1788,No,Yes,17437
Colorado,2020/7/24,55.24126354,689,3,43098,1791,No,Yes,17437
Colorado,2020/7/25,55.24126354,749,4,43847,1795,No,Yes,17437
Colorado,2020/7/26,55.24126354,517,0,44364,1795,No,Yes,17437
Colorado,2020/7/27,55.24126354,359,5,44723,1800,No,Yes,17437
Colorado,2020/7/28,55.24126354,697,9,45420,1809,No,Yes,17437
Colorado,2020/7/29,55.24126354,465,17,45885,1826,No,Yes,11690
Colorado,2020/7/30,55.24126354,453,0,46338,1826,No,Yes,11690
Colorado,2020/7/31,55.24126354,610,15,46948,1841,No,Yes,11690
Colorado,2020/8/1,55.24126354,409,5,47357,1846,No,Yes,11690
Colorado,2020/8/2,55.24126354,442,0,47799,1846,No,Yes,11690
Colorado,2020/8/3,55.24126354,320,3,48119,1849,No,Yes,11690
Colorado,2020/8/4,55.24126354,373,6,48492,1855,No,Yes,11690
Colorado,2020/8/5,55.24126354,651,2,49143,1857,No,Yes,9467
Colorado,2020/8/6,55.24126354,490,0,49633,1857,No,Yes,9467
Colorado,2020/8/7,55.24126354,448,5,50081,1862,No,Yes,9467
Colorado,2020/8/8,55.24126354,410,0,50491,1862,No,Yes,9467
Colorado,2020/8/9,55.24126354,308,1,50799,1863,No,Yes,9467
Colorado,2020/8/10,55.24126354,305,5,51104,1868,No,Yes,9467
Colorado,2020/8/11,55.24126354,383,10,51487,1878,No,Yes,9467
Colorado,2020/8/12,55.24126354,360,3,51847,1881,No,Yes,11047
Colorado,2020/8/13,55.24126354,395,5,52242,1886,No,Yes,11047
Colorado,2020/8/14,55.24126354,345,6,52587,1892,No,Yes,11047
Colorado,2020/8/15,55.24126354,281,5,52868,1897,No,Yes,11047
Colorado,2020/8/16,55.24126354,320,0,53188,1897,No,Yes,11047
Colorado,2020/8/17,55.24126354,203,6,53391,1903,No,Yes,11047
Colorado,2020/8/18,55.24126354,283,3,53674,1906,No,Yes,11047
Colorado,2020/8/19,55.24126354,269,0,53943,1906,No,Yes,8676
Colorado,2020/8/20,55.24126354,342,3,54285,1909,No,Yes,8676
Colorado,2020/8/21,55.24126354,373,6,54658,1915,No,Yes,8676
Colorado,2020/8/22,55.24126354,281,8,54939,1923,No,Yes,8676
Colorado,2020/8/23,55.24126354,502,2,55441,1925,No,Yes,8676
Colorado,2020/8/24,55.24126354,259,1,55700,1926,No,Yes,8676
Colorado,2020/8/25,55.24126354,476,6,56176,1932,No,Yes,8676
Colorado,2020/8/26,55.24126354,170,1,56346,1933,No,Yes,8511
Colorado,2020/8/27,55.24126354,360,4,56706,1937,No,Yes,8511
Colorado,2020/8/28,55.24126354,452,8,57158,1945,No,Yes,8511
Colorado,2020/8/29,55.24126354,168,1,57326,1946,No,Yes,8511
Colorado,2020/8/30,55.24126354,189,-1,57515,1945,No,Yes,8511
Colorado,2020/8/31,55.24126354,282,7,57797,1952,No,Yes,8511
Colorado,2020/9/1,55.24126354,321,1,58118,1953,No,Yes,8511
Colorado,2020/9/2,55.24126354,274,7,58392,1960,No,Yes,8901
Colorado,2020/9/3,55.24126354,288,3,58680,1963,No,Yes,8901
Colorado,2020/9/4,55.24126354,341,10,59021,1973,No,Yes,8901
Colorado,2020/9/5,55.24126354,341,5,59362,1978,No,Yes,8901
Colorado,2020/9/6,55.24126354,264,2,59626,1980,No,Yes,8901
Colorado,2020/9/7,55.24126354,197,0,59823,1980,No,Yes,8901
Colorado,2020/9/8,55.24126354,180,0,60003,1980,No,Yes,8901
Colorado,2020/9/9,55.24126354,288,4,60291,1984,No,Yes,8848
Colorado,2020/9/10,55.24126354,285,4,60576,1988,No,Yes,8848
Colorado,2020/9/11,55.24126354,305,3,60881,1991,No,Yes,8848
Colorado,2020/9/12,55.24126354,430,3,61311,1994,No,Yes,8848
Colorado,2020/9/13,55.24126354,330,0,61641,1994,No,Yes,8848
Colorado,2020/9/14,55.24126354,391,6,62032,2000,No,Yes,8848
Colorado,2020/9/15,55.24126354,543,6,62575,2006,No,Yes,8848
Colorado,2020/9/16,55.24126354,493,4,63068,2010,No,Yes,8679
Colorado,2020/9/17,55.24126354,545,6,63613,2016,No,Yes,8679
Colorado,2020/9/18,55.24126354,664,4,64277,2020,No,Yes,8679
Colorado,2020/9/19,55.24126354,417,2,64694,2022,No,Yes,8679
Colorado,2020/9/20,55.24126354,554,1,65248,2023,No,Yes,8679
Colorado,2020/9/21,55.24126354,688,8,65936,2031,No,Yes,8679
Colorado,2020/9/22,55.24126354,616,3,66552,2034,No,Yes,8679
Colorado,2020/9/23,55.24126354,634,4,67186,2038,No,Yes,8805
Colorado,2020/9/24,55.24126354,559,4,67745,2042,No,Yes,8805
Colorado,2020/9/25,55.24126354,761,3,68506,2045,No,Yes,8805
Colorado,2020/9/26,55.24126354,467,2,68973,2047,No,Yes,8805
Colorado,2020/9/27,55.24126354,499,1,69472,2048,No,Yes,8805
Colorado,2020/9/28,55.24126354,495,4,69967,2052,No,Yes,8805
Colorado,2020/9/29,55.24126354,491,6,70458,2058,No,Yes,8805
Colorado,2020/9/30,55.24126354,632,3,71090,2061,No,Yes,7732
Colorado,2020/10/1,55.24126354,633,3,71723,2064,No,Yes,7732
Colorado,2020/10/2,55.24126354,731,5,72454,2069,No,Yes,7732
Colorado,2020/10/3,55.24126354,475,2,72929,2071,No,Yes,7732
Colorado,2020/10/4,55.24126354,460,6,73389,2077,No,Yes,7732
Colorado,2020/10/5,55.24126354,640,8,74029,2085,No,Yes,7732
Colorado,2020/10/6,55.24126354,506,9,74535,2094,No,Yes,7732
Colorado,2020/10/7,55.24126354,875,3,75410,2097,No,Yes,8581
Colorado,2020/10/8,55.24126354,776,10,76186,2107,No,Yes,8581
Colorado,2020/10/9,55.24126354,882,8,77068,2115,No,Yes,8581
Colorado,2020/10/10,55.24126354,979,6,78047,2121,No,Yes,8581
Colorado,2020/10/11,55.24126354,705,13,78752,2134,No,Yes,8581
Colorado,2020/10/12,55.24126354,747,10,79499,2144,No,Yes,8581
Colorado,2020/10/13,55.24126354,915,37,80414,2181,No,Yes,8581
Colorado,2020/10/14,55.24126354,791,5,81205,2186,No,Yes,7964
Colorado,2020/10/15,55.24126354,1238,1,82443,2187,No,Yes,7964
Colorado,2020/10/16,55.24126354,1269,9,83712,2196,No,Yes,7964
Colorado,2020/10/17,55.24126354,1092,3,84804,2199,No,Yes,7964
Colorado,2020/10/18,55.24126354,999,0,85803,2199,No,Yes,7964
Colorado,2020/10/19,55.24126354,924,8,86727,2207,No,Yes,7964
Colorado,2020/10/20,55.24126354,1239,5,87966,2212,No,Yes,7964
Colorado,2020/10/21,55.24126354,1279,8,89245,2220,No,Yes,7126
Colorado,2020/10/22,55.24126354,1394,4,90639,2224,No,Yes,7126
Colorado,2020/10/23,55.24126354,1428,9,92067,2233,No,Yes,7126
Colorado,2020/10/24,55.24126354,1922,8,93989,2241,No,Yes,7126
Colorado,2020/10/25,55.24126354,1753,3,95742,2244,No,Yes,7126
Colorado,2020/10/26,55.24126354,1944,11,97686,2255,No,Yes,7126
Colorado,2020/10/27,55.24126354,1425,10,99111,2265,No,Yes,7126
Colorado,2020/10/28,55.24126354,1503,12,100614,2277,No,Yes,7060
Colorado,2020/10/29,55.24126354,2051,18,102665,2295,No,Yes,7060
Colorado,2020/10/30,55.24126354,2262,7,104927,2302,No,Yes,7060
Colorado,2020/10/31,55.24126354,2917,7,107844,2309,No,Yes,7060
Colorado,2020/11/1,55.24126354,2796,3,110640,2312,No,Yes,7060
Colorado,2020/11/2,55.24126354,2181,8,112821,2320,No,Yes,7060
Colorado,2020/11/3,55.24126354,2543,17,115364,2337,No,Yes,7060
Colorado,2020/11/4,55.24126354,2992,29,118356,2366,No,Yes,8764
Colorado,2020/11/5,55.24126354,3814,17,122170,2383,No,Yes,8764
Colorado,2020/11/6,55.24126354,3227,21,125397,2404,No,Yes,8764
Colorado,2020/11/7,55.24126354,3214,13,128611,2417,No,Yes,8764
Colorado,2020/11/8,55.24126354,3259,4,131870,2421,No,Yes,8764
Colorado,2020/11/9,55.24126354,3877,17,135747,2438,No,Yes,8764
Colorado,2020/11/10,55.24126354,3499,31,139246,2469,No,Yes,8764
Colorado,2020/11/11,55.24126354,4307,12,143553,2481,No,Yes,9262
Colorado,2020/11/12,55.24126354,5709,31,149262,2512,No,Yes,9262
Colorado,2020/11/13,55.24126354,6499,29,155761,2541,No,Yes,9262
Colorado,2020/11/14,55.24126354,4698,13,160459,2554,No,Yes,9262
Colorado,2020/11/15,55.24126354,3949,20,164408,2574,No,Yes,9262
Colorado,2020/11/16,55.24126354,4482,31,168890,2605,No,Yes,9262
Colorado,2020/11/17,55.24126354,4330,21,173220,2626,No,Yes,9262
Colorado,2020/11/18,55.24126354,5004,43,178224,2669,No,Yes,11813
Colorado,2020/11/19,55.24126354,6036,65,184260,2734,No,Yes,11813
Colorado,2020/11/20,55.24126354,5840,18,190100,2752,No,Yes,11813
Colorado,2020/11/21,55.24126354,5120,39,195220,2791,No,Yes,11813
Colorado,2020/11/22,55.24126354,4076,20,199296,2811,No,Yes,11813
Colorado,2020/11/23,55.24126354,4282,10,203578,2821,No,Yes,11813
Colorado,2020/11/24,55.24126354,4304,47,207882,2868,No,Yes,11813
Colorado,2020/11/25,55.24126354,4534,62,212416,2930,No,Yes,7061
Colorado,2020/11/26,55.24126354,5239,47,217655,2977,No,Yes,7061
Colorado,2020/11/27,55.24126354,4889,21,222544,2998,No,Yes,7061
Colorado,2020/11/28,55.24126354,4023,14,226567,3012,No,Yes,7061
Colorado,2020/11/29,55.24126354,3490,13,230057,3025,No,Yes,7061
Colorado,2020/11/30,55.24126354,4445,35,234502,3060,No,Yes,7061
Colorado,2020/12/1,55.24126354,4277,76,238779,3136,No,Yes,7061
Colorado,2020/12/2,55.24126354,4545,90,243324,3226,No,Yes,7656
Colorado,2020/12/3,55.24126354,5455,109,248779,3335,No,Yes,7656
Colorado,2020/12/4,55.24126354,4181,40,252960,3375,No,Yes,7656
Colorado,2020/12/5,55.24126354,5164,40,258124,3415,No,Yes,7656
Colorado,2020/12/6,55.24126354,4336,22,262460,3437,No,Yes,7656
Colorado,2020/12/7,55.24126354,4210,29,266670,3466,No,Yes,7656
Colorado,2020/12/8,55.24126354,3711,42,270381,3508,No,Yes,7656
Colorado,2020/12/9,55.24126354,3973,163,274354,3671,No,Yes,7568
Colorado,2020/12/10,55.24126354,4562,124,278916,3795,No,Yes,7568
Colorado,2020/12/11,55.24126354,4655,63,283571,3858,No,Yes,7568
Colorado,2020/12/12,55.24126354,3793,58,287364,3916,No,Yes,7568
Colorado,2020/12/13,55.24126354,2315,66,289679,3982,No,Yes,7568
Colorado,2020/12/14,55.24126354,1966,33,291645,4015,No,Yes,7568
Colorado,2020/12/15,55.24126354,3913,116,295558,4131,No,Yes,7568
Colorado,2020/12/16,55.24126354,2934,61,298492,4192,No,Yes,7543
Colorado,2020/12/17,55.24126354,3594,73,302086,4265,No,Yes,7543
Colorado,2020/12/18,55.24126354,3536,58,305622,4323,No,Yes,7543
Colorado,2020/12/19,55.24126354,2728,77,308350,4400,No,Yes,7543
Colorado,2020/12/20,55.24126354,2172,20,310522,4420,No,Yes,7543
Colorado,2020/12/21,55.24126354,2191,12,312713,4432,No,Yes,7543
Colorado,2020/12/22,55.24126354,2684,32,315397,4464,No,Yes,7543
Colorado,2020/12/23,55.24126354,2630,67,318027,4531,No,Yes,5506
Colorado,2020/12/24,55.24126354,2687,79,320714,4610,No,Yes,5506
Colorado,2020/12/25,55.24126354,2615,21,323329,4631,No,Yes,5506
Colorado,2020/12/26,55.24126354,1540,21,324869,4652,No,Yes,5506
Colorado,2020/12/27,55.24126354,1407,8,326276,4660,No,Yes,5506
Colorado,2020/12/28,55.24126354,1973,39,328249,4699,No,Yes,5506
Colorado,2020/12/29,55.24126354,1869,59,330118,4758,No,Yes,5506
Colorado,2020/12/30,55.24126354,2568,64,332686,4822,No,Yes,10986
Colorado,2020/12/31,55.24126354,2893,57,335579,4879,No,Yes,10986
Colorado,2021/1/1,55.24126354,2778,57,338357,4936,No,Yes,10986
Colorado,2021/1/2,55.24126354,2097,40,340454,4976,No,Yes,10986
Colorado,2021/1/3,55.24126354,2040,21,342494,4997,No,Yes,10986
Colorado,2021/1/4,55.24126354,2745,14,345239,5011,No,Yes,10986
Colorado,2021/1/5,55.24126354,3244,47,348483,5058,No,Yes,10986
Colorado,2021/1/6,55.24126354,2077,22,350560,5080,No,Yes,14084
Colorado,2021/1/7,55.24126354,4438,84,354998,5164,No,Yes,14084
Colorado,2021/1/8,55.24126354,2467,43,357465,5207,No,No,14084
Colorado,2021/1/9,55.24126354,3392,55,360857,5262,No,No,14084
Colorado,2021/1/10,55.24126354,2162,17,363019,5279,No,No,14084
Colorado,2021/1/11,55.24126354,1796,12,364815,5291,No,No,14084
Colorado,2021/1/12,55.24126354,1570,35,366385,5326,No,No,14084
Colorado,2021/1/13,55.24126354,2390,28,368775,5354,No,No,11980
Colorado,2021/1/14,55.24126354,2587,31,371362,5385,No,No,11980
Colorado,2021/1/15,55.24126354,2285,32,373647,5417,No,No,11980
Colorado,2021/1/16,55.24126354,1816,23,375463,5440,No,No,11980
Colorado,2021/1/17,55.24126354,1458,14,376921,5454,No,No,11980
Colorado,2021/1/18,55.24126354,1390,8,378311,5462,No,No,11980
Colorado,2021/1/19,55.24126354,1688,11,379999,5473,No,No,11980
Colorado,2021/1/20,55.24126354,1415,36,381414,5509,No,No,11615
Colorado,2021/1/21,55.24126354,1504,14,382918,5523,No,No,11615
Colorado,2021/1/22,55.24126354,2235,25,385153,5548,No,No,11615
Colorado,2021/1/23,55.24126354,1279,13,386432,5561,No,No,11615
Colorado,2021/1/24,55.24126354,1528,27,387960,5588,No,No,11615
Colorado,2021/1/25,55.24126354,1267,14,389227,5602,No,No,11615
Colorado,2021/1/26,55.24126354,1435,15,390662,5617,No,No,11615
Colorado,2021/1/27,55.24126354,1786,31,392448,5648,No,No,12664
Colorado,2021/1/28,55.24126354,2220,22,394668,5670,No,No,12664
Colorado,2021/1/29,55.24126354,1104,24,395772,5694,No,No,12664
Colorado,2021/1/30,55.24126354,348,2,396120,5696,No,No,12664
Colorado,2021/1/31,55.24126354,1018,15,397138,5711,No,No,12664
Colorado,2021/2/1,55.24126354,2246,26,399384,5737,No,No,12664
Colorado,2021/2/2,55.24126354,999,10,400383,5747,No,No,12664
Colorado,2021/2/3,55.24126354,1368,12,401751,5759,No,No,13464
Colorado,2021/2/4,55.24126354,1661,15,403412,5774,No,No,13464
Colorado,2021/2/5,55.24126354,1788,30,405200,5804,No,No,13464
Colorado,2021/2/6,55.24126354,1377,15,406577,5819,No,No,13464
Colorado,2021/2/7,55.24126354,1124,9,407701,5828,No,No,13464
Colorado,2021/2/8,55.24126354,1092,4,408793,5832,No,No,13464
Colorado,2021/2/9,55.24126354,859,10,409652,5842,No,No,13464
Colorado,2021/2/10,55.24126354,732,26,410384,5868,No,No,12087
Colorado,2021/2/11,55.24126354,1613,13,411997,5881,No,No,12087
Colorado,2021/2/12,55.24126354,2174,12,414171,5893,No,No,12087
Colorado,2021/2/13,55.24126354,1090,20,415261,5913,No,No,12087
Colorado,2021/2/14,55.24126354,596,8,415857,5921,No,No,12087
Colorado,2021/2/15,55.24126354,1048,3,416905,5924,No,No,12087
Colorado,2021/2/16,55.24126354,783,8,417688,5932,No,No,12087
Colorado,2021/2/17,55.24126354,1134,13,418822,5945,No,No,11395
Colorado,2021/2/18,55.24126354,1272,21,420094,5966,No,No,11395
Colorado,2021/2/19,55.24126354,1233,14,421327,5980,No,No,11395
Colorado,2021/2/20,55.24126354,913,4,422240,5984,No,No,11395
Colorado,2021/2/21,55.24126354,968,5,423208,5989,No,No,11395
Colorado,2021/2/22,55.24126354,889,1,424097,5990,No,No,11395
Colorado,2021/2/23,55.24126354,1058,13,425155,6003,No,No,11395
Colorado,2021/2/24,55.24126354,1126,9,426281,6012,No,No,11395
Colorado,2021/2/25,55.24126354,1218,7,427499,6019,No,No,11395
Colorado,2021/2/26,55.24126354,976,4,428475,6023,No,No,11395
Colorado,2021/2/27,55.24126354,1654,15,430129,6038,No,No,11395
Colorado,2021/2/28,55.24126354,841,7,430970,6045,No,No,11395
Colorado,2021/3/1,55.24126354,1216,1,432186,6046,No,No,11395
Colorado,2021/3/2,55.24126354,753,8,432939,6054,No,No,11395
Colorado,2021/3/3,55.24126354,1204,9,434143,6063,No,No,11395
Colorado,2021/3/4,55.24126354,1305,3,435448,6066,No,No,11395
Connecticut,2020/3/1,711.7762028,0,0,0,0,No,No,1575
Connecticut,2020/3/2,711.7762028,0,0,0,0,No,No,1575
Connecticut,2020/3/3,711.7762028,0,0,0,0,No,No,1575
Connecticut,2020/3/4,711.7762028,0,0,0,0,No,No,1663
Connecticut,2020/3/5,711.7762028,0,0,0,0,No,No,1663
Connecticut,2020/3/6,711.7762028,0,0,0,0,No,No,1663
Connecticut,2020/3/7,711.7762028,0,0,0,0,No,No,1663
Connecticut,2020/3/8,711.7762028,1,0,1,0,No,No,1663
Connecticut,2020/3/9,711.7762028,1,0,2,0,No,No,1663
Connecticut,2020/3/10,711.7762028,0,0,2,0,No,No,1663
Connecticut,2020/3/11,711.7762028,1,0,3,0,No,No,1819
Connecticut,2020/3/12,711.7762028,3,0,6,0,No,No,1819
Connecticut,2020/3/13,711.7762028,5,0,11,0,No,No,1819
Connecticut,2020/3/14,711.7762028,9,0,20,0,No,No,1819
Connecticut,2020/3/15,711.7762028,6,0,26,0,No,No,1819
Connecticut,2020/3/16,711.7762028,15,0,41,0,No,No,1819
Connecticut,2020/3/17,711.7762028,27,0,68,0,No,No,1819
Connecticut,2020/3/18,711.7762028,28,1,96,1,No,No,10892
Connecticut,2020/3/19,711.7762028,63,3,159,4,No,No,10892
Connecticut,2020/3/20,711.7762028,35,0,194,4,No,No,10892
Connecticut,2020/3/21,711.7762028,29,1,223,5,No,No,10892
Connecticut,2020/3/22,711.7762028,104,3,327,8,No,No,10892
Connecticut,2020/3/23,711.7762028,88,2,415,10,Yes,No,10892
Connecticut,2020/3/24,711.7762028,203,2,618,12,Yes,No,10892
Connecticut,2020/3/25,711.7762028,257,7,875,19,Yes,No,80984
Connecticut,2020/3/26,711.7762028,137,2,1012,21,Yes,No,80984
Connecticut,2020/3/27,711.7762028,279,6,1291,27,Yes,No,80984
Connecticut,2020/3/28,711.7762028,233,6,1524,33,Yes,No,80984
Connecticut,2020/3/29,711.7762028,469,1,1993,34,Yes,No,80984
Connecticut,2020/3/30,711.7762028,578,2,2571,36,Yes,No,80984
Connecticut,2020/3/31,711.7762028,557,33,3128,69,Yes,No,80984
Connecticut,2020/4/1,711.7762028,429,16,3557,85,Yes,No,106739
Connecticut,2020/4/2,711.7762028,267,27,3824,112,Yes,No,106739
Connecticut,2020/4/3,711.7762028,1091,20,4915,132,Yes,No,106739
Connecticut,2020/4/4,711.7762028,361,33,5276,165,Yes,No,106739
Connecticut,2020/4/5,711.7762028,399,24,5675,189,Yes,No,106739
Connecticut,2020/4/6,711.7762028,1231,17,6906,206,Yes,No,106739
Connecticut,2020/4/7,711.7762028,875,71,7781,277,Yes,No,106739
Connecticut,2020/4/8,711.7762028,1000,58,8781,335,Yes,No,77515
Connecticut,2020/4/9,711.7762028,1003,45,9784,380,Yes,No,77515
Connecticut,2020/4/10,711.7762028,754,68,10538,448,Yes,No,77515
Connecticut,2020/4/11,711.7762028,972,46,11510,494,Yes,No,77515
Connecticut,2020/4/12,711.7762028,525,60,12035,554,Yes,No,77515
Connecticut,2020/4/13,711.7762028,1346,48,13381,602,Yes,No,77515
Connecticut,2020/4/14,711.7762028,608,69,13989,671,Yes,No,77515
Connecticut,2020/4/15,711.7762028,766,197,14755,868,Yes,No,66432
Connecticut,2020/4/16,711.7762028,1129,103,15884,971,Yes,No,66432
Connecticut,2020/4/17,711.7762028,925,65,16809,1036,Yes,No,66432
Connecticut,2020/4/18,711.7762028,741,50,17550,1086,Yes,No,66432
Connecticut,2020/4/19,711.7762028,412,41,17962,1127,Yes,No,66432
Connecticut,2020/4/20,711.7762028,1853,204,19815,1331,Yes,No,66432
Connecticut,2020/4/21,711.7762028,545,92,20360,1423,Yes,No,66432
Connecticut,2020/4/22,711.7762028,2109,121,22469,1544,Yes,No,74966
Connecticut,2020/4/23,711.7762028,631,95,23100,1639,Yes,No,74966
Connecticut,2020/4/24,711.7762028,821,125,23921,1764,Yes,No,74966
Connecticut,2020/4/25,711.7762028,661,98,24582,1862,Yes,No,74966
Connecticut,2020/4/26,711.7762028,687,63,25269,1925,Yes,No,74966
Connecticut,2020/4/27,711.7762028,728,87,25997,2012,Yes,No,74966
Connecticut,2020/4/28,711.7762028,315,77,26312,2089,Yes,No,74966
Connecticut,2020/4/29,711.7762028,455,79,26767,2168,Yes,No,28985
Connecticut,2020/4/30,711.7762028,933,89,27700,2257,Yes,No,28985
Connecticut,2020/5/1,711.7762028,1064,82,28764,2339,Yes,No,28985
Connecticut,2020/5/2,711.7762028,523,97,29287,2436,Yes,No,28985
Connecticut,2020/5/3,711.7762028,0,0,29287,2436,Yes,No,28985
Connecticut,2020/5/4,711.7762028,686,120,29973,2556,Yes,No,28985
Connecticut,2020/5/5,711.7762028,648,77,30621,2633,Yes,No,28985
Connecticut,2020/5/6,711.7762028,374,85,30995,2718,Yes,No,26666
Connecticut,2020/5/7,711.7762028,789,79,31784,2797,Yes,No,26666
Connecticut,2020/5/8,711.7762028,627,77,32411,2874,Yes,No,26666
Connecticut,2020/5/9,711.7762028,573,58,32984,2932,Yes,No,26666
Connecticut,2020/5/10,711.7762028,570,35,33554,2967,Yes,No,26666
Connecticut,2020/5/11,711.7762028,211,41,33765,3008,Yes,No,26666
Connecticut,2020/5/12,711.7762028,568,33,34333,3041,Yes,No,26666
Connecticut,2020/5/13,711.7762028,522,84,34855,3125,Yes,No,25150
Connecticut,2020/5/14,711.7762028,609,94,35464,3219,Yes,No,25150
Connecticut,2020/5/15,711.7762028,621,66,36085,3285,Yes,No,25150
Connecticut,2020/5/16,711.7762028,618,54,36703,3339,Yes,No,25150
Connecticut,2020/5/17,711.7762028,716,69,37419,3408,Yes,No,25150
Connecticut,2020/5/18,711.7762028,697,41,38116,3449,Yes,No,25150
Connecticut,2020/5/19,711.7762028,314,23,38430,3472,Yes,No,25150
Connecticut,2020/5/20,711.7762028,587,57,39017,3529,Yes,No,27919
Connecticut,2020/5/21,711.7762028,191,53,39208,3582,No,No,27919
Connecticut,2020/5/22,711.7762028,432,55,39640,3637,No,No,27919
Connecticut,2020/5/23,711.7762028,382,38,40022,3675,No,No,27919
Connecticut,2020/5/24,711.7762028,446,18,40468,3693,No,No,27919
Connecticut,2020/5/25,711.7762028,405,49,40873,3742,No,No,27919
Connecticut,2020/5/26,711.7762028,430,27,41303,3769,No,No,27919
Connecticut,2020/5/27,711.7762028,-15,34,41288,3803,No,No,21335
Connecticut,2020/5/28,711.7762028,271,23,41559,3826,No,No,21335
Connecticut,2020/5/29,711.7762028,203,42,41762,3868,No,No,21335
Connecticut,2020/5/30,711.7762028,260,44,42022,3912,No,No,21335
Connecticut,2020/5/31,711.7762028,179,32,42201,3944,No,No,21335
Connecticut,2020/6/1,711.7762028,539,20,42740,3964,No,No,21335
Connecticut,2020/6/2,711.7762028,239,8,42979,3972,No,No,21335
Connecticut,2020/6/3,711.7762028,112,17,43091,3989,No,No,19949
Connecticut,2020/6/4,711.7762028,148,18,43239,4007,No,No,19949
Connecticut,2020/6/5,711.7762028,221,31,43460,4038,No,No,19949
Connecticut,2020/6/6,711.7762028,358,17,43818,4055,No,No,19949
Connecticut,2020/6/7,711.7762028,150,16,43968,4071,No,No,19949
Connecticut,2020/6/8,711.7762028,124,13,44092,4084,No,No,19949
Connecticut,2020/6/9,711.7762028,87,13,44179,4097,No,No,19949
Connecticut,2020/6/10,711.7762028,168,23,44347,4120,No,No,18367
Connecticut,2020/6/11,711.7762028,114,26,44461,4146,No,No,18367
Connecticut,2020/6/12,711.7762028,228,13,44689,4159,No,No,18367
Connecticut,2020/6/13,711.7762028,305,27,44994,4186,No,No,18367
Connecticut,2020/6/14,711.7762028,94,15,45088,4201,No,No,18367
Connecticut,2020/6/15,711.7762028,147,3,45235,4204,No,No,18367
Connecticut,2020/6/16,711.7762028,114,6,45349,4210,No,No,18367
Connecticut,2020/6/17,711.7762028,80,9,45429,4219,No,No,18671
Connecticut,2020/6/18,711.7762028,11,7,45440,4226,No,No,18671
Connecticut,2020/6/19,711.7762028,117,12,45557,4238,No,No,18671
Connecticut,2020/6/20,711.7762028,158,13,45715,4251,No,No,18671
Connecticut,2020/6/21,711.7762028,40,9,45755,4260,No,No,18671
Connecticut,2020/6/22,711.7762028,27,3,45782,4263,No,No,18671
Connecticut,2020/6/23,711.7762028,117,14,45899,4277,No,No,18671
Connecticut,2020/6/24,711.7762028,14,10,45913,4287,No,No,18338
Connecticut,2020/6/25,711.7762028,81,11,45994,4298,No,No,18338
Connecticut,2020/6/26,711.7762028,65,9,46059,4307,No,No,18338
Connecticut,2020/6/27,711.7762028,147,4,46206,4311,No,No,18338
Connecticut,2020/6/28,711.7762028,97,5,46303,4316,No,No,18338
Connecticut,2020/6/29,711.7762028,59,4,46362,4320,No,No,18338
Connecticut,2020/6/30,711.7762028,152,2,46514,4322,No,No,18338
Connecticut,2020/7/1,711.7762028,58,2,46572,4324,No,No,19056
Connecticut,2020/7/2,711.7762028,74,2,46646,4326,No,No,19056
Connecticut,2020/7/3,711.7762028,71,9,46717,4335,No,No,19056
Connecticut,2020/7/4,711.7762028,0,0,46717,4335,No,No,19056
Connecticut,2020/7/5,711.7762028,0,0,46717,4335,No,No,19056
Connecticut,2020/7/6,711.7762028,259,3,46976,4338,No,No,19056
Connecticut,2020/7/7,711.7762028,57,0,47033,4338,No,No,19056
Connecticut,2020/7/8,711.7762028,75,5,47108,4343,No,No,20563
Connecticut,2020/7/9,711.7762028,101,5,47209,4348,No,No,20563
Connecticut,2020/7/10,711.7762028,78,0,47287,4348,No,No,20563
Connecticut,2020/7/11,711.7762028,0,0,47287,4348,No,No,20563
Connecticut,2020/7/12,711.7762028,0,0,47287,4348,No,No,20563
Connecticut,2020/7/13,711.7762028,223,23,47510,4371,No,No,20563
Connecticut,2020/7/14,711.7762028,20,1,47530,4372,No,No,20563
Connecticut,2020/7/15,711.7762028,106,8,47636,4380,No,No,23676
Connecticut,2020/7/16,711.7762028,114,9,47750,4389,No,No,23676
Connecticut,2020/7/17,711.7762028,143,7,47893,4396,No,No,23676
Connecticut,2020/7/18,711.7762028,0,0,47893,4396,No,No,23676
Connecticut,2020/7/19,711.7762028,0,0,47893,4396,No,No,23676
Connecticut,2020/7/20,711.7762028,162,10,48055,4406,No,No,23676
Connecticut,2020/7/21,711.7762028,41,0,48096,4406,No,No,23676
Connecticut,2020/7/22,711.7762028,127,0,48223,4406,No,No,17437
Connecticut,2020/7/23,711.7762028,9,4,48232,4410,No,No,17437
Connecticut,2020/7/24,711.7762028,544,3,48776,4413,No,No,17437
Connecticut,2020/7/25,711.7762028,0,0,48776,4413,No,No,17437
Connecticut,2020/7/26,711.7762028,0,0,48776,4413,No,No,17437
Connecticut,2020/7/27,711.7762028,207,5,48983,4418,No,No,17437
Connecticut,2020/7/28,711.7762028,94,5,49077,4423,No,No,17437
Connecticut,2020/7/29,711.7762028,463,2,49540,4425,No,No,11690
Connecticut,2020/7/30,711.7762028,130,6,49670,4431,No,No,11690
Connecticut,2020/7/31,711.7762028,140,1,49810,4432,No,No,11690
Connecticut,2020/8/1,711.7762028,0,0,49810,4432,No,No,11690
Connecticut,2020/8/2,711.7762028,0,0,49810,4432,No,No,11690
Connecticut,2020/8/3,711.7762028,252,5,50062,4437,No,No,11690
Connecticut,2020/8/4,711.7762028,48,0,50110,4437,No,No,11690
Connecticut,2020/8/5,711.7762028,115,0,50225,4437,No,No,9467
Connecticut,2020/8/6,711.7762028,20,0,50245,4437,No,No,9467
Connecticut,2020/8/7,711.7762028,75,4,50320,4441,No,No,9467
Connecticut,2020/8/8,711.7762028,0,0,50320,4441,No,No,9467
Connecticut,2020/8/9,711.7762028,0,0,50320,4441,No,No,9467
Connecticut,2020/8/10,711.7762028,247,3,50567,4444,No,No,9467
Connecticut,2020/8/11,711.7762028,117,0,50684,4444,No,No,9467
Connecticut,2020/8/12,711.7762028,22,6,50706,4450,No,No,11047
Connecticut,2020/8/13,711.7762028,76,0,50782,4450,No,No,11047
Connecticut,2020/8/14,711.7762028,115,3,50897,4453,No,Yes,11047
Connecticut,2020/8/15,711.7762028,0,0,50897,4453,No,Yes,11047
Connecticut,2020/8/16,711.7762028,0,0,50897,4453,No,Yes,11047
Connecticut,2020/8/17,711.7762028,370,3,51267,4456,No,Yes,11047
Connecticut,2020/8/18,711.7762028,-12,0,51255,4456,No,Yes,11047
Connecticut,2020/8/19,711.7762028,59,1,51314,4457,No,Yes,8676
Connecticut,2020/8/20,711.7762028,118,1,51432,4458,No,Yes,8676
Connecticut,2020/8/21,711.7762028,87,2,51519,4460,No,Yes,8676
Connecticut,2020/8/22,711.7762028,0,0,51519,4460,No,Yes,8676
Connecticut,2020/8/23,711.7762028,0,0,51519,4460,No,Yes,8676
Connecticut,2020/8/24,711.7762028,492,0,52011,4460,No,Yes,8676
Connecticut,2020/8/25,711.7762028,29,3,52040,4463,No,Yes,8676
Connecticut,2020/8/26,711.7762028,180,0,52220,4463,No,Yes,8511
Connecticut,2020/8/27,711.7762028,130,2,52350,4465,No,Yes,8511
Connecticut,2020/8/28,711.7762028,145,0,52495,4465,No,Yes,8511
Connecticut,2020/8/29,711.7762028,0,0,52495,4465,No,Yes,8511
Connecticut,2020/8/30,711.7762028,0,0,52495,4465,No,Yes,8511
Connecticut,2020/8/31,711.7762028,384,0,52879,4465,No,Yes,8511
Connecticut,2020/9/1,711.7762028,127,1,53006,4466,No,Yes,8511
Connecticut,2020/9/2,711.7762028,102,1,53108,4467,No,Yes,8901
Connecticut,2020/9/3,711.7762028,101,1,53209,4468,No,Yes,8901
Connecticut,2020/9/4,711.7762028,156,0,53365,4468,No,Yes,8901
Connecticut,2020/9/5,711.7762028,0,0,53365,4468,No,Yes,8901
Connecticut,2020/9/6,711.7762028,0,0,53365,4468,No,Yes,8901
Connecticut,2020/9/7,711.7762028,0,0,53365,4468,No,Yes,8901
Connecticut,2020/9/8,711.7762028,417,6,53782,4474,No,Yes,8901
Connecticut,2020/9/9,711.7762028,89,0,53871,4474,No,Yes,8848
Connecticut,2020/9/10,711.7762028,222,4,54093,4478,No,Yes,8848
Connecticut,2020/9/11,711.7762028,233,2,54326,4480,No,Yes,8848
Connecticut,2020/9/12,711.7762028,0,0,54326,4480,No,Yes,8848
Connecticut,2020/9/13,711.7762028,0,0,54326,4480,No,Yes,8848
Connecticut,2020/9/14,711.7762028,569,5,54895,4485,No,Yes,8848
Connecticut,2020/9/15,711.7762028,136,0,55031,4485,No,Yes,8848
Connecticut,2020/9/16,711.7762028,135,2,55166,4487,No,Yes,8679
Connecticut,2020/9/17,711.7762028,220,1,55386,4488,No,Yes,8679
Connecticut,2020/9/18,711.7762028,141,4,55527,4492,No,Yes,8679
Connecticut,2020/9/19,711.7762028,0,0,55527,4492,No,Yes,8679
Connecticut,2020/9/20,711.7762028,0,0,55527,4492,No,Yes,8679
Connecticut,2020/9/21,711.7762028,497,3,56024,4495,No,Yes,8679
Connecticut,2020/9/22,711.7762028,136,1,56160,4496,No,Yes,8679
Connecticut,2020/9/23,711.7762028,155,1,56315,4497,No,Yes,8805
Connecticut,2020/9/24,711.7762028,157,2,56472,4499,No,Yes,8805
Connecticut,2020/9/25,711.7762028,115,2,56587,4501,No,Yes,8805
Connecticut,2020/9/26,711.7762028,0,0,56587,4501,No,Yes,8805
Connecticut,2020/9/27,711.7762028,0,0,56587,4501,No,Yes,8805
Connecticut,2020/9/28,711.7762028,560,2,57147,4503,No,Yes,8805
Connecticut,2020/9/29,711.7762028,182,2,57329,4505,No,Yes,8805
Connecticut,2020/9/30,711.7762028,221,3,57550,4508,No,Yes,7732
Connecticut,2020/10/1,711.7762028,192,3,57742,4511,No,Yes,7732
Connecticut,2020/10/2,711.7762028,555,2,58297,4513,No,Yes,7732
Connecticut,2020/10/3,711.7762028,0,0,58297,4513,No,Yes,7732
Connecticut,2020/10/4,711.7762028,0,0,58297,4513,No,Yes,7732
Connecticut,2020/10/5,711.7762028,823,4,59120,4517,No,Yes,7732
Connecticut,2020/10/6,711.7762028,121,4,59241,4521,No,Yes,7732
Connecticut,2020/10/7,711.7762028,123,1,59364,4522,No,Yes,8581
Connecticut,2020/10/8,711.7762028,384,5,59748,4527,No,Yes,8581
Connecticut,2020/10/9,711.7762028,290,3,60038,4530,No,Yes,8581
Connecticut,2020/10/10,711.7762028,0,0,60038,4530,No,Yes,8581
Connecticut,2020/10/11,711.7762028,0,0,60038,4530,No,Yes,8581
Connecticut,2020/10/12,711.7762028,1339,2,61377,4532,No,Yes,8581
Connecticut,2020/10/13,711.7762028,320,1,61697,4533,No,Yes,8581
Connecticut,2020/10/14,711.7762028,164,4,61861,4537,No,Yes,7964
Connecticut,2020/10/15,711.7762028,167,3,62028,4540,No,Yes,7964
Connecticut,2020/10/16,711.7762028,802,2,62830,4542,No,Yes,7964
Connecticut,2020/10/17,711.7762028,0,0,62830,4542,No,Yes,7964
Connecticut,2020/10/18,711.7762028,0,0,62830,4542,No,Yes,7964
Connecticut,2020/10/19,711.7762028,1191,12,64021,4554,No,Yes,7964
Connecticut,2020/10/20,711.7762028,434,5,64455,4559,No,Yes,7964
Connecticut,2020/10/21,711.7762028,416,8,64871,4567,No,Yes,7126
Connecticut,2020/10/22,711.7762028,502,2,65373,4569,No,Yes,7126
Connecticut,2020/10/23,711.7762028,679,8,66052,4577,No,Yes,7126
Connecticut,2020/10/24,711.7762028,0,0,66052,4577,No,Yes,7126
Connecticut,2020/10/25,711.7762028,0,0,66052,4577,No,Yes,7126
Connecticut,2020/10/26,711.7762028,2047,12,68099,4589,No,Yes,7126
Connecticut,2020/10/27,711.7762028,538,6,68637,4595,No,Yes,7126
Connecticut,2020/10/28,711.7762028,490,9,69127,4604,No,Yes,7060
Connecticut,2020/10/29,711.7762028,1319,5,70446,4609,No,Yes,7060
Connecticut,2020/10/30,711.7762028,761,7,71207,4616,No,Yes,7060
Connecticut,2020/10/31,711.7762028,0,0,71207,4616,No,Yes,7060
Connecticut,2020/11/1,711.7762028,0,0,71207,4616,No,Yes,7060
Connecticut,2020/11/2,711.7762028,2651,11,73858,4627,No,Yes,7060
Connecticut,2020/11/3,711.7762028,985,8,74843,4635,No,Yes,7060
Connecticut,2020/11/4,711.7762028,530,10,75373,4645,No,Yes,8764
Connecticut,2020/11/5,711.7762028,1687,11,77060,4656,No,Yes,8764
Connecticut,2020/11/6,711.7762028,1065,15,78125,4671,No,Yes,8764
Connecticut,2020/11/7,711.7762028,0,0,78125,4671,No,Yes,8764
Connecticut,2020/11/8,711.7762028,0,0,78125,4671,No,Yes,8764
Connecticut,2020/11/9,711.7762028,3338,27,81463,4698,No,Yes,8764
Connecticut,2020/11/10,711.7762028,1524,9,82987,4707,No,Yes,8764
Connecticut,2020/11/11,711.7762028,1754,9,84741,4716,No,Yes,9262
Connecticut,2020/11/12,711.7762028,1158,10,85899,4726,No,Yes,9262
Connecticut,2020/11/13,711.7762028,2746,11,88645,4737,No,Yes,9262
Connecticut,2020/11/14,711.7762028,0,0,88645,4737,No,Yes,9262
Connecticut,2020/11/15,711.7762028,0,0,88645,4737,No,Yes,9262
Connecticut,2020/11/16,711.7762028,4639,22,93284,4759,No,Yes,9262
Connecticut,2020/11/17,711.7762028,1702,12,94986,4771,No,Yes,9262
Connecticut,2020/11/18,711.7762028,2042,13,97028,4784,No,Yes,11813
Connecticut,2020/11/19,711.7762028,2353,21,99381,4805,No,Yes,11813
Connecticut,2020/11/20,711.7762028,2088,23,101469,4828,No,Yes,11813
Connecticut,2020/11/21,711.7762028,0,0,101469,4828,No,Yes,11813
Connecticut,2020/11/22,711.7762028,0,0,101469,4828,No,Yes,11813
Connecticut,2020/11/23,711.7762028,5271,43,106740,4871,No,Yes,11813
Connecticut,2020/11/24,711.7762028,540,10,107280,4881,No,Yes,11813
Connecticut,2020/11/25,711.7762028,1872,45,109152,4926,No,Yes,7061
Connecticut,2020/11/26,711.7762028,0,0,109152,4926,No,Yes,7061
Connecticut,2020/11/27,711.7762028,3429,35,112581,4961,No,Yes,7061
Connecticut,2020/11/28,711.7762028,0,0,112581,4961,No,Yes,7061
Connecticut,2020/11/29,711.7762028,0,0,112581,4961,No,Yes,7061
Connecticut,2020/11/30,711.7762028,4714,59,117295,5020,No,Yes,7061
Connecticut,2020/12/1,711.7762028,1459,20,118754,5040,No,Yes,7061
Connecticut,2020/12/2,711.7762028,2672,51,121426,5091,No,Yes,7656
Connecticut,2020/12/3,711.7762028,4751,20,126177,5111,No,Yes,7656
Connecticut,2020/12/4,711.7762028,1538,35,127715,5146,No,Yes,7656
Connecticut,2020/12/5,711.7762028,0,0,127715,5146,No,Yes,7656
Connecticut,2020/12/6,711.7762028,0,0,127715,5146,No,Yes,7656
Connecticut,2020/12/7,711.7762028,8129,78,135844,5224,No,Yes,7656
Connecticut,2020/12/8,711.7762028,2414,18,138258,5242,No,Yes,7656
Connecticut,2020/12/9,711.7762028,2290,43,140548,5285,No,Yes,7568
Connecticut,2020/12/10,711.7762028,2431,42,142979,5327,No,Yes,7568
Connecticut,2020/12/11,711.7762028,3782,36,146761,5363,No,Yes,7568
Connecticut,2020/12/12,711.7762028,0,0,146761,5363,No,Yes,7568
Connecticut,2020/12/13,711.7762028,0,0,146761,5363,No,Yes,7568
Connecticut,2020/12/14,711.7762028,7231,81,153992,5444,No,Yes,7568
Connecticut,2020/12/15,711.7762028,1470,22,155462,5466,No,Yes,7568
Connecticut,2020/12/16,711.7762028,2319,40,157781,5506,No,Yes,7543
Connecticut,2020/12/17,711.7762028,2321,46,160102,5552,No,Yes,7543
Connecticut,2020/12/18,711.7762028,2680,29,162782,5581,No,Yes,7543
Connecticut,2020/12/19,711.7762028,0,0,162782,5581,No,Yes,7543
Connecticut,2020/12/20,711.7762028,0,0,162782,5581,No,Yes,7543
Connecticut,2020/12/21,711.7762028,4595,95,167377,5676,No,Yes,7543
Connecticut,2020/12/22,711.7762028,1583,27,168960,5703,No,Yes,7543
Connecticut,2020/12/23,711.7762028,1745,33,170705,5736,No,Yes,5506
Connecticut,2020/12/24,711.7762028,2038,55,172743,5791,No,Yes,5506
Connecticut,2020/12/25,711.7762028,0,0,172743,5791,No,Yes,5506
Connecticut,2020/12/26,711.7762028,0,0,172743,5791,No,Yes,5506
Connecticut,2020/12/27,711.7762028,0,0,172743,5791,No,Yes,5506
Connecticut,2020/12/28,711.7762028,8457,113,181200,5904,No,Yes,5506
Connecticut,2020/12/29,711.7762028,767,20,181967,5924,No,Yes,5506
Connecticut,2020/12/30,711.7762028,1696,40,183663,5964,No,Yes,10986
Connecticut,2020/12/31,711.7762028,2045,31,185708,5995,No,Yes,10986
Connecticut,2021/1/1,711.7762028,0,0,185708,5995,No,Yes,10986
Connecticut,2021/1/2,711.7762028,4412,104,190120,6099,No,Yes,10986
Connecticut,2021/1/3,711.7762028,0,0,190120,6099,No,Yes,10986
Connecticut,2021/1/4,711.7762028,4516,69,194636,6168,No,Yes,10986
Connecticut,2021/1/5,711.7762028,2332,24,196968,6192,No,Yes,10986
Connecticut,2021/1/6,711.7762028,2486,38,199454,6230,No,Yes,14084
Connecticut,2021/1/7,711.7762028,3304,57,202758,6287,No,Yes,14084
Connecticut,2021/1/8,711.7762028,3236,37,205994,6324,No,Yes,14084
Connecticut,2021/1/9,711.7762028,0,0,205994,6324,No,Yes,14084
Connecticut,2021/1/10,711.7762028,0,0,205994,6324,No,Yes,14084
Connecticut,2021/1/11,711.7762028,7364,92,213358,6416,No,Yes,14084
Connecticut,2021/1/12,711.7762028,3689,33,217047,6449,No,Yes,14084
Connecticut,2021/1/13,711.7762028,3529,87,220576,6536,No,Yes,11980
Connecticut,2021/1/14,711.7762028,968,17,221544,6553,No,Yes,11980
Connecticut,2021/1/15,711.7762028,1878,41,223422,6594,No,Yes,11980
Connecticut,2021/1/16,711.7762028,0,0,223422,6594,No,Yes,11980
Connecticut,2021/1/17,711.7762028,0,0,223422,6594,No,Yes,11980
Connecticut,2021/1/18,711.7762028,6703,76,230125,6670,No,Yes,11980
Connecticut,2021/1/19,711.7762028,2094,12,232219,6682,No,Yes,11980
Connecticut,2021/1/20,711.7762028,1915,44,234134,6726,No,Yes,11615
Connecticut,2021/1/21,711.7762028,1662,48,235796,6774,No,Yes,11615
Connecticut,2021/1/22,711.7762028,2019,45,237815,6819,No,Yes,11615
Connecticut,2021/1/23,711.7762028,0,0,237815,6819,No,Yes,11615
Connecticut,2021/1/24,711.7762028,0,0,237815,6819,No,Yes,11615
Connecticut,2021/1/25,711.7762028,5817,92,243632,6911,No,Yes,11615
Connecticut,2021/1/26,711.7762028,1267,23,244899,6934,No,Yes,11615
Connecticut,2021/1/27,711.7762028,2440,42,247339,6976,No,Yes,12664
Connecticut,2021/1/28,711.7762028,1426,44,248765,7020,No,Yes,12664
Connecticut,2021/1/29,711.7762028,1258,26,250023,7046,No,Yes,12664
Connecticut,2021/1/30,711.7762028,0,0,250023,7046,No,Yes,12664
Connecticut,2021/1/31,711.7762028,0,0,250023,7046,No,Yes,12664
Connecticut,2021/2/1,711.7762028,3931,73,253954,7119,No,Yes,12664
Connecticut,2021/2/2,711.7762028,2568,14,256522,7133,No,Yes,12664
Connecticut,2021/2/3,711.7762028,482,24,257004,7157,No,Yes,13464
Connecticut,2021/2/4,711.7762028,937,28,257941,7185,No,Yes,13464
Connecticut,2021/2/5,711.7762028,1431,29,259372,7214,No,Yes,13464
Connecticut,2021/2/6,711.7762028,0,0,259372,7214,No,Yes,13464
Connecticut,2021/2/7,711.7762028,0,0,259372,7214,No,Yes,13464
Connecticut,2021/2/8,711.7762028,4367,68,263739,7282,No,Yes,13464
Connecticut,2021/2/9,711.7762028,869,16,264608,7298,No,Yes,13464
Connecticut,2021/2/10,711.7762028,888,28,265496,7326,No,Yes,12087
Connecticut,2021/2/11,711.7762028,1003,28,266499,7354,No,Yes,12087
Connecticut,2021/2/12,711.7762028,838,27,267337,7381,No,Yes,12087
Connecticut,2021/2/13,711.7762028,0,0,267337,7381,No,Yes,12087
Connecticut,2021/2/14,711.7762028,0,0,267337,7381,No,Yes,12087
Connecticut,2021/2/15,711.7762028,2905,66,270242,7447,No,Yes,12087
Connecticut,2021/2/16,711.7762028,580,2,270822,7449,No,Yes,12087
Connecticut,2021/2/17,711.7762028,534,27,271356,7476,No,Yes,11395
Connecticut,2021/2/18,711.7762028,547,20,271903,7496,No,Yes,11395
Connecticut,2021/2/19,711.7762028,1198,27,273101,7523,No,Yes,11395
Connecticut,2021/2/20,711.7762028,0,0,273101,7523,No,Yes,11395
Connecticut,2021/2/21,711.7762028,0,0,273101,7523,No,Yes,11395
Connecticut,2021/2/22,711.7762028,2233,39,275334,7562,No,Yes,11395
Connecticut,2021/2/23,711.7762028,1357,10,276691,7572,No,Yes,11395
Connecticut,2021/2/24,711.7762028,1493,23,278184,7595,No,Yes,11395
Connecticut,2021/2/25,711.7762028,975,19,279159,7614,No,Yes,11395
Connecticut,2021/2/26,711.7762028,787,8,279946,7622,No,Yes,11395
Connecticut,2021/2/27,711.7762028,0,0,279946,7622,No,Yes,11395
Connecticut,2021/2/28,711.7762028,0,0,279946,7622,No,Yes,11395
Connecticut,2021/3/1,711.7762028,2680,29,282626,7651,No,Yes,11395
Connecticut,2021/3/2,711.7762028,502,7,283128,7658,No,Yes,11395
Connecticut,2021/3/3,711.7762028,494,20,283622,7678,No,Yes,11395
Connecticut,2021/3/4,711.7762028,878,15,284500,7693,No,Yes,11395
Delaware,2020/3/1,473.3903743,0,0,0,0,No,No,1575
Delaware,2020/3/2,473.3903743,0,0,0,0,No,No,1575
Delaware,2020/3/3,473.3903743,0,0,0,0,No,No,1575
Delaware,2020/3/4,473.3903743,0,0,0,0,No,No,1663
Delaware,2020/3/5,473.3903743,0,0,0,0,No,No,1663
Delaware,2020/3/6,473.3903743,0,0,0,0,No,No,1663
Delaware,2020/3/7,473.3903743,0,0,0,0,No,No,1663
Delaware,2020/3/8,473.3903743,0,0,0,0,No,No,1663
Delaware,2020/3/9,473.3903743,0,0,0,0,No,No,1663
Delaware,2020/3/10,473.3903743,0,0,0,0,No,No,1663
Delaware,2020/3/11,473.3903743,1,0,1,0,No,No,1819
Delaware,2020/3/12,473.3903743,3,0,4,0,No,No,1819
Delaware,2020/3/13,473.3903743,0,0,4,0,No,No,1819
Delaware,2020/3/14,473.3903743,0,0,4,0,No,No,1819
Delaware,2020/3/15,473.3903743,3,0,7,0,No,No,1819
Delaware,2020/3/16,473.3903743,1,0,8,0,No,No,1819
Delaware,2020/3/17,473.3903743,8,0,16,0,No,No,1819
Delaware,2020/3/18,473.3903743,10,0,26,0,No,No,10892
Delaware,2020/3/19,473.3903743,4,0,30,0,No,No,10892
Delaware,2020/3/20,473.3903743,9,0,39,0,No,No,10892
Delaware,2020/3/21,473.3903743,6,0,45,0,No,No,10892
Delaware,2020/3/22,473.3903743,11,0,56,0,No,No,10892
Delaware,2020/3/23,473.3903743,31,0,87,0,No,No,10892
Delaware,2020/3/24,473.3903743,17,0,104,0,Yes,No,10892
Delaware,2020/3/25,473.3903743,15,0,119,0,Yes,No,80984
Delaware,2020/3/26,473.3903743,24,1,143,1,Yes,No,80984
Delaware,2020/3/27,473.3903743,22,1,165,2,Yes,No,80984
Delaware,2020/3/28,473.3903743,49,3,214,5,Yes,No,80984
Delaware,2020/3/29,473.3903743,18,1,232,6,Yes,No,80984
Delaware,2020/3/30,473.3903743,32,1,264,7,Yes,No,80984
Delaware,2020/3/31,473.3903743,55,3,319,10,Yes,No,80984
Delaware,2020/4/1,473.3903743,49,1,368,11,Yes,No,106739
Delaware,2020/4/2,473.3903743,25,1,393,12,Yes,No,106739
Delaware,2020/4/3,473.3903743,57,2,450,14,Yes,No,106739
Delaware,2020/4/4,473.3903743,143,0,593,14,Yes,No,106739
Delaware,2020/4/5,473.3903743,80,0,673,14,Yes,No,106739
Delaware,2020/4/6,473.3903743,110,1,783,15,Yes,No,106739
Delaware,2020/4/7,473.3903743,145,1,928,16,Yes,No,106739
Delaware,2020/4/8,473.3903743,188,3,1116,19,Yes,No,77515
Delaware,2020/4/9,473.3903743,93,4,1209,23,Yes,No,77515
Delaware,2020/4/10,473.3903743,117,9,1326,32,Yes,No,77515
Delaware,2020/4/11,473.3903743,153,1,1479,33,Yes,No,77515
Delaware,2020/4/12,473.3903743,146,2,1625,35,Yes,No,77515
Delaware,2020/4/13,473.3903743,136,6,1761,41,Yes,No,77515
Delaware,2020/4/14,473.3903743,165,2,1926,43,Yes,No,77515
Delaware,2020/4/15,473.3903743,88,3,2014,46,Yes,No,66432
Delaware,2020/4/16,473.3903743,61,6,2075,52,Yes,No,66432
Delaware,2020/4/17,473.3903743,248,9,2323,61,Yes,No,66432
Delaware,2020/4/18,473.3903743,215,6,2538,67,Yes,No,66432
Delaware,2020/4/19,473.3903743,0,0,2538,67,Yes,No,66432
Delaware,2020/4/20,473.3903743,207,5,2745,72,Yes,No,66432
Delaware,2020/4/21,473.3903743,186,10,2931,82,Yes,No,66432
Delaware,2020/4/22,473.3903743,269,7,3200,89,Yes,No,74966
Delaware,2020/4/23,473.3903743,108,3,3308,92,Yes,No,74966
Delaware,2020/4/24,473.3903743,134,8,3442,100,Yes,No,74966
Delaware,2020/4/25,473.3903743,134,12,3576,112,Yes,No,74966
Delaware,2020/4/26,473.3903743,458,8,4034,120,Yes,No,74966
Delaware,2020/4/27,473.3903743,128,5,4162,125,Yes,No,74966
Delaware,2020/4/28,473.3903743,413,12,4575,137,Yes,No,74966
Delaware,2020/4/29,473.3903743,80,7,4655,144,Yes,No,28985
Delaware,2020/4/30,473.3903743,79,8,4734,152,Yes,No,28985
Delaware,2020/5/1,473.3903743,184,7,4918,159,Yes,No,28985
Delaware,2020/5/2,473.3903743,120,9,5038,168,Yes,No,28985
Delaware,2020/5/3,473.3903743,170,9,5208,177,Yes,No,28985
Delaware,2020/5/4,473.3903743,80,5,5288,182,Yes,No,28985
Delaware,2020/5/5,473.3903743,83,5,5371,187,Yes,No,28985
Delaware,2020/5/6,473.3903743,407,6,5778,193,Yes,No,26666
Delaware,2020/5/7,473.3903743,161,9,5939,202,Yes,No,26666
Delaware,2020/5/8,473.3903743,144,11,6083,213,Yes,No,26666
Delaware,2020/5/9,473.3903743,194,8,6277,221,Yes,No,26666
Delaware,2020/5/10,473.3903743,170,3,6447,224,Yes,No,26666
Delaware,2020/5/11,473.3903743,118,1,6565,225,Yes,No,26666
Delaware,2020/5/12,473.3903743,176,12,6741,237,Yes,No,26666
Delaware,2020/5/13,473.3903743,211,10,6952,247,Yes,No,25150
Delaware,2020/5/14,473.3903743,271,13,7223,260,Yes,No,25150
Delaware,2020/5/15,473.3903743,150,11,7373,271,Yes,No,25150
Delaware,2020/5/16,473.3903743,174,15,7547,286,Yes,No,25150
Delaware,2020/5/17,473.3903743,123,4,7670,290,Yes,No,25150
Delaware,2020/5/18,473.3903743,199,7,7869,297,Yes,No,25150
Delaware,2020/5/19,473.3903743,168,7,8037,304,Yes,No,25150
Delaware,2020/5/20,473.3903743,157,6,8194,310,Yes,No,27919
Delaware,2020/5/21,473.3903743,192,7,8386,317,Yes,No,27919
Delaware,2020/5/22,473.3903743,143,5,8529,322,Yes,No,27919
Delaware,2020/5/23,473.3903743,161,2,8690,324,Yes,No,27919
Delaware,2020/5/24,473.3903743,119,2,8809,326,Yes,No,27919
Delaware,2020/5/25,473.3903743,156,6,8965,332,Yes,No,27919
Delaware,2020/5/26,473.3903743,101,3,9066,335,Yes,No,27919
Delaware,2020/5/27,473.3903743,30,9,9096,344,Yes,No,21335
Delaware,2020/5/28,473.3903743,75,1,9171,345,Yes,No,21335
Delaware,2020/5/29,473.3903743,65,11,9236,356,Yes,No,21335
Delaware,2020/5/30,473.3903743,186,5,9422,361,Yes,No,21335
Delaware,2020/5/31,473.3903743,76,5,9498,366,Yes,No,21335
Delaware,2020/6/1,473.3903743,107,2,9605,368,No,No,21335
Delaware,2020/6/2,473.3903743,80,5,9685,373,No,No,21335
Delaware,2020/6/3,473.3903743,27,2,9712,375,No,No,19949
Delaware,2020/6/4,473.3903743,34,11,9746,386,No,No,19949
Delaware,2020/6/5,473.3903743,27,2,9773,388,No,No,19949
Delaware,2020/6/6,473.3903743,72,2,9845,390,No,No,19949
Delaware,2020/6/7,473.3903743,97,8,9942,398,No,No,19949
Delaware,2020/6/8,473.3903743,30,0,9972,398,No,No,19949
Delaware,2020/6/9,473.3903743,48,12,10020,410,No,No,19949
Delaware,2020/6/10,473.3903743,36,3,10056,413,No,No,18367
Delaware,2020/6/11,473.3903743,50,1,10106,414,No,No,18367
Delaware,2020/6/12,473.3903743,67,0,10173,414,No,No,18367
Delaware,2020/6/13,473.3903743,56,5,10229,419,No,No,18367
Delaware,2020/6/14,473.3903743,35,3,10264,422,No,No,18367
Delaware,2020/6/15,473.3903743,76,1,10340,423,No,No,18367
Delaware,2020/6/16,473.3903743,63,1,10403,424,No,No,18367
Delaware,2020/6/17,473.3903743,41,2,10444,426,No,No,18671
Delaware,2020/6/18,473.3903743,55,5,10499,431,No,No,18671
Delaware,2020/6/19,473.3903743,112,2,10611,433,No,No,18671
Delaware,2020/6/20,473.3903743,70,1,10681,434,No,No,18671
Delaware,2020/6/21,473.3903743,94,1,10775,435,No,No,18671
Delaware,2020/6/22,473.3903743,45,0,10820,435,No,No,18671
Delaware,2020/6/23,473.3903743,27,69,10847,504,No,No,18671
Delaware,2020/6/24,473.3903743,42,1,10889,505,No,No,18338
Delaware,2020/6/25,473.3903743,91,2,10980,507,No,No,18338
Delaware,2020/6/26,473.3903743,37,0,11017,507,No,No,18338
Delaware,2020/6/27,473.3903743,74,0,11091,507,No,No,18338
Delaware,2020/6/28,473.3903743,135,0,11226,507,No,No,18338
Delaware,2020/6/29,473.3903743,150,0,11376,507,No,No,18338
Delaware,2020/6/30,473.3903743,98,2,11474,509,No,No,18338
Delaware,2020/7/1,473.3903743,36,0,11510,509,No,No,19056
Delaware,2020/7/2,473.3903743,221,1,11731,510,No,No,19056
Delaware,2020/7/3,473.3903743,192,2,11923,512,No,No,19056
Delaware,2020/7/4,473.3903743,73,0,11996,512,No,No,19056
Delaware,2020/7/5,473.3903743,132,0,12128,512,No,No,19056
Delaware,2020/7/6,473.3903743,165,0,12293,512,No,No,19056
Delaware,2020/7/7,473.3903743,121,2,12414,514,No,No,19056
Delaware,2020/7/8,473.3903743,48,1,12462,515,No,No,20563
Delaware,2020/7/9,473.3903743,69,2,12531,517,No,No,20563
Delaware,2020/7/10,473.3903743,121,0,12652,517,No,No,20563
Delaware,2020/7/11,473.3903743,91,0,12743,517,No,No,20563
Delaware,2020/7/12,473.3903743,61,0,12804,517,No,No,20563
Delaware,2020/7/13,473.3903743,75,0,12879,517,No,No,20563
Delaware,2020/7/14,473.3903743,90,1,12969,518,No,No,20563
Delaware,2020/7/15,473.3903743,81,3,13050,521,No,No,23676
Delaware,2020/7/16,473.3903743,64,0,13114,521,No,No,23676
Delaware,2020/7/17,473.3903743,223,0,13337,521,No,No,23676
Delaware,2020/7/18,473.3903743,92,2,13429,523,No,No,23676
Delaware,2020/7/19,473.3903743,90,0,13519,523,No,No,23676
Delaware,2020/7/20,473.3903743,105,0,13624,523,No,No,23676
Delaware,2020/7/21,473.3903743,122,2,13746,525,No,No,23676
Delaware,2020/7/22,473.3903743,46,2,13792,527,No,No,17437
Delaware,2020/7/23,473.3903743,132,2,13924,529,No,No,17437
Delaware,2020/7/24,473.3903743,278,49,14202,578,No,No,17437
Delaware,2020/7/25,473.3903743,-27,1,14175,579,No,No,17437
Delaware,2020/7/26,473.3903743,115,0,14290,579,No,No,17437
Delaware,2020/7/27,473.3903743,116,0,14406,579,No,No,17437
Delaware,2020/7/28,473.3903743,70,1,14476,580,No,No,17437
Delaware,2020/7/29,473.3903743,126,1,14602,581,No,No,11690
Delaware,2020/7/30,473.3903743,87,0,14689,581,No,No,11690
Delaware,2020/7/31,473.3903743,99,4,14788,585,No,No,11690
Delaware,2020/8/1,473.3903743,89,0,14877,585,No,No,11690
Delaware,2020/8/2,473.3903743,72,0,14949,585,No,No,11690
Delaware,2020/8/3,473.3903743,106,0,15055,585,No,No,11690
Delaware,2020/8/4,473.3903743,82,2,15137,587,No,No,11690
Delaware,2020/8/5,473.3903743,159,0,15296,587,No,No,9467
Delaware,2020/8/6,473.3903743,69,0,15365,587,No,No,9467
Delaware,2020/8/7,473.3903743,80,1,15445,588,No,No,9467
Delaware,2020/8/8,473.3903743,57,2,15502,590,No,No,9467
Delaware,2020/8/9,473.3903743,73,1,15575,591,No,No,9467
Delaware,2020/8/10,473.3903743,59,0,15634,591,No,No,9467
Delaware,2020/8/11,473.3903743,65,0,15699,591,No,No,9467
Delaware,2020/8/12,473.3903743,66,1,15765,592,No,No,11047
Delaware,2020/8/13,473.3903743,202,1,15967,593,No,No,11047
Delaware,2020/8/14,473.3903743,373,0,16340,593,No,No,11047
Delaware,2020/8/15,473.3903743,56,0,16396,593,No,No,11047
Delaware,2020/8/16,473.3903743,55,0,16451,593,No,No,11047
Delaware,2020/8/17,473.3903743,85,0,16536,593,No,No,11047
Delaware,2020/8/18,473.3903743,57,0,16593,593,No,No,11047
Delaware,2020/8/19,473.3903743,50,2,16643,595,No,No,8676
Delaware,2020/8/20,473.3903743,75,0,16718,595,No,No,8676
Delaware,2020/8/21,473.3903743,52,5,16770,600,No,No,8676
Delaware,2020/8/22,473.3903743,58,0,16828,600,No,No,8676
Delaware,2020/8/23,473.3903743,67,0,16895,600,No,No,8676
Delaware,2020/8/24,473.3903743,47,4,16942,604,No,No,8676
Delaware,2020/8/25,473.3903743,20,-1,16962,603,No,No,8676
Delaware,2020/8/26,473.3903743,24,1,16986,604,No,No,8511
Delaware,2020/8/27,473.3903743,-10,0,16976,604,No,No,8511
Delaware,2020/8/28,473.3903743,107,0,17083,604,No,No,8511
Delaware,2020/8/29,473.3903743,266,0,17349,604,No,No,8511
Delaware,2020/8/30,473.3903743,-6,0,17343,604,No,No,8511
Delaware,2020/8/31,473.3903743,86,1,17429,605,No,No,8511
Delaware,2020/9/1,473.3903743,106,0,17535,605,No,No,8511
Delaware,2020/9/2,473.3903743,14,1,17549,606,No,No,8901
Delaware,2020/9/3,473.3903743,104,0,17653,606,No,No,8901
Delaware,2020/9/4,473.3903743,99,0,17752,606,No,No,8901
Delaware,2020/9/5,473.3903743,140,2,17892,608,No,No,8901
Delaware,2020/9/6,473.3903743,151,1,18043,609,No,No,8901
Delaware,2020/9/7,473.3903743,206,0,18249,609,No,No,8901
Delaware,2020/9/8,473.3903743,59,0,18308,609,No,No,8901
Delaware,2020/9/9,473.3903743,0,0,18308,609,No,No,8848
Delaware,2020/9/10,473.3903743,158,4,18466,613,No,No,8848
Delaware,2020/9/11,473.3903743,93,0,18559,613,No,No,8848
Delaware,2020/9/12,473.3903743,167,0,18726,613,No,No,8848
Delaware,2020/9/13,473.3903743,123,2,18849,615,No,No,8848
Delaware,2020/9/14,473.3903743,88,2,18937,617,No,No,8848
Delaware,2020/9/15,473.3903743,200,1,19137,618,No,No,8848
Delaware,2020/9/16,473.3903743,97,1,19234,619,No,No,8679
Delaware,2020/9/17,473.3903743,84,0,19318,619,No,No,8679
Delaware,2020/9/18,473.3903743,48,1,19366,620,No,No,8679
Delaware,2020/9/19,473.3903743,83,1,19449,621,No,No,8679
Delaware,2020/9/20,473.3903743,117,0,19566,621,No,No,8679
Delaware,2020/9/21,473.3903743,101,6,19667,627,No,No,8679
Delaware,2020/9/22,473.3903743,94,1,19761,628,No,No,8679
Delaware,2020/9/23,473.3903743,69,1,19830,629,No,No,8805
Delaware,2020/9/24,473.3903743,117,1,19947,630,No,No,8805
Delaware,2020/9/25,473.3903743,138,1,20085,631,No,No,8805
Delaware,2020/9/26,473.3903743,71,2,20156,633,No,No,8805
Delaware,2020/9/27,473.3903743,104,0,20260,633,No,No,8805
Delaware,2020/9/28,473.3903743,129,1,20389,634,No,No,8805
Delaware,2020/9/29,473.3903743,142,1,20531,635,No,No,8805
Delaware,2020/9/30,473.3903743,82,1,20613,636,No,No,7732
Delaware,2020/10/1,473.3903743,174,0,20787,636,No,No,7732
Delaware,2020/10/2,473.3903743,150,6,20937,642,No,No,7732
Delaware,2020/10/3,473.3903743,188,3,21125,645,No,No,7732
Delaware,2020/10/4,473.3903743,118,0,21243,645,No,No,7732
Delaware,2020/10/5,473.3903743,120,0,21363,645,No,No,7732
Delaware,2020/10/6,473.3903743,103,1,21466,646,No,No,7732
Delaware,2020/10/7,473.3903743,84,3,21550,649,No,No,8581
Delaware,2020/10/8,473.3903743,132,2,21682,651,No,No,8581
Delaware,2020/10/9,473.3903743,145,0,21827,651,No,No,8581
Delaware,2020/10/10,473.3903743,171,2,21998,653,No,No,8581
Delaware,2020/10/11,473.3903743,132,1,22130,654,No,No,8581
Delaware,2020/10/12,473.3903743,159,2,22289,656,No,No,8581
Delaware,2020/10/13,473.3903743,105,3,22394,659,No,No,8581
Delaware,2020/10/14,473.3903743,71,1,22465,660,No,No,7964
Delaware,2020/10/15,473.3903743,95,1,22560,661,No,No,7964
Delaware,2020/10/16,473.3903743,164,1,22724,662,No,No,7964
Delaware,2020/10/17,473.3903743,218,2,22942,664,No,No,7964
Delaware,2020/10/18,473.3903743,151,1,23093,665,No,No,7964
Delaware,2020/10/19,473.3903743,103,1,23196,666,No,No,7964
Delaware,2020/10/20,473.3903743,129,2,23325,668,No,No,7964
Delaware,2020/10/21,473.3903743,50,2,23375,670,No,No,7126
Delaware,2020/10/22,473.3903743,153,0,23528,670,No,No,7126
Delaware,2020/10/23,473.3903743,159,8,23687,678,No,No,7126
Delaware,2020/10/24,473.3903743,160,2,23847,680,No,No,7126
Delaware,2020/10/25,473.3903743,114,1,23961,681,No,No,7126
Delaware,2020/10/26,473.3903743,207,4,24168,685,No,No,7126
Delaware,2020/10/27,473.3903743,81,1,24249,686,No,No,7126
Delaware,2020/10/28,473.3903743,143,2,24392,688,No,No,7060
Delaware,2020/10/29,473.3903743,161,1,24553,689,No,No,7060
Delaware,2020/10/30,473.3903743,198,15,24751,704,No,No,7060
Delaware,2020/10/31,473.3903743,200,4,24951,708,No,No,7060
Delaware,2020/11/1,473.3903743,175,2,25126,710,No,No,7060
Delaware,2020/11/2,473.3903743,185,0,25311,710,No,No,7060
Delaware,2020/11/3,473.3903743,115,2,25426,712,No,No,7060
Delaware,2020/11/4,473.3903743,108,0,25534,712,No,No,8764
Delaware,2020/11/5,473.3903743,219,4,25753,716,No,No,8764
Delaware,2020/11/6,473.3903743,282,0,26035,716,No,No,8764
Delaware,2020/11/7,473.3903743,223,0,26258,716,No,No,8764
Delaware,2020/11/8,473.3903743,345,2,26603,718,No,No,8764
Delaware,2020/11/9,473.3903743,305,1,26908,719,No,No,8764
Delaware,2020/11/10,473.3903743,204,3,27112,722,No,No,8764
Delaware,2020/11/11,473.3903743,230,2,27342,724,No,No,9262
Delaware,2020/11/12,473.3903743,204,8,27546,732,No,No,9262
Delaware,2020/11/13,473.3903743,470,2,28016,734,No,No,9262
Delaware,2020/11/14,473.3903743,379,2,28395,736,No,No,9262
Delaware,2020/11/15,473.3903743,408,0,28803,736,No,No,9262
Delaware,2020/11/16,473.3903743,397,0,29200,736,No,No,9262
Delaware,2020/11/17,473.3903743,352,3,29552,739,No,No,9262
Delaware,2020/11/18,473.3903743,203,3,29755,742,No,No,11813
Delaware,2020/11/19,473.3903743,398,0,30153,742,No,No,11813
Delaware,2020/11/20,473.3903743,663,4,30816,746,No,No,11813
Delaware,2020/11/21,473.3903743,505,0,31321,746,No,No,11813
Delaware,2020/11/22,473.3903743,487,2,31808,748,No,No,11813
Delaware,2020/11/23,473.3903743,403,4,32211,752,No,No,11813
Delaware,2020/11/24,473.3903743,453,5,32664,757,No,No,11813
Delaware,2020/11/25,473.3903743,331,3,32995,760,No,No,7061
Delaware,2020/11/26,473.3903743,584,1,33579,761,No,No,7061
Delaware,2020/11/27,473.3903743,591,2,34170,763,No,No,7061
Delaware,2020/11/28,473.3903743,500,0,34670,763,No,No,7061
Delaware,2020/11/29,473.3903743,581,7,35251,770,No,No,7061
Delaware,2020/11/30,473.3903743,403,2,35654,772,No,No,7061
Delaware,2020/12/1,473.3903743,689,5,36343,777,No,No,7061
Delaware,2020/12/2,473.3903743,355,2,36698,779,No,No,7656
Delaware,2020/12/3,473.3903743,758,0,37456,779,No,No,7656
Delaware,2020/12/4,473.3903743,942,3,38398,782,No,No,7656
Delaware,2020/12/5,473.3903743,698,0,39096,782,No,No,7656
Delaware,2020/12/6,473.3903743,816,11,39912,793,No,No,7656
Delaware,2020/12/7,473.3903743,799,0,40711,793,No,No,7656
Delaware,2020/12/8,473.3903743,753,10,41464,803,No,No,7656
Delaware,2020/12/9,473.3903743,929,0,42393,803,No,No,7568
Delaware,2020/12/10,473.3903743,643,3,43036,806,No,No,7568
Delaware,2020/12/11,473.3903743,782,1,43818,807,No,No,7568
Delaware,2020/12/12,473.3903743,1058,8,44876,815,No,No,7568
Delaware,2020/12/13,473.3903743,584,1,45460,816,No,No,7568
Delaware,2020/12/14,473.3903743,997,0,46457,816,No,No,7568
Delaware,2020/12/15,473.3903743,685,10,47142,826,No,No,7568
Delaware,2020/12/16,473.3903743,787,7,47929,833,No,No,7543
Delaware,2020/12/17,473.3903743,839,12,48768,845,No,No,7543
Delaware,2020/12/18,473.3903743,341,9,49109,854,No,No,7543
Delaware,2020/12/19,473.3903743,1027,4,50136,858,No,No,7543
Delaware,2020/12/20,473.3903743,480,4,50616,862,No,No,7543
Delaware,2020/12/21,473.3903743,440,9,51056,871,No,No,7543
Delaware,2020/12/22,473.3903743,567,1,51623,872,No,No,7543
Delaware,2020/12/23,473.3903743,612,0,52235,872,No,No,5506
Delaware,2020/12/24,473.3903743,780,16,53015,888,No,No,5506
Delaware,2020/12/25,473.3903743,638,3,53653,891,No,No,5506
Delaware,2020/12/26,473.3903743,820,4,54473,895,No,No,5506
Delaware,2020/12/27,473.3903743,584,2,55057,897,No,No,5506
Delaware,2020/12/28,473.3903743,431,1,55488,898,No,No,5506
Delaware,2020/12/29,473.3903743,701,0,56189,898,No,No,5506
Delaware,2020/12/30,473.3903743,407,23,56596,921,No,No,10986
Delaware,2020/12/31,473.3903743,860,5,57456,926,No,No,10986
Delaware,2021/1/1,473.3903743,608,4,58064,930,No,No,10986
Delaware,2021/1/2,473.3903743,809,0,58873,930,No,No,10986
Delaware,2021/1/3,473.3903743,611,0,59484,930,No,No,10986
Delaware,2021/1/4,473.3903743,849,7,60333,937,No,No,10986
Delaware,2021/1/5,473.3903743,767,10,61100,947,No,No,10986
Delaware,2021/1/6,473.3903743,629,0,61729,947,No,No,14084
Delaware,2021/1/7,473.3903743,1220,2,62949,949,No,No,14084
Delaware,2021/1/8,473.3903743,554,8,63503,957,No,No,14084
Delaware,2021/1/9,473.3903743,972,12,64475,969,No,No,14084
Delaware,2021/1/10,473.3903743,798,3,65273,972,No,No,14084
Delaware,2021/1/11,473.3903743,554,14,65827,986,No,No,14084
Delaware,2021/1/12,473.3903743,619,5,66446,991,No,No,14084
Delaware,2021/1/13,473.3903743,727,3,67173,994,No,No,11980
Delaware,2021/1/14,473.3903743,892,1,68065,995,No,No,11980
Delaware,2021/1/15,473.3903743,662,7,68727,1002,No,No,11980
Delaware,2021/1/16,473.3903743,645,14,69372,1016,No,No,11980
Delaware,2021/1/17,473.3903743,922,0,70294,1016,No,No,11980
Delaware,2021/1/18,473.3903743,616,0,70910,1016,No,No,11980
Delaware,2021/1/19,473.3903743,401,5,71311,1021,No,No,11980
Delaware,2021/1/20,473.3903743,464,5,71775,1026,No,No,11615
Delaware,2021/1/21,473.3903743,748,1,72523,1027,No,No,11615
Delaware,2021/1/22,473.3903743,710,0,73233,1027,No,No,11615
Delaware,2021/1/23,473.3903743,682,9,73915,1036,No,No,11615
Delaware,2021/1/24,473.3903743,660,5,74575,1041,No,No,11615
Delaware,2021/1/25,473.3903743,616,8,75191,1049,No,No,11615
Delaware,2021/1/26,473.3903743,299,16,75490,1065,No,No,11615
Delaware,2021/1/27,473.3903743,342,7,75832,1072,No,No,12664
Delaware,2021/1/28,473.3903743,663,3,76495,1075,No,No,12664
Delaware,2021/1/29,473.3903743,440,3,76935,1078,No,No,12664
Delaware,2021/1/30,473.3903743,616,3,77551,1081,No,No,12664
Delaware,2021/1/31,473.3903743,520,9,78071,1090,No,No,12664
Delaware,2021/2/1,473.3903743,424,11,78495,1101,No,No,12664
Delaware,2021/2/2,473.3903743,201,7,78696,1108,No,No,12664
Delaware,2021/2/3,473.3903743,286,22,78982,1130,No,No,13464
Delaware,2021/2/4,473.3903743,243,5,79225,1135,No,No,13464
Delaware,2021/2/5,473.3903743,321,56,79546,1191,No,No,13464
Delaware,2021/2/6,473.3903743,286,11,79832,1202,No,No,13464
Delaware,2021/2/7,473.3903743,762,6,80594,1208,No,No,13464
Delaware,2021/2/8,473.3903743,337,0,80931,1208,No,No,13464
Delaware,2021/2/9,473.3903743,279,13,81210,1221,No,No,13464
Delaware,2021/2/10,473.3903743,251,24,81461,1245,No,No,12087
Delaware,2021/2/11,473.3903743,414,17,81875,1262,No,No,12087
Delaware,2021/2/12,473.3903743,388,7,82263,1269,No,No,12087
Delaware,2021/2/13,473.3903743,409,13,82672,1282,No,No,12087
Delaware,2021/2/14,473.3903743,331,1,83003,1283,No,No,12087
Delaware,2021/2/15,473.3903743,236,0,83239,1283,No,No,12087
Delaware,2021/2/16,473.3903743,130,8,83369,1291,No,No,12087
Delaware,2021/2/17,473.3903743,212,25,83581,1316,No,No,11395
Delaware,2021/2/18,473.3903743,271,10,83852,1326,No,No,11395
Delaware,2021/2/19,473.3903743,329,17,84181,1343,No,No,11395
Delaware,2021/2/20,473.3903743,350,23,84531,1366,No,No,11395
Delaware,2021/2/21,473.3903743,201,1,84732,1367,No,No,11395
Delaware,2021/2/22,473.3903743,358,1,85090,1368,No,No,11395
Delaware,2021/2/23,473.3903743,138,11,85228,1379,No,No,11395
Delaware,2021/2/24,473.3903743,278,23,85506,1402,No,No,11395
Delaware,2021/2/25,473.3903743,295,4,85801,1406,No,No,11395
Delaware,2021/2/26,473.3903743,297,12,86098,1418,No,No,11395
Delaware,2021/2/27,473.3903743,419,0,86517,1418,No,No,11395
Delaware,2021/2/28,473.3903743,282,4,86799,1422,No,No,11395
Delaware,2021/3/1,473.3903743,281,0,87080,1422,No,No,11395
Delaware,2021/3/2,473.3903743,113,4,87193,1426,No,No,11395
Delaware,2021/3/3,473.3903743,232,14,87425,1440,No,No,11395
Delaware,2021/3/4,473.3903743,218,4,87643,1444,No,No,11395
"Washington, D.C.",2020/3/1,4466.765823,0,0,0,0,No,No,1575
"Washington, D.C.",2020/3/2,4466.765823,0,0,0,0,No,No,1575
"Washington, D.C.",2020/3/3,4466.765823,0,0,0,0,No,No,1575
"Washington, D.C.",2020/3/4,4466.765823,0,0,0,0,No,No,1663
"Washington, D.C.",2020/3/5,4466.765823,0,0,0,0,No,No,1663
"Washington, D.C.",2020/3/6,4466.765823,0,0,0,0,No,No,1663
"Washington, D.C.",2020/3/7,4466.765823,1,0,1,0,No,No,1663
"Washington, D.C.",2020/3/8,4466.765823,0,0,1,0,No,No,1663
"Washington, D.C.",2020/3/9,4466.765823,3,0,4,0,No,No,1663
"Washington, D.C.",2020/3/10,4466.765823,0,0,4,0,No,No,1663
"Washington, D.C.",2020/3/11,4466.765823,6,0,10,0,No,No,1819
"Washington, D.C.",2020/3/12,4466.765823,0,0,10,0,No,No,1819
"Washington, D.C.",2020/3/13,4466.765823,0,0,10,0,No,No,1819
"Washington, D.C.",2020/3/14,4466.765823,6,0,16,0,No,No,1819
"Washington, D.C.",2020/3/15,4466.765823,1,0,17,0,No,No,1819
"Washington, D.C.",2020/3/16,4466.765823,5,0,22,0,No,No,1819
"Washington, D.C.",2020/3/17,4466.765823,9,0,31,0,No,No,1819
"Washington, D.C.",2020/3/18,4466.765823,5,0,36,0,No,No,10892
"Washington, D.C.",2020/3/19,4466.765823,3,0,39,0,No,No,10892
"Washington, D.C.",2020/3/20,4466.765823,32,0,71,0,No,No,10892
"Washington, D.C.",2020/3/21,4466.765823,6,1,77,1,No,No,10892
"Washington, D.C.",2020/3/22,4466.765823,21,0,98,1,No,No,10892
"Washington, D.C.",2020/3/23,4466.765823,18,1,116,2,No,No,10892
"Washington, D.C.",2020/3/24,4466.765823,21,0,137,2,No,No,10892
"Washington, D.C.",2020/3/25,4466.765823,46,0,183,2,No,No,80984
"Washington, D.C.",2020/3/26,4466.765823,48,1,231,3,No,No,80984
"Washington, D.C.",2020/3/27,4466.765823,36,0,267,3,No,No,80984
"Washington, D.C.",2020/3/28,4466.765823,37,1,304,4,No,No,80984
"Washington, D.C.",2020/3/29,4466.765823,38,1,342,5,No,No,80984
"Washington, D.C.",2020/3/30,4466.765823,59,4,401,9,No,No,80984
"Washington, D.C.",2020/3/31,4466.765823,94,0,495,9,No,No,80984
"Washington, D.C.",2020/4/1,4466.765823,91,2,586,11,Yes,No,106739
"Washington, D.C.",2020/4/2,4466.765823,67,1,653,12,Yes,No,106739
"Washington, D.C.",2020/4/3,4466.765823,104,3,757,15,Yes,No,106739
"Washington, D.C.",2020/4/4,4466.765823,145,6,902,21,Yes,No,106739
"Washington, D.C.",2020/4/5,4466.765823,96,1,998,22,Yes,No,106739
"Washington, D.C.",2020/4/6,4466.765823,99,2,1097,24,Yes,No,106739
"Washington, D.C.",2020/4/7,4466.765823,114,0,1211,24,Yes,No,106739
"Washington, D.C.",2020/4/8,4466.765823,229,3,1440,27,Yes,No,77515
"Washington, D.C.",2020/4/9,4466.765823,83,5,1523,32,Yes,No,77515
"Washington, D.C.",2020/4/10,4466.765823,137,6,1660,38,Yes,No,77515
"Washington, D.C.",2020/4/11,4466.765823,118,9,1778,47,Yes,No,77515
"Washington, D.C.",2020/4/12,4466.765823,97,3,1875,50,Yes,No,77515
"Washington, D.C.",2020/4/13,4466.765823,80,2,1955,52,Yes,No,77515
"Washington, D.C.",2020/4/14,4466.765823,103,15,2058,67,Yes,No,77515
"Washington, D.C.",2020/4/15,4466.765823,139,5,2197,72,Yes,No,66432
"Washington, D.C.",2020/4/16,4466.765823,153,9,2350,81,Yes,No,66432
"Washington, D.C.",2020/4/17,4466.765823,126,5,2476,86,Yes,No,66432
"Washington, D.C.",2020/4/18,4466.765823,190,5,2666,91,Yes,No,66432
"Washington, D.C.",2020/4/19,4466.765823,127,5,2793,96,Yes,No,66432
"Washington, D.C.",2020/4/20,4466.765823,134,9,2927,105,Yes,No,66432
"Washington, D.C.",2020/4/21,4466.765823,171,7,3098,112,Yes,No,66432
"Washington, D.C.",2020/4/22,4466.765823,108,15,3206,127,Yes,No,74966
"Washington, D.C.",2020/4/23,4466.765823,155,12,3361,139,Yes,No,74966
"Washington, D.C.",2020/4/24,4466.765823,167,14,3528,153,Yes,No,74966
"Washington, D.C.",2020/4/25,4466.765823,171,12,3699,165,Yes,No,74966
"Washington, D.C.",2020/4/26,4466.765823,142,13,3841,178,Yes,No,74966
"Washington, D.C.",2020/4/27,4466.765823,51,7,3892,185,Yes,No,74966
"Washington, D.C.",2020/4/28,4466.765823,102,5,3994,190,Yes,No,74966
"Washington, D.C.",2020/4/29,4466.765823,112,15,4106,205,Yes,No,28985
"Washington, D.C.",2020/4/30,4466.765823,217,19,4323,224,Yes,No,28985
"Washington, D.C.",2020/5/1,4466.765823,335,7,4658,231,Yes,No,28985
"Washington, D.C.",2020/5/2,4466.765823,139,9,4797,240,Yes,No,28985
"Washington, D.C.",2020/5/3,4466.765823,219,11,5016,251,Yes,No,28985
"Washington, D.C.",2020/5/4,4466.765823,154,7,5170,258,Yes,No,28985
"Washington, D.C.",2020/5/5,4466.765823,152,6,5322,264,Yes,No,28985
"Washington, D.C.",2020/5/6,4466.765823,139,13,5461,277,Yes,No,26666
"Washington, D.C.",2020/5/7,4466.765823,193,8,5654,285,Yes,No,26666
"Washington, D.C.",2020/5/8,4466.765823,245,19,5899,304,Yes,No,26666
"Washington, D.C.",2020/5/9,4466.765823,203,7,6102,311,Yes,No,26666
"Washington, D.C.",2020/5/10,4466.765823,170,12,6272,323,Yes,No,26666
"Washington, D.C.",2020/5/11,4466.765823,117,5,6389,328,Yes,No,26666
"Washington, D.C.",2020/5/12,4466.765823,96,8,6485,336,Yes,No,26666
"Washington, D.C.",2020/5/13,4466.765823,99,14,6584,350,Yes,No,25150
"Washington, D.C.",2020/5/14,4466.765823,152,8,6736,358,Yes,No,25150
"Washington, D.C.",2020/5/15,4466.765823,135,10,6871,368,Yes,No,25150
"Washington, D.C.",2020/5/16,4466.765823,171,7,7042,375,Yes,No,25150
"Washington, D.C.",2020/5/17,4466.765823,81,8,7123,383,Yes,No,25150
"Washington, D.C.",2020/5/18,4466.765823,147,9,7270,392,Yes,No,25150
"Washington, D.C.",2020/5/19,4466.765823,164,8,7434,400,Yes,No,25150
"Washington, D.C.",2020/5/20,4466.765823,117,7,7551,407,Yes,No,27919
"Washington, D.C.",2020/5/21,4466.765823,237,5,7788,412,Yes,No,27919
"Washington, D.C.",2020/5/22,4466.765823,105,6,7893,418,Yes,No,27919
"Washington, D.C.",2020/5/23,4466.765823,73,9,7966,427,Yes,No,27919
"Washington, D.C.",2020/5/24,4466.765823,144,5,8110,432,Yes,No,27919
"Washington, D.C.",2020/5/25,4466.765823,115,8,8225,440,Yes,No,27919
"Washington, D.C.",2020/5/26,4466.765823,109,0,8334,440,Yes,No,27919
"Washington, D.C.",2020/5/27,4466.765823,72,5,8406,445,Yes,No,21335
"Washington, D.C.",2020/5/28,4466.765823,86,8,8492,453,Yes,No,21335
"Washington, D.C.",2020/5/29,4466.765823,46,7,8538,460,Yes,No,21335
"Washington, D.C.",2020/5/30,4466.765823,179,2,8717,462,Yes,No,21335
"Washington, D.C.",2020/5/31,4466.765823,84,4,8801,466,Yes,No,21335
"Washington, D.C.",2020/6/1,4466.765823,56,2,8857,468,Yes,No,21335
"Washington, D.C.",2020/6/2,4466.765823,29,2,8886,470,Yes,No,21335
"Washington, D.C.",2020/6/3,4466.765823,130,3,9016,473,Yes,No,19949
"Washington, D.C.",2020/6/4,4466.765823,104,2,9120,475,Yes,No,19949
"Washington, D.C.",2020/6/5,4466.765823,79,4,9199,479,Yes,No,19949
"Washington, D.C.",2020/6/6,4466.765823,70,4,9269,483,Yes,No,19949
"Washington, D.C.",2020/6/7,4466.765823,63,6,9332,489,Yes,No,19949
"Washington, D.C.",2020/6/8,4466.765823,57,2,9389,491,Yes,No,19949
"Washington, D.C.",2020/6/9,4466.765823,85,4,9474,495,No,No,19949
"Washington, D.C.",2020/6/10,4466.765823,63,4,9537,499,No,No,18367
"Washington, D.C.",2020/6/11,4466.765823,52,3,9589,502,No,No,18367
"Washington, D.C.",2020/6/12,4466.765823,65,4,9654,506,No,No,18367
"Washington, D.C.",2020/6/13,4466.765823,55,5,9709,511,No,No,18367
"Washington, D.C.",2020/6/14,4466.765823,58,4,9767,515,No,No,18367
"Washington, D.C.",2020/6/15,4466.765823,32,0,9799,515,No,No,18367
"Washington, D.C.",2020/6/16,4466.765823,19,5,9818,520,No,No,18367
"Washington, D.C.",2020/6/17,4466.765823,29,3,9847,523,No,No,18671
"Washington, D.C.",2020/6/18,4466.765823,56,4,9903,527,No,No,18671
"Washington, D.C.",2020/6/19,4466.765823,49,3,9952,530,No,No,18671
"Washington, D.C.",2020/6/20,4466.765823,32,1,9984,531,No,No,18671
"Washington, D.C.",2020/6/21,4466.765823,36,2,10020,533,No,No,18671
"Washington, D.C.",2020/6/22,4466.765823,38,2,10058,535,No,Yes,18671
"Washington, D.C.",2020/6/23,4466.765823,36,2,10094,537,No,Yes,18671
"Washington, D.C.",2020/6/24,4466.765823,34,4,10128,541,No,Yes,18338
"Washington, D.C.",2020/6/25,4466.765823,31,2,10159,543,No,Yes,18338
"Washington, D.C.",2020/6/26,4466.765823,26,3,10185,546,No,Yes,18338
"Washington, D.C.",2020/6/27,4466.765823,31,2,10216,548,No,Yes,18338
"Washington, D.C.",2020/6/28,4466.765823,32,2,10248,550,No,Yes,18338
"Washington, D.C.",2020/6/29,4466.765823,44,1,10292,551,No,Yes,18338
"Washington, D.C.",2020/6/30,4466.765823,35,0,10327,551,No,Yes,18338
"Washington, D.C.",2020/7/1,4466.765823,38,2,10365,553,No,Yes,19056
"Washington, D.C.",2020/7/2,4466.765823,25,1,10390,554,No,Yes,19056
"Washington, D.C.",2020/7/3,4466.765823,45,1,10435,555,No,Yes,19056
"Washington, D.C.",2020/7/4,4466.765823,12,2,10447,557,No,Yes,19056
"Washington, D.C.",2020/7/5,4466.765823,35,2,10482,559,No,Yes,19056
"Washington, D.C.",2020/7/6,4466.765823,33,2,10515,561,No,Yes,19056
"Washington, D.C.",2020/7/7,4466.765823,54,0,10569,561,No,Yes,19056
"Washington, D.C.",2020/7/8,4466.765823,73,3,10642,564,No,Yes,20563
"Washington, D.C.",2020/7/9,4466.765823,37,4,10679,568,No,Yes,20563
"Washington, D.C.",2020/7/10,4466.765823,64,0,10743,568,No,Yes,20563
"Washington, D.C.",2020/7/11,4466.765823,58,0,10801,568,No,Yes,20563
"Washington, D.C.",2020/7/12,4466.765823,46,0,10847,568,No,Yes,20563
"Washington, D.C.",2020/7/13,4466.765823,59,0,10906,568,No,Yes,20563
"Washington, D.C.",2020/7/14,4466.765823,40,0,10946,568,No,Yes,20563
"Washington, D.C.",2020/7/15,4466.765823,80,3,11026,571,No,Yes,23676
"Washington, D.C.",2020/7/16,4466.765823,50,3,11076,574,No,Yes,23676
"Washington, D.C.",2020/7/17,4466.765823,39,3,11115,577,No,Yes,23676
"Washington, D.C.",2020/7/18,4466.765823,79,1,11194,578,No,Yes,23676
"Washington, D.C.",2020/7/19,4466.765823,67,0,11261,578,No,Yes,23676
"Washington, D.C.",2020/7/20,4466.765823,78,1,11339,579,No,Yes,23676
"Washington, D.C.",2020/7/21,4466.765823,88,1,11427,580,No,Yes,23676
"Washington, D.C.",2020/7/22,4466.765823,102,0,11529,580,No,Yes,17437
"Washington, D.C.",2020/7/23,4466.765823,42,1,11571,581,No,Yes,17437
"Washington, D.C.",2020/7/24,4466.765823,78,0,11649,581,No,Yes,17437
"Washington, D.C.",2020/7/25,4466.765823,68,0,11717,581,No,Yes,17437
"Washington, D.C.",2020/7/26,4466.765823,63,0,11780,581,No,Yes,17437
"Washington, D.C.",2020/7/27,4466.765823,78,1,11858,582,No,Yes,17437
"Washington, D.C.",2020/7/28,4466.765823,87,1,11945,583,No,Yes,17437
"Washington, D.C.",2020/7/29,4466.765823,54,1,11999,584,No,Yes,11690
"Washington, D.C.",2020/7/30,4466.765823,58,0,12057,584,No,Yes,11690
"Washington, D.C.",2020/7/31,4466.765823,69,1,12126,585,No,Yes,11690
"Washington, D.C.",2020/8/1,4466.765823,79,0,12205,585,No,Yes,11690
"Washington, D.C.",2020/8/2,4466.765823,69,1,12274,586,No,Yes,11690
"Washington, D.C.",2020/8/3,4466.765823,39,0,12313,586,No,Yes,11690
"Washington, D.C.",2020/8/4,4466.765823,85,1,12398,587,No,Yes,11690
"Washington, D.C.",2020/8/5,4466.765823,45,0,12443,587,No,Yes,9467
"Washington, D.C.",2020/8/6,4466.765823,75,0,12518,587,No,Yes,9467
"Washington, D.C.",2020/8/7,4466.765823,71,2,12589,589,No,Yes,9467
"Washington, D.C.",2020/8/8,4466.765823,64,1,12653,590,No,Yes,9467
"Washington, D.C.",2020/8/9,4466.765823,100,1,12753,591,No,Yes,9467
"Washington, D.C.",2020/8/10,4466.765823,54,0,12807,591,No,Yes,9467
"Washington, D.C.",2020/8/11,4466.765823,89,2,12896,593,No,Yes,9467
"Washington, D.C.",2020/8/12,4466.765823,63,0,12959,593,No,Yes,11047
"Washington, D.C.",2020/8/13,4466.765823,65,1,13024,594,No,Yes,11047
"Washington, D.C.",2020/8/14,4466.765823,94,0,13118,594,No,Yes,11047
"Washington, D.C.",2020/8/15,4466.765823,41,3,13159,597,No,Yes,11047
"Washington, D.C.",2020/8/16,4466.765823,61,0,13220,597,No,Yes,11047
"Washington, D.C.",2020/8/17,4466.765823,53,0,13273,597,No,Yes,11047
"Washington, D.C.",2020/8/18,4466.765823,52,2,13325,599,No,Yes,11047
"Washington, D.C.",2020/8/19,4466.765823,29,1,13354,600,No,Yes,8676
"Washington, D.C.",2020/8/20,4466.765823,55,1,13409,601,No,Yes,8676
"Washington, D.C.",2020/8/21,4466.765823,60,1,13469,602,No,Yes,8676
"Washington, D.C.",2020/8/22,4466.765823,65,2,13534,604,No,Yes,8676
"Washington, D.C.",2020/8/23,4466.765823,56,0,13590,604,No,Yes,8676
"Washington, D.C.",2020/8/24,4466.765823,49,0,13639,604,No,Yes,8676
"Washington, D.C.",2020/8/25,4466.765823,45,0,13684,604,No,Yes,8676
"Washington, D.C.",2020/8/26,4466.765823,38,1,13722,605,No,Yes,8511
"Washington, D.C.",2020/8/27,4466.765823,72,0,13794,605,No,Yes,8511
"Washington, D.C.",2020/8/28,4466.765823,57,0,13851,605,No,Yes,8511
"Washington, D.C.",2020/8/29,4466.765823,74,0,13925,605,No,Yes,8511
"Washington, D.C.",2020/8/30,4466.765823,34,1,13959,606,No,Yes,8511
"Washington, D.C.",2020/8/31,4466.765823,33,1,13992,607,No,Yes,8511
"Washington, D.C.",2020/9/1,4466.765823,57,0,14049,607,No,Yes,8511
"Washington, D.C.",2020/9/2,4466.765823,28,1,14077,608,No,Yes,8901
"Washington, D.C.",2020/9/3,4466.765823,58,1,14135,609,No,Yes,8901
"Washington, D.C.",2020/9/4,4466.765823,51,2,14186,611,No,Yes,8901
"Washington, D.C.",2020/9/5,4466.765823,52,0,14238,611,No,Yes,8901
"Washington, D.C.",2020/9/6,4466.765823,41,0,14279,611,No,Yes,8901
"Washington, D.C.",2020/9/7,4466.765823,36,0,14315,611,No,Yes,8901
"Washington, D.C.",2020/9/8,4466.765823,47,0,14362,611,No,Yes,8901
"Washington, D.C.",2020/9/9,4466.765823,25,4,14387,615,No,Yes,8848
"Washington, D.C.",2020/9/10,4466.765823,25,1,14412,616,No,Yes,8848
"Washington, D.C.",2020/9/11,4466.765823,81,0,14493,616,No,Yes,8848
"Washington, D.C.",2020/9/12,4466.765823,59,0,14552,616,No,Yes,8848
"Washington, D.C.",2020/9/13,4466.765823,40,0,14592,616,No,Yes,8848
"Washington, D.C.",2020/9/14,4466.765823,30,0,14622,616,No,Yes,8848
"Washington, D.C.",2020/9/15,4466.765823,65,0,14687,616,No,Yes,8848
"Washington, D.C.",2020/9/16,4466.765823,56,1,14743,617,No,Yes,8679
"Washington, D.C.",2020/9/17,4466.765823,47,2,14790,619,No,Yes,8679
"Washington, D.C.",2020/9/18,4466.765823,62,0,14852,619,No,Yes,8679
"Washington, D.C.",2020/9/19,4466.765823,50,0,14902,619,No,Yes,8679
"Washington, D.C.",2020/9/20,4466.765823,53,1,14955,620,No,Yes,8679
"Washington, D.C.",2020/9/21,4466.765823,23,1,14978,621,No,Yes,8679
"Washington, D.C.",2020/9/22,4466.765823,43,0,15021,621,No,Yes,8679
"Washington, D.C.",2020/9/23,4466.765823,29,0,15050,621,No,Yes,8805
"Washington, D.C.",2020/9/24,4466.765823,56,0,15106,621,No,Yes,8805
"Washington, D.C.",2020/9/25,4466.765823,57,2,15163,623,No,Yes,8805
"Washington, D.C.",2020/9/26,4466.765823,52,1,15215,624,No,Yes,8805
"Washington, D.C.",2020/9/27,4466.765823,35,0,15250,624,No,Yes,8805
"Washington, D.C.",2020/9/28,4466.765823,14,0,15264,624,No,Yes,8805
"Washington, D.C.",2020/9/29,4466.765823,36,2,15300,626,No,Yes,8805
"Washington, D.C.",2020/9/30,4466.765823,26,1,15326,627,No,Yes,7732
"Washington, D.C.",2020/10/1,4466.765823,32,1,15358,628,No,Yes,7732
"Washington, D.C.",2020/10/2,4466.765823,65,1,15423,629,No,Yes,7732
"Washington, D.C.",2020/10/3,4466.765823,50,0,15473,629,No,Yes,7732
"Washington, D.C.",2020/10/4,4466.765823,46,2,15519,631,No,Yes,7732
"Washington, D.C.",2020/10/5,4466.765823,28,0,15547,631,No,Yes,7732
"Washington, D.C.",2020/10/6,4466.765823,105,0,15652,631,No,Yes,7732
"Washington, D.C.",2020/10/7,4466.765823,45,1,15697,632,No,Yes,8581
"Washington, D.C.",2020/10/8,4466.765823,68,2,15765,634,No,Yes,8581
"Washington, D.C.",2020/10/9,4466.765823,78,0,15843,634,No,Yes,8581
"Washington, D.C.",2020/10/10,4466.765823,75,2,15918,636,No,Yes,8581
"Washington, D.C.",2020/10/11,4466.765823,66,1,15984,637,No,Yes,8581
"Washington, D.C.",2020/10/12,4466.765823,38,0,16022,637,No,Yes,8581
"Washington, D.C.",2020/10/13,4466.765823,46,0,16068,637,No,Yes,8581
"Washington, D.C.",2020/10/14,4466.765823,64,1,16132,638,No,Yes,7964
"Washington, D.C.",2020/10/15,4466.765823,34,0,16166,638,No,Yes,7964
"Washington, D.C.",2020/10/16,4466.765823,89,3,16255,641,No,Yes,7964
"Washington, D.C.",2020/10/17,4466.765823,79,0,16334,641,No,Yes,7964
"Washington, D.C.",2020/10/18,4466.765823,36,0,16370,641,No,Yes,7964
"Washington, D.C.",2020/10/19,4466.765823,25,0,16395,641,No,Yes,7964
"Washington, D.C.",2020/10/20,4466.765823,50,1,16445,642,No,Yes,7964
"Washington, D.C.",2020/10/21,4466.765823,53,0,16498,642,No,Yes,7126
"Washington, D.C.",2020/10/22,4466.765823,39,0,16537,642,No,Yes,7126
"Washington, D.C.",2020/10/23,4466.765823,72,0,16609,642,No,Yes,7126
"Washington, D.C.",2020/10/24,4466.765823,97,0,16706,642,No,Yes,7126
"Washington, D.C.",2020/10/25,4466.765823,61,0,16767,642,No,Yes,7126
"Washington, D.C.",2020/10/26,4466.765823,45,0,16812,642,No,Yes,7126
"Washington, D.C.",2020/10/27,4466.765823,94,2,16906,644,No,Yes,7126
"Washington, D.C.",2020/10/28,4466.765823,67,0,16973,644,No,Yes,7060
"Washington, D.C.",2020/10/29,4466.765823,101,1,17074,645,No,Yes,7060
"Washington, D.C.",2020/10/30,4466.765823,70,1,17144,646,No,Yes,7060
"Washington, D.C.",2020/10/31,4466.765823,122,0,17266,646,No,Yes,7060
"Washington, D.C.",2020/11/1,4466.765823,103,0,17369,646,No,Yes,7060
"Washington, D.C.",2020/11/2,4466.765823,69,1,17438,647,No,Yes,7060
"Washington, D.C.",2020/11/3,4466.765823,86,0,17524,647,No,Yes,7060
"Washington, D.C.",2020/11/4,4466.765823,77,0,17601,647,No,Yes,8764
"Washington, D.C.",2020/11/5,4466.765823,81,3,17682,650,No,Yes,8764
"Washington, D.C.",2020/11/6,4466.765823,110,2,17792,652,No,Yes,8764
"Washington, D.C.",2020/11/7,4466.765823,99,2,17891,654,No,Yes,8764
"Washington, D.C.",2020/11/8,4466.765823,110,0,18001,654,No,Yes,8764
"Washington, D.C.",2020/11/9,4466.765823,86,1,18087,655,No,Yes,8764
"Washington, D.C.",2020/11/10,4466.765823,86,2,18173,657,No,Yes,8764
"Washington, D.C.",2020/11/11,4466.765823,206,0,18379,657,No,Yes,9262
"Washington, D.C.",2020/11/12,4466.765823,128,0,18507,657,No,Yes,9262
"Washington, D.C.",2020/11/13,4466.765823,159,0,18666,657,No,Yes,9262
"Washington, D.C.",2020/11/14,4466.765823,148,1,18814,658,No,Yes,9262
"Washington, D.C.",2020/11/15,4466.765823,163,2,18977,660,No,Yes,9262
"Washington, D.C.",2020/11/16,4466.765823,87,0,19064,660,No,Yes,9262
"Washington, D.C.",2020/11/17,4466.765823,245,0,19309,660,No,Yes,9262
"Washington, D.C.",2020/11/18,4466.765823,156,5,19465,665,No,Yes,11813
"Washington, D.C.",2020/11/19,4466.765823,213,2,19678,667,No,Yes,11813
"Washington, D.C.",2020/11/20,4466.765823,130,2,19808,669,No,Yes,11813
"Washington, D.C.",2020/11/21,4466.765823,153,1,19961,670,No,Yes,11813
"Washington, D.C.",2020/11/22,4466.765823,190,0,20151,670,No,Yes,11813
"Washington, D.C.",2020/11/23,4466.765823,139,2,20290,672,No,Yes,11813
"Washington, D.C.",2020/11/24,4466.765823,119,1,20409,673,No,Yes,11813
"Washington, D.C.",2020/11/25,4466.765823,107,4,20516,677,No,Yes,7061
"Washington, D.C.",2020/11/26,4466.765823,220,0,20736,677,No,Yes,7061
"Washington, D.C.",2020/11/27,4466.765823,201,0,20937,677,No,Yes,7061
"Washington, D.C.",2020/11/28,4466.765823,371,1,21308,678,No,Yes,7061
"Washington, D.C.",2020/11/29,4466.765823,140,2,21448,680,No,Yes,7061
"Washington, D.C.",2020/11/30,4466.765823,104,0,21552,680,No,Yes,7061
"Washington, D.C.",2020/12/1,4466.765823,133,5,21685,685,No,Yes,7061
"Washington, D.C.",2020/12/2,4466.765823,157,5,21842,690,No,Yes,7656
"Washington, D.C.",2020/12/3,4466.765823,322,2,22164,692,No,Yes,7656
"Washington, D.C.",2020/12/4,4466.765823,316,1,22480,693,No,Yes,7656
"Washington, D.C.",2020/12/5,4466.765823,392,2,22872,695,No,Yes,7656
"Washington, D.C.",2020/12/6,4466.765823,264,2,23136,697,No,Yes,7656
"Washington, D.C.",2020/12/7,4466.765823,183,4,23319,701,No,Yes,7656
"Washington, D.C.",2020/12/8,4466.765823,270,0,23589,701,No,Yes,7656
"Washington, D.C.",2020/12/9,4466.765823,265,3,23854,704,No,Yes,7568
"Washington, D.C.",2020/12/10,4466.765823,244,4,24098,708,No,Yes,7568
"Washington, D.C.",2020/12/11,4466.765823,259,1,24357,709,No,Yes,7568
"Washington, D.C.",2020/12/12,4466.765823,286,4,24643,713,No,Yes,7568
"Washington, D.C.",2020/12/13,4466.765823,231,2,24874,715,No,Yes,7568
"Washington, D.C.",2020/12/14,4466.765823,164,1,25038,716,No,Yes,7568
"Washington, D.C.",2020/12/15,4466.765823,301,4,25339,720,No,Yes,7568
"Washington, D.C.",2020/12/16,4466.765823,263,0,25602,720,No,Yes,7543
"Washington, D.C.",2020/12/17,4466.765823,228,5,25830,725,No,Yes,7543
"Washington, D.C.",2020/12/18,4466.765823,274,3,26104,728,No,Yes,7543
"Washington, D.C.",2020/12/19,4466.765823,238,2,26342,730,No,Yes,7543
"Washington, D.C.",2020/12/20,4466.765823,259,7,26601,737,No,Yes,7543
"Washington, D.C.",2020/12/21,4466.765823,139,5,26740,742,No,Yes,7543
"Washington, D.C.",2020/12/22,4466.765823,160,2,26900,744,No,Yes,7543
"Washington, D.C.",2020/12/23,4466.765823,326,7,27226,751,No,Yes,5506
"Washington, D.C.",2020/12/24,4466.765823,210,5,27436,756,No,Yes,5506
"Washington, D.C.",2020/12/25,4466.765823,0,0,27436,756,No,Yes,5506
"Washington, D.C.",2020/12/26,4466.765823,274,6,27710,762,No,Yes,5506
"Washington, D.C.",2020/12/27,4466.765823,492,6,28202,768,No,Yes,5506
"Washington, D.C.",2020/12/28,4466.765823,140,3,28342,771,No,Yes,5506
"Washington, D.C.",2020/12/29,4466.765823,193,4,28535,775,No,Yes,5506
"Washington, D.C.",2020/12/30,4466.765823,223,5,28758,780,No,Yes,10986
"Washington, D.C.",2020/12/31,4466.765823,225,6,28983,786,No,Yes,10986
"Washington, D.C.",2021/1/1,4466.765823,269,2,29252,788,No,Yes,10986
"Washington, D.C.",2021/1/2,4466.765823,257,4,29509,792,No,Yes,10986
"Washington, D.C.",2021/1/3,4466.765823,255,2,29764,794,No,Yes,10986
"Washington, D.C.",2021/1/4,4466.765823,140,3,29904,797,No,Yes,10986
"Washington, D.C.",2021/1/5,4466.765823,262,4,30166,801,No,Yes,10986
"Washington, D.C.",2021/1/6,4466.765823,316,5,30482,806,No,Yes,14084
"Washington, D.C.",2021/1/7,4466.765823,268,2,30750,808,No,Yes,14084
"Washington, D.C.",2021/1/8,4466.765823,357,1,31107,809,No,Yes,14084
"Washington, D.C.",2021/1/9,4466.765823,350,4,31457,813,No,Yes,14084
"Washington, D.C.",2021/1/10,4466.765823,334,4,31791,817,No,Yes,14084
"Washington, D.C.",2021/1/11,4466.765823,202,4,31993,821,No,Yes,14084
"Washington, D.C.",2021/1/12,4466.765823,430,4,32423,825,No,Yes,14084
"Washington, D.C.",2021/1/13,4466.765823,177,6,32600,831,No,Yes,11980
"Washington, D.C.",2021/1/14,4466.765823,220,11,32820,842,No,Yes,11980
"Washington, D.C.",2021/1/15,4466.765823,320,0,33140,842,No,Yes,11980
"Washington, D.C.",2021/1/16,4466.765823,397,5,33537,847,No,Yes,11980
"Washington, D.C.",2021/1/17,4466.765823,314,3,33851,850,No,Yes,11980
"Washington, D.C.",2021/1/18,4466.765823,182,7,34033,857,No,Yes,11980
"Washington, D.C.",2021/1/19,4466.765823,226,4,34259,861,No,Yes,11980
"Washington, D.C.",2021/1/20,4466.765823,144,2,34403,863,No,Yes,11615
"Washington, D.C.",2021/1/21,4466.765823,209,1,34612,864,No,Yes,11615
"Washington, D.C.",2021/1/22,4466.765823,293,3,34905,867,No,Yes,11615
"Washington, D.C.",2021/1/23,4466.765823,172,3,35077,870,No,Yes,11615
"Washington, D.C.",2021/1/24,4466.765823,224,2,35301,872,No,Yes,11615
"Washington, D.C.",2021/1/25,4466.765823,204,7,35505,879,No,Yes,11615
"Washington, D.C.",2021/1/26,4466.765823,195,9,35700,888,No,Yes,11615
"Washington, D.C.",2021/1/27,4466.765823,165,7,35865,895,No,Yes,12664
"Washington, D.C.",2021/1/28,4466.765823,267,7,36132,902,No,Yes,12664
"Washington, D.C.",2021/1/29,4466.765823,282,5,36414,907,No,Yes,12664
"Washington, D.C.",2021/1/30,4466.765823,248,2,36662,909,No,Yes,12664
"Washington, D.C.",2021/1/31,4466.765823,210,4,36872,913,No,Yes,12664
"Washington, D.C.",2021/2/1,4466.765823,136,3,37008,916,No,Yes,12664
"Washington, D.C.",2021/2/2,4466.765823,130,5,37138,921,No,Yes,12664
"Washington, D.C.",2021/2/3,4466.765823,61,5,37199,926,No,Yes,13464
"Washington, D.C.",2021/2/4,4466.765823,166,6,37365,932,No,Yes,13464
"Washington, D.C.",2021/2/5,4466.765823,269,8,37634,940,No,Yes,13464
"Washington, D.C.",2021/2/6,4466.765823,243,7,37877,947,No,Yes,13464
"Washington, D.C.",2021/2/7,4466.765823,158,5,38035,952,No,Yes,13464
"Washington, D.C.",2021/2/8,4466.765823,101,4,38136,956,No,Yes,13464
"Washington, D.C.",2021/2/9,4466.765823,145,5,38281,961,No,Yes,13464
"Washington, D.C.",2021/2/10,4466.765823,67,4,38348,965,No,Yes,12087
"Washington, D.C.",2021/2/11,4466.765823,185,8,38533,973,No,Yes,12087
"Washington, D.C.",2021/2/12,4466.765823,137,3,38670,976,No,Yes,12087
"Washington, D.C.",2021/2/13,4466.765823,126,3,38796,979,No,Yes,12087
"Washington, D.C.",2021/2/14,4466.765823,122,0,38918,979,No,Yes,12087
"Washington, D.C.",2021/2/15,4466.765823,83,1,39001,980,No,Yes,12087
"Washington, D.C.",2021/2/16,4466.765823,130,2,39131,982,No,Yes,12087
"Washington, D.C.",2021/2/17,4466.765823,49,3,39180,985,No,Yes,11395
"Washington, D.C.",2021/2/18,4466.765823,121,7,39301,992,No,Yes,11395
"Washington, D.C.",2021/2/19,4466.765823,160,1,39461,993,No,Yes,11395
"Washington, D.C.",2021/2/20,4466.765823,92,1,39553,994,No,Yes,11395
"Washington, D.C.",2021/2/21,4466.765823,95,1,39648,995,No,Yes,11395
"Washington, D.C.",2021/2/22,4466.765823,107,0,39755,995,No,Yes,11395
"Washington, D.C.",2021/2/23,4466.765823,89,3,39844,998,No,Yes,11395
"Washington, D.C.",2021/2/24,4466.765823,99,3,39943,1001,No,Yes,11395
"Washington, D.C.",2021/2/25,4466.765823,179,4,40122,1005,No,Yes,11395
"Washington, D.C.",2021/2/26,4466.765823,162,4,40284,1009,No,Yes,11395
"Washington, D.C.",2021/2/27,4466.765823,194,1,40478,1010,No,Yes,11395
"Washington, D.C.",2021/2/28,4466.765823,120,7,40598,1017,No,Yes,11395
"Washington, D.C.",2021/3/1,4466.765823,86,2,40684,1019,No,Yes,11395
"Washington, D.C.",2021/3/2,4466.765823,83,0,40767,1019,No,Yes,11395
"Washington, D.C.",2021/3/3,4466.765823,51,4,40818,1023,No,Yes,11395
"Washington, D.C.",2021/3/4,4466.765823,196,1,41014,1024,No,Yes,11395
Florida,2020/3/1,366.7646346,2,0,2,0,No,No,1575
Florida,2020/3/2,366.7646346,0,0,2,0,No,No,1575
Florida,2020/3/3,366.7646346,1,0,3,0,No,No,1575
Florida,2020/3/4,366.7646346,0,0,3,0,No,No,1663
Florida,2020/3/5,366.7646346,1,0,4,0,No,No,1663
Florida,2020/3/6,366.7646346,3,2,7,2,No,No,1663
Florida,2020/3/7,366.7646346,5,0,12,2,No,No,1663
Florida,2020/3/8,366.7646346,1,0,13,2,No,No,1663
Florida,2020/3/9,366.7646346,1,0,14,2,No,No,1663
Florida,2020/3/10,366.7646346,9,0,23,2,No,No,1663
Florida,2020/3/11,366.7646346,3,0,26,2,No,No,1819
Florida,2020/3/12,366.7646346,20,0,46,2,No,No,1819
Florida,2020/3/13,366.7646346,24,0,70,2,No,No,1819
Florida,2020/3/14,366.7646346,0,1,70,3,No,No,1819
Florida,2020/3/15,366.7646346,39,0,109,3,No,No,1819
Florida,2020/3/16,366.7646346,32,1,141,4,No,No,1819
Florida,2020/3/17,366.7646346,69,2,210,6,No,No,1819
Florida,2020/3/18,366.7646346,116,1,326,7,No,No,10892
Florida,2020/3/19,366.7646346,108,1,434,8,No,No,10892
Florida,2020/3/20,366.7646346,130,1,564,9,No,No,10892
Florida,2020/3/21,366.7646346,200,2,764,11,No,No,10892
Florida,2020/3/22,366.7646346,236,2,1000,13,No,No,10892
Florida,2020/3/23,366.7646346,222,5,1222,18,No,No,10892
Florida,2020/3/24,366.7646346,245,2,1467,20,No,No,10892
Florida,2020/3/25,366.7646346,504,3,1971,23,No,No,80984
Florida,2020/3/26,366.7646346,507,6,2478,29,No,No,80984
Florida,2020/3/27,366.7646346,720,17,3198,46,No,No,80984
Florida,2020/3/28,366.7646346,840,10,4038,56,No,No,80984
Florida,2020/3/29,366.7646346,905,4,4943,60,No,No,80984
Florida,2020/3/30,366.7646346,752,12,5695,72,No,No,80984
Florida,2020/3/31,366.7646346,1047,13,6742,85,No,No,80984
Florida,2020/4/1,366.7646346,1027,15,7769,100,No,No,106739
Florida,2020/4/2,366.7646346,1231,44,9000,144,Yes,No,106739
Florida,2020/4/3,366.7646346,1260,25,10260,169,Yes,No,106739
Florida,2020/4/4,366.7646346,1277,25,11537,194,Yes,No,106739
Florida,2020/4/5,366.7646346,805,26,12342,220,Yes,No,106739
Florida,2020/4/6,366.7646346,1279,33,13621,253,Yes,No,106739
Florida,2020/4/7,366.7646346,1118,42,14739,295,Yes,No,106739
Florida,2020/4/8,366.7646346,951,27,15690,322,Yes,No,77515
Florida,2020/4/9,366.7646346,1129,48,16819,370,Yes,No,77515
Florida,2020/4/10,366.7646346,1141,48,17960,418,Yes,No,77515
Florida,2020/4/11,366.7646346,1018,27,18978,445,Yes,No,77515
Florida,2020/4/12,366.7646346,877,15,19855,460,Yes,No,77515
Florida,2020/4/13,366.7646346,1156,38,21011,498,Yes,No,77515
Florida,2020/4/14,366.7646346,609,72,21620,570,Yes,No,77515
Florida,2020/4/15,366.7646346,906,43,22526,613,Yes,No,66432
Florida,2020/4/16,366.7646346,806,54,23332,667,Yes,No,66432
Florida,2020/4/17,366.7646346,1413,58,24745,725,Yes,No,66432
Florida,2020/4/18,366.7646346,739,22,25484,747,Yes,No,66432
Florida,2020/4/19,366.7646346,822,26,26306,773,Yes,No,66432
Florida,2020/4/20,366.7646346,744,49,27050,822,Yes,No,66432
Florida,2020/4/21,366.7646346,811,44,27861,866,Yes,No,66432
Florida,2020/4/22,366.7646346,440,60,28301,926,Yes,No,74966
Florida,2020/4/23,366.7646346,1339,60,29640,986,Yes,No,74966
Florida,2020/4/24,366.7646346,885,59,30525,1045,Yes,No,74966
Florida,2020/4/25,366.7646346,306,9,30831,1054,Yes,No,74966
Florida,2020/4/26,366.7646346,689,19,31520,1073,Yes,No,74966
Florida,2020/4/27,366.7646346,610,14,32130,1087,Yes,No,74966
Florida,2020/4/28,366.7646346,708,83,32838,1170,Yes,No,74966
Florida,2020/4/29,366.7646346,347,46,33185,1216,Yes,No,28985
Florida,2020/4/30,366.7646346,498,51,33683,1267,Yes,No,28985
Florida,2020/5/1,366.7646346,1037,46,34720,1313,Yes,No,28985
Florida,2020/5/2,366.7646346,735,50,35455,1363,Yes,No,28985
Florida,2020/5/3,366.7646346,615,15,36070,1378,Yes,No,28985
Florida,2020/5/4,366.7646346,819,20,36889,1398,Yes,No,28985
Florida,2020/5/5,366.7646346,542,72,37431,1470,No,No,28985
Florida,2020/5/6,366.7646346,563,68,37994,1538,No,No,26666
Florida,2020/5/7,366.7646346,826,61,38820,1599,No,No,26666
Florida,2020/5/8,366.7646346,371,69,39191,1668,No,No,26666
Florida,2020/5/9,366.7646346,802,46,39993,1714,No,No,26666
Florida,2020/5/10,366.7646346,595,6,40588,1720,No,No,26666
Florida,2020/5/11,366.7646346,386,14,40974,1734,No,No,26666
Florida,2020/5/12,366.7646346,941,44,41915,1778,No,No,26666
Florida,2020/5/13,366.7646346,479,48,42394,1826,No,No,25150
Florida,2020/5/14,366.7646346,808,48,43202,1874,No,No,25150
Florida,2020/5/15,366.7646346,928,42,44130,1916,No,No,25150
Florida,2020/5/16,366.7646346,673,47,44803,1963,No,No,25150
Florida,2020/5/17,366.7646346,777,9,45580,1972,No,No,25150
Florida,2020/5/18,366.7646346,854,24,46434,1996,No,No,25150
Florida,2020/5/19,366.7646346,502,55,46936,2051,No,No,25150
Florida,2020/5/20,366.7646346,527,44,47463,2095,No,No,27919
Florida,2020/5/21,366.7646346,1204,48,48667,2143,No,No,27919
Florida,2020/5/22,366.7646346,776,46,49443,2189,No,No,27919
Florida,2020/5/23,366.7646346,676,43,50119,2232,No,No,27919
Florida,2020/5/24,366.7646346,740,4,50859,2236,No,No,27919
Florida,2020/5/25,366.7646346,879,15,51738,2251,No,No,27919
Florida,2020/5/26,366.7646346,509,7,52247,2258,No,No,27919
Florida,2020/5/27,366.7646346,379,60,52626,2318,No,No,21335
Florida,2020/5/28,366.7646346,651,45,53277,2363,No,No,21335
Florida,2020/5/29,366.7646346,1212,49,54489,2412,No,No,21335
Florida,2020/5/30,366.7646346,927,34,55416,2446,No,No,21335
Florida,2020/5/31,366.7646346,739,4,56155,2450,No,No,21335
Florida,2020/6/1,366.7646346,667,9,56822,2459,No,No,21335
Florida,2020/6/2,366.7646346,617,70,57439,2529,No,No,21335
Florida,2020/6/3,366.7646346,1317,36,58756,2565,No,No,19949
Florida,2020/6/4,366.7646346,1419,41,60175,2606,No,No,19949
Florida,2020/6/5,366.7646346,1305,53,61480,2659,No,No,19949
Florida,2020/6/6,366.7646346,1270,28,62750,2687,No,No,19949
Florida,2020/6/7,366.7646346,1180,12,63930,2699,No,No,19949
Florida,2020/6/8,366.7646346,966,12,64896,2711,No,No,19949
Florida,2020/6/9,366.7646346,1096,53,65992,2764,No,No,19949
Florida,2020/6/10,366.7646346,1371,36,67363,2800,No,No,18367
Florida,2020/6/11,366.7646346,1698,47,69061,2847,No,No,18367
Florida,2020/6/12,366.7646346,1902,29,70963,2876,No,No,18367
Florida,2020/6/13,366.7646346,2581,48,73544,2924,No,No,18367
Florida,2020/6/14,366.7646346,2016,6,75560,2930,No,No,18367
Florida,2020/6/15,366.7646346,1758,7,77318,2937,No,No,18367
Florida,2020/6/16,366.7646346,2783,55,80101,2992,No,No,18367
Florida,2020/6/17,366.7646346,2610,25,82711,3017,No,No,18671
Florida,2020/6/18,366.7646346,3207,43,85918,3060,No,No,18671
Florida,2020/6/19,366.7646346,3822,43,89740,3103,No,No,18671
Florida,2020/6/20,366.7646346,4049,40,93789,3143,No,No,18671
Florida,2020/6/21,366.7646346,3494,17,97283,3160,No,No,18671
Florida,2020/6/22,366.7646346,2926,12,100209,3172,No,No,18671
Florida,2020/6/23,366.7646346,3286,65,103495,3237,No,No,18671
Florida,2020/6/24,366.7646346,5511,43,109006,3280,No,No,18338
Florida,2020/6/25,366.7646346,5004,46,114010,3326,No,No,18338
Florida,2020/6/26,366.7646346,8942,39,122952,3365,No,No,18338
Florida,2020/6/27,366.7646346,9585,24,132537,3389,No,No,18338
Florida,2020/6/28,366.7646346,8530,29,141067,3418,No,No,18338
Florida,2020/6/29,366.7646346,5266,28,146333,3446,No,No,18338
Florida,2020/6/30,366.7646346,6093,58,152426,3504,No,No,18338
Florida,2020/7/1,366.7646346,6563,45,158989,3549,No,No,19056
Florida,2020/7/2,366.7646346,10109,67,169098,3616,No,No,19056
Florida,2020/7/3,366.7646346,9488,67,178586,3683,No,No,19056
Florida,2020/7/4,366.7646346,11458,18,190044,3701,No,No,19056
Florida,2020/7/5,366.7646346,10059,29,200103,3730,No,No,19056
Florida,2020/7/6,366.7646346,6336,47,206439,3777,No,No,19056
Florida,2020/7/7,366.7646346,7347,63,213786,3840,No,No,19056
Florida,2020/7/8,366.7646346,9989,48,223775,3888,No,No,20563
Florida,2020/7/9,366.7646346,8935,120,232710,4008,No,No,20563
Florida,2020/7/10,366.7646346,11433,93,244143,4101,No,No,20563
Florida,2020/7/11,366.7646346,10360,95,254503,4196,No,No,20563
Florida,2020/7/12,366.7646346,15300,45,269803,4241,No,No,20563
Florida,2020/7/13,366.7646346,12624,35,282427,4276,No,No,20563
Florida,2020/7/14,366.7646346,9194,132,291621,4408,No,No,20563
Florida,2020/7/15,366.7646346,10181,112,301802,4520,No,No,23676
Florida,2020/7/16,366.7646346,13965,156,315767,4676,No,No,23676
Florida,2020/7/17,366.7646346,11466,128,327233,4804,No,No,23676
Florida,2020/7/18,366.7646346,10328,90,337561,4894,No,No,23676
Florida,2020/7/19,366.7646346,12478,87,350039,4981,No,No,23676
Florida,2020/7/20,366.7646346,10347,90,360386,5071,No,No,23676
Florida,2020/7/21,366.7646346,9440,134,369826,5205,No,No,23676
Florida,2020/7/22,366.7646346,9785,139,379611,5344,No,No,17437
Florida,2020/7/23,366.7646346,10249,173,389860,5517,No,No,17437
Florida,2020/7/24,366.7646346,12444,135,402304,5652,No,No,17437
Florida,2020/7/25,366.7646346,12199,124,414503,5776,No,No,17437
Florida,2020/7/26,366.7646346,9344,77,423847,5853,No,No,17437
Florida,2020/7/27,366.7646346,8892,77,432739,5930,No,No,17437
Florida,2020/7/28,366.7646346,9230,186,441969,6116,No,No,17437
Florida,2020/7/29,366.7646346,9446,216,451415,6332,No,No,11690
Florida,2020/7/30,366.7646346,9956,253,461371,6585,No,No,11690
Florida,2020/7/31,366.7646346,9007,257,470378,6842,No,No,11690
Florida,2020/8/1,366.7646346,9642,179,480020,7021,No,No,11690
Florida,2020/8/2,366.7646346,7104,62,487124,7083,No,No,11690
Florida,2020/8/3,366.7646346,4752,73,491876,7156,No,No,11690
Florida,2020/8/4,366.7646346,5446,245,497322,7401,No,No,11690
Florida,2020/8/5,366.7646346,5409,225,502731,7626,No,No,9467
Florida,2020/8/6,366.7646346,7650,120,510381,7746,No,No,9467
Florida,2020/8/7,366.7646346,7686,180,518067,7926,No,No,9467
Florida,2020/8/8,366.7646346,8502,182,526569,8108,No,No,9467
Florida,2020/8/9,366.7646346,6229,77,532798,8185,No,No,9467
Florida,2020/8/10,366.7646346,4155,91,536953,8276,No,No,9467
Florida,2020/8/11,366.7646346,5831,276,542784,8552,No,No,9467
Florida,2020/8/12,366.7646346,8109,212,550893,8764,No,No,11047
Florida,2020/8/13,366.7646346,6236,148,557129,8912,No,No,11047
Florida,2020/8/14,366.7646346,6148,228,563277,9140,No,No,11047
Florida,2020/8/15,366.7646346,6352,204,569629,9344,No,No,11047
Florida,2020/8/16,366.7646346,3779,107,573408,9451,No,No,11047
Florida,2020/8/17,366.7646346,2678,87,576086,9538,No,No,11047
Florida,2020/8/18,366.7646346,3838,219,579924,9757,No,No,11047
Florida,2020/8/19,366.7646346,4115,174,584039,9931,No,No,8676
Florida,2020/8/20,366.7646346,4555,117,588594,10048,No,No,8676
Florida,2020/8/21,366.7646346,4684,119,593278,10167,No,No,8676
Florida,2020/8/22,366.7646346,4311,106,597589,10273,No,No,8676
Florida,2020/8/23,366.7646346,2974,51,600563,10324,No,No,8676
Florida,2020/8/24,366.7646346,2258,72,602821,10396,No,No,8676
Florida,2020/8/25,366.7646346,2673,183,605494,10579,No,No,8676
Florida,2020/8/26,366.7646346,3220,153,608714,10732,No,No,8511
Florida,2020/8/27,366.7646346,3269,135,611983,10867,No,No,8511
Florida,2020/8/28,366.7646346,3815,89,615798,10956,No,No,8511
Florida,2020/8/29,366.7646346,3197,148,618995,11104,No,No,8511
Florida,2020/8/30,366.7646346,2583,14,621578,11118,No,No,8511
Florida,2020/8/31,366.7646346,1885,68,623463,11186,No,No,8511
Florida,2020/9/1,366.7646346,7569,187,631032,11373,No,No,8511
Florida,2020/9/2,366.7646346,2402,127,633434,11500,No,No,8901
Florida,2020/9/3,366.7646346,3571,149,637005,11649,No,No,8901
Florida,2020/9/4,366.7646346,3198,100,640203,11749,No,No,8901
Florida,2020/9/5,366.7646346,3656,61,643859,11810,No,No,8901
Florida,2020/9/6,366.7646346,2564,38,646423,11848,No,No,8901
Florida,2020/9/7,366.7646346,1838,22,648261,11870,No,No,8901
Florida,2020/9/8,366.7646346,1823,44,650084,11914,No,No,8901
Florida,2020/9/9,366.7646346,2056,200,652140,12114,No,No,8848
Florida,2020/9/10,366.7646346,2583,211,654723,12325,No,No,8848
Florida,2020/9/11,366.7646346,3650,176,658373,12501,No,No,8848
Florida,2020/9/12,366.7646346,3190,98,661563,12599,No,No,8848
Florida,2020/9/13,366.7646346,2423,8,663986,12607,No,No,8848
Florida,2020/9/14,366.7646346,1736,34,665722,12641,No,No,8848
Florida,2020/9/15,366.7646346,3116,145,668838,12786,No,No,8848
Florida,2020/9/16,366.7646346,2355,152,671193,12938,No,No,8679
Florida,2020/9/17,366.7646346,3255,147,674448,13085,No,No,8679
Florida,2020/9/18,366.7646346,3204,139,677652,13224,No,No,8679
Florida,2020/9/19,366.7646346,3573,62,681225,13286,No,No,8679
Florida,2020/9/20,366.7646346,2521,9,683746,13295,No,No,8679
Florida,2020/9/21,366.7646346,1685,21,685431,13316,No,No,8679
Florida,2020/9/22,366.7646346,2470,99,687901,13415,No,No,8679
Florida,2020/9/23,366.7646346,2590,202,690491,13617,No,No,8805
Florida,2020/9/24,366.7646346,2541,177,693032,13794,No,No,8805
Florida,2020/9/25,366.7646346,2847,120,695879,13914,No,No,8805
Florida,2020/9/26,366.7646346,2795,107,698674,14021,No,No,8805
Florida,2020/9/27,366.7646346,1882,10,700556,14031,No,No,8805
Florida,2020/9/28,366.7646346,738,5,701294,14036,No,No,8805
Florida,2020/9/29,366.7646346,3266,106,704560,14142,No,No,8805
Florida,2020/9/30,366.7646346,1948,174,706508,14316,No,No,7732
Florida,2020/10/1,366.7646346,2628,127,709136,14443,No,No,7732
Florida,2020/10/2,366.7646346,2660,110,711796,14553,No,No,7732
Florida,2020/10/3,366.7646346,2787,74,714583,14627,No,No,7732
Florida,2020/10/4,366.7646346,1868,43,716451,14670,No,No,7732
Florida,2020/10/5,366.7646346,1415,41,717866,14711,No,No,7732
Florida,2020/10/6,366.7646346,2251,55,720117,14766,No,No,7732
Florida,2020/10/7,366.7646346,2582,137,722699,14903,No,No,8581
Florida,2020/10/8,366.7646346,3306,164,726005,15067,No,No,8581
Florida,2020/10/9,366.7646346,2908,118,728913,15185,No,No,8581
Florida,2020/10/10,366.7646346,0,0,728913,15185,No,No,8581
Florida,2020/10/11,366.7646346,5570,178,734483,15363,No,No,8581
Florida,2020/10/12,366.7646346,1533,48,736016,15411,No,No,8581
Florida,2020/10/13,366.7646346,2725,119,738741,15530,No,No,8581
Florida,2020/10/14,366.7646346,2883,64,741624,15594,No,No,7964
Florida,2020/10/15,366.7646346,3356,141,744980,15735,No,No,7964
Florida,2020/10/16,366.7646346,3449,94,748429,15829,No,No,7964
Florida,2020/10/17,366.7646346,4044,87,752473,15916,No,No,7964
Florida,2020/10/18,366.7646346,2539,50,755012,15966,No,No,7964
Florida,2020/10/19,366.7646346,1707,54,756719,16020,No,No,7964
Florida,2020/10/20,366.7646346,3662,84,760381,16104,No,No,7964
Florida,2020/10/21,366.7646346,2144,105,762525,16209,No,No,7126
Florida,2020/10/22,366.7646346,5558,57,768083,16266,No,No,7126
Florida,2020/10/23,366.7646346,3689,73,771772,16339,No,No,7126
Florida,2020/10/24,366.7646346,4471,77,776243,16416,No,No,7126
Florida,2020/10/25,366.7646346,2385,12,778628,16428,No,No,7126
Florida,2020/10/26,366.7646346,3377,20,782005,16448,No,No,7126
Florida,2020/10/27,366.7646346,4298,56,786303,16504,No,No,7126
Florida,2020/10/28,366.7646346,4115,66,790418,16570,No,No,7060
Florida,2020/10/29,366.7646346,4198,77,794616,16647,No,No,7060
Florida,2020/10/30,366.7646346,5592,72,800208,16719,No,No,7060
Florida,2020/10/31,366.7646346,2331,41,802539,16760,No,No,7060
Florida,2020/11/1,366.7646346,4865,28,807404,16788,No,No,7060
Florida,2020/11/2,366.7646346,4651,45,812055,16833,No,No,7060
Florida,2020/11/3,366.7646346,4637,56,816692,16889,No,No,7060
Florida,2020/11/4,366.7646346,4423,32,821115,16921,No,No,8764
Florida,2020/11/5,366.7646346,6257,39,827372,16960,No,No,8764
Florida,2020/11/6,366.7646346,5245,53,832617,17013,No,No,8764
Florida,2020/11/7,366.7646346,4452,86,837069,17099,No,No,8764
Florida,2020/11/8,366.7646346,6820,21,843889,17120,No,No,8764
Florida,2020/11/9,366.7646346,3924,58,847813,17178,No,No,8764
Florida,2020/11/10,366.7646346,4353,69,852166,17247,No,No,8764
Florida,2020/11/11,366.7646346,5838,52,858004,17299,No,No,9262
Florida,2020/11/12,366.7646346,5607,72,863611,17371,No,No,9262
Florida,2020/11/13,366.7646346,6933,73,870544,17444,No,No,9262
Florida,2020/11/14,366.7646346,4544,44,875088,17488,No,No,9262
Florida,2020/11/15,366.7646346,10105,29,885193,17517,No,No,9262
Florida,2020/11/16,366.7646346,4663,41,889856,17558,No,No,9262
Florida,2020/11/17,366.7646346,7459,85,897315,17643,No,No,9262
Florida,2020/11/18,366.7646346,7925,87,905240,17730,No,No,11813
Florida,2020/11/19,366.7646346,9085,79,914325,17809,No,No,11813
Florida,2020/11/20,366.7646346,9085,79,923410,17888,No,No,11813
Florida,2020/11/21,366.7646346,8409,41,931819,17929,No,No,11813
Florida,2020/11/22,366.7646346,6587,61,938406,17990,No,No,11813
Florida,2020/11/23,366.7646346,6331,94,944737,18084,No,No,11813
Florida,2020/11/24,366.7646346,8555,72,953292,18156,No,No,11813
Florida,2020/11/25,366.7646346,8376,97,961668,18253,No,No,7061
Florida,2020/11/26,366.7646346,0,0,961668,18253,No,No,7061
Florida,2020/11/27,366.7646346,17344,109,979012,18362,No,No,7061
Florida,2020/11/28,366.7646346,6277,79,985289,18441,No,No,7061
Florida,2020/11/29,366.7646346,7363,58,992652,18499,No,No,7061
Florida,2020/11/30,366.7646346,6659,97,999311,18596,No,No,7061
Florida,2020/12/1,366.7646346,8847,82,1008158,18678,No,No,7061
Florida,2020/12/2,366.7646346,9994,97,1018152,18775,No,No,7656
Florida,2020/12/3,366.7646346,10870,98,1029022,18873,No,No,7656
Florida,2020/12/4,366.7646346,10177,120,1039199,18993,No,No,7656
Florida,2020/12/5,366.7646346,10431,90,1049630,19083,No,No,7656
Florida,2020/12/6,366.7646346,8436,93,1058066,19176,No,No,7656
Florida,2020/12/7,366.7646346,7711,105,1065777,19281,No,No,7656
Florida,2020/12/8,366.7646346,7985,96,1073762,19377,No,No,7656
Florida,2020/12/9,366.7646346,9592,84,1083354,19461,No,No,7568
Florida,2020/12/10,366.7646346,11335,129,1094689,19590,No,No,7568
Florida,2020/12/11,366.7646346,11699,123,1106388,19713,No,No,7568
Florida,2020/12/12,366.7646346,10577,71,1116965,19784,No,No,7568
Florida,2020/12/13,366.7646346,8958,81,1125923,19865,No,No,7568
Florida,2020/12/14,366.7646346,8452,137,1134375,20002,No,No,7568
Florida,2020/12/15,366.7646346,9411,79,1143786,20081,No,No,7568
Florida,2020/12/16,366.7646346,11541,122,1155327,20203,No,No,7543
Florida,2020/12/17,366.7646346,13148,101,1168475,20304,No,No,7543
Florida,2020/12/18,366.7646346,13000,96,1181475,20400,No,No,7543
Florida,2020/12/19,366.7646346,11682,72,1193157,20472,No,No,7543
Florida,2020/12/20,366.7646346,8401,95,1201558,20567,No,No,7543
Florida,2020/12/21,366.7646346,11015,112,1212573,20679,No,No,7543
Florida,2020/12/22,366.7646346,10434,74,1223007,20753,No,No,7543
Florida,2020/12/23,366.7646346,11384,120,1234391,20873,No,No,5506
Florida,2020/12/24,366.7646346,13147,121,1247538,20994,No,No,5506
Florida,2020/12/25,366.7646346,0,0,1247538,20994,No,No,5506
Florida,2020/12/26,366.7646346,17042,140,1264580,21134,No,No,5506
Florida,2020/12/27,366.7646346,7391,77,1271971,21211,No,No,5506
Florida,2020/12/28,366.7646346,8198,96,1280169,21307,No,No,5506
Florida,2020/12/29,366.7646346,12075,101,1292244,21408,No,No,5506
Florida,2020/12/30,366.7646346,13871,137,1306115,21545,No,No,10986
Florida,2020/12/31,366.7646346,17192,127,1323307,21672,No,No,10986
Florida,2021/1/1,366.7646346,0,0,1323307,21672,No,No,10986
Florida,2021/1/2,366.7646346,31518,217,1354825,21889,No,No,10986
Florida,2021/1/3,366.7646346,10603,97,1365428,21986,No,No,10986
Florida,2021/1/4,366.7646346,11256,103,1376684,22089,No,No,10986
Florida,2021/1/5,366.7646346,15431,98,1392115,22187,No,No,10986
Florida,2021/1/6,366.7646346,17783,129,1409898,22316,No,No,14084
Florida,2021/1/7,366.7646346,19816,164,1429714,22480,No,No,14084
Florida,2021/1/8,366.7646346,19530,185,1449244,22665,No,No,14084
Florida,2021/1/9,366.7646346,15445,138,1464689,22803,No,No,14084
Florida,2021/1/10,366.7646346,12313,108,1477002,22911,No,No,14084
Florida,2021/1/11,366.7646346,11576,159,1488578,23070,No,No,14084
Florida,2021/1/12,366.7646346,14896,156,1503474,23226,No,No,14084
Florida,2021/1/13,366.7646346,13990,169,1517464,23395,No,No,11980
Florida,2021/1/14,366.7646346,13720,217,1531184,23612,No,No,11980
Florida,2021/1/15,366.7646346,16875,186,1548059,23798,No,No,11980
Florida,2021/1/16,366.7646346,12119,205,1560178,24003,No,No,11980
Florida,2021/1/17,366.7646346,11093,133,1571271,24136,No,No,11980
Florida,2021/1/18,366.7646346,8002,137,1579273,24273,No,No,11980
Florida,2021/1/19,366.7646346,9816,162,1589089,24435,No,No,11980
Florida,2021/1/20,366.7646346,11914,142,1601003,24577,No,No,11615
Florida,2021/1/21,366.7646346,12873,161,1613876,24738,No,No,11615
Florida,2021/1/22,366.7646346,13719,272,1627595,25010,No,No,11615
Florida,2021/1/23,366.7646346,12311,153,1639906,25163,No,No,11615
Florida,2021/1/24,366.7646346,9535,129,1649441,25292,No,No,11615
Florida,2021/1/25,366.7646346,8720,153,1658161,25445,No,No,11615
Florida,2021/1/26,366.7646346,9594,227,1667755,25672,No,No,11615
Florida,2021/1/27,366.7646346,8408,160,1676163,25832,No,No,12664
Florida,2021/1/28,366.7646346,11423,202,1687586,26034,No,No,12664
Florida,2021/1/29,366.7646346,10976,219,1698562,26253,No,No,12664
Florida,2021/1/30,366.7646346,15019,106,1713581,26359,No,No,12664
Florida,2021/1/31,366.7646346,7788,119,1721369,26478,No,No,12664
Florida,2021/2/1,366.7646346,5730,206,1727099,26684,No,No,12664
Florida,2021/2/2,366.7646346,10533,137,1737632,26821,No,No,12664
Florida,2021/2/3,366.7646346,6979,197,1744611,27018,No,No,13464
Florida,2021/2/4,366.7646346,7711,228,1752322,27246,No,No,13464
Florida,2021/2/5,366.7646346,11543,210,1763865,27456,No,No,13464
Florida,2021/2/6,366.7646346,7486,142,1771351,27598,No,No,13464
Florida,2021/2/7,366.7646346,6624,97,1777975,27695,No,No,13464
Florida,2021/2/8,366.7646346,5737,119,1783712,27814,No,No,13464
Florida,2021/2/9,366.7646346,7023,233,1790735,28047,No,No,13464
Florida,2021/2/10,366.7646346,7537,160,1798272,28207,No,No,12087
Florida,2021/2/11,366.7646346,8525,174,1806797,28381,No,No,12087
Florida,2021/2/12,366.7646346,7617,183,1814414,28564,No,No,12087
Florida,2021/2/13,366.7646346,7515,118,1821929,28682,No,No,12087
Florida,2021/2/14,366.7646346,5436,96,1827365,28778,No,No,12087
Florida,2021/2/15,366.7646346,3615,155,1830980,28933,No,No,12087
Florida,2021/2/16,366.7646346,6297,220,1837277,29153,No,No,12087
Florida,2021/2/17,366.7646346,7342,157,1844619,29310,No,No,11395
Florida,2021/2/18,366.7646346,5117,163,1849736,29473,No,No,11395
Florida,2021/2/19,366.7646346,6683,218,1856419,29691,No,No,11395
Florida,2021/2/20,366.7646346,7280,121,1863699,29812,No,No,11395
Florida,2021/2/21,366.7646346,5065,93,1868764,29905,No,No,11395
Florida,2021/2/22,366.7646346,4151,159,1872915,30064,No,No,11395
Florida,2021/2/23,366.7646346,5610,148,1878525,30212,No,No,11395
Florida,2021/2/24,366.7646346,7128,127,1885653,30339,No,No,11395
Florida,2021/2/25,366.7646346,6640,138,1892293,30477,No,No,11395
Florida,2021/2/26,366.7646346,5922,146,1898215,30623,No,No,11395
Florida,2021/2/27,366.7646346,5459,110,1903674,30733,No,No,11395
Florida,2021/2/28,366.7646346,5539,118,1909213,30851,No,No,11395
Florida,2021/3/1,366.7646346,1700,147,1910913,30998,No,No,11395
Florida,2021/3/2,366.7646346,7179,136,1918092,31134,No,No,11395
Florida,2021/3/3,366.7646346,6014,132,1924106,31266,No,No,11395
Florida,2021/3/4,366.7646346,6118,120,1930224,31386,No,No,11395
Georgia,2020/3/1,180.3353319,0,0,0,0,No,No,1575
Georgia,2020/3/2,180.3353319,2,0,2,0,No,No,1575
Georgia,2020/3/3,180.3353319,0,0,2,0,No,No,1575
Georgia,2020/3/4,180.3353319,0,0,2,0,No,No,1663
Georgia,2020/3/5,180.3353319,0,0,2,0,No,No,1663
Georgia,2020/3/6,180.3353319,1,0,3,0,No,No,1663
Georgia,2020/3/7,180.3353319,4,0,7,0,No,No,1663
Georgia,2020/3/8,180.3353319,4,0,11,0,No,No,1663
Georgia,2020/3/9,180.3353319,6,0,17,0,No,No,1663
Georgia,2020/3/10,180.3353319,5,0,22,0,No,No,1663
Georgia,2020/3/11,180.3353319,9,0,31,0,No,No,1819
Georgia,2020/3/12,180.3353319,0,1,31,1,No,No,1819
Georgia,2020/3/13,180.3353319,10,0,41,1,No,No,1819
Georgia,2020/3/14,180.3353319,24,0,65,1,No,No,1819
Georgia,2020/3/15,180.3353319,32,0,97,1,No,No,1819
Georgia,2020/3/16,180.3353319,21,0,118,1,No,No,1819
Georgia,2020/3/17,180.3353319,24,0,142,1,No,No,1819
Georgia,2020/3/18,180.3353319,51,2,193,3,No,No,10892
Georgia,2020/3/19,180.3353319,89,7,282,10,No,No,10892
Georgia,2020/3/20,180.3353319,200,4,482,14,No,No,10892
Georgia,2020/3/21,180.3353319,70,6,552,20,No,No,10892
Georgia,2020/3/22,180.3353319,68,5,620,25,No,No,10892
Georgia,2020/3/23,180.3353319,180,0,800,25,No,No,10892
Georgia,2020/3/24,180.3353319,295,13,1095,38,No,No,10892
Georgia,2020/3/25,180.3353319,290,9,1385,47,No,No,80984
Georgia,2020/3/26,180.3353319,256,9,1641,56,No,No,80984
Georgia,2020/3/27,180.3353319,557,8,2198,64,No,No,80984
Georgia,2020/3/28,180.3353319,249,15,2447,79,No,No,80984
Georgia,2020/3/29,180.3353319,236,4,2683,83,No,No,80984
Georgia,2020/3/30,180.3353319,349,20,3032,103,No,No,80984
Georgia,2020/3/31,180.3353319,1084,23,4116,126,No,No,80984
Georgia,2020/4/1,180.3353319,631,28,4747,154,No,No,106739
Georgia,2020/4/2,180.3353319,697,22,5444,176,No,No,106739
Georgia,2020/4/3,180.3353319,523,22,5967,198,Yes,No,106739
Georgia,2020/4/4,180.3353319,416,10,6383,208,Yes,No,106739
Georgia,2020/4/5,180.3353319,359,11,6742,219,Yes,No,106739
Georgia,2020/4/6,180.3353319,816,75,7558,294,Yes,No,106739
Georgia,2020/4/7,180.3353319,1598,54,9156,348,Yes,No,106739
Georgia,2020/4/8,180.3353319,1048,22,10204,370,Yes,No,77515
Georgia,2020/4/9,180.3353319,681,42,10885,412,Yes,No,77515
Georgia,2020/4/10,180.3353319,974,13,11859,425,Yes,No,77515
Georgia,2020/4/11,180.3353319,402,7,12261,432,Yes,No,77515
Georgia,2020/4/12,180.3353319,-158,6,12103,438,Yes,No,77515
Georgia,2020/4/13,180.3353319,1022,41,13125,479,Yes,No,77515
Georgia,2020/4/14,180.3353319,788,38,13913,517,Yes,No,77515
Georgia,2020/4/15,180.3353319,670,52,14583,569,Yes,No,66432
Georgia,2020/4/16,180.3353319,1061,42,15644,611,Yes,No,66432
Georgia,2020/4/17,180.3353319,1014,50,16658,661,Yes,No,66432
Georgia,2020/4/18,180.3353319,356,9,17014,670,Yes,No,66432
Georgia,2020/4/19,180.3353319,605,12,17619,682,Yes,No,66432
Georgia,2020/4/20,180.3353319,828,85,18447,767,Yes,No,66432
Georgia,2020/4/21,180.3353319,742,43,19189,810,Yes,No,66432
Georgia,2020/4/22,180.3353319,910,27,20099,837,Yes,No,74966
Georgia,2020/4/23,180.3353319,806,34,20905,871,Yes,No,74966
Georgia,2020/4/24,180.3353319,670,18,21575,889,Yes,No,74966
Georgia,2020/4/25,180.3353319,650,8,22225,897,Yes,No,74966
Georgia,2020/4/26,180.3353319,234,10,22459,907,Yes,No,74966
Georgia,2020/4/27,180.3353319,770,74,23229,981,Yes,No,74966
Georgia,2020/4/28,180.3353319,378,41,23607,1022,Yes,No,74966
Georgia,2020/4/29,180.3353319,693,64,24300,1086,Yes,No,28985
Georgia,2020/4/30,180.3353319,1131,35,25431,1121,Yes,No,28985
Georgia,2020/5/1,180.3353319,1005,32,26436,1153,No,No,28985
Georgia,2020/5/2,180.3353319,832,8,27268,1161,No,No,28985
Georgia,2020/5/3,180.3353319,350,7,27618,1168,No,No,28985
Georgia,2020/5/4,180.3353319,732,60,28350,1228,No,No,28985
Georgia,2020/5/5,180.3353319,526,49,28876,1277,No,No,28985
Georgia,2020/5/6,180.3353319,848,32,29724,1309,No,No,26666
Georgia,2020/5/7,180.3353319,800,23,30524,1332,No,No,26666
Georgia,2020/5/8,180.3353319,565,46,31089,1378,No,No,26666
Georgia,2020/5/9,180.3353319,392,2,31481,1380,No,No,26666
Georgia,2020/5/10,180.3353319,786,3,32267,1383,No,No,26666
Georgia,2020/5/11,180.3353319,181,37,32448,1420,No,No,26666
Georgia,2020/5/12,180.3353319,863,50,33311,1470,No,No,26666
Georgia,2020/5/13,180.3353319,555,24,33866,1494,No,No,25150
Georgia,2020/5/14,180.3353319,556,27,34422,1521,No,No,25150
Georgia,2020/5/15,180.3353319,820,42,35242,1563,No,No,25150
Georgia,2020/5/16,180.3353319,413,10,35655,1573,No,No,25150
Georgia,2020/5/17,180.3353319,299,11,35954,1584,No,No,25150
Georgia,2020/5/18,180.3353319,680,40,36634,1624,No,No,25150
Georgia,2020/5/19,180.3353319,580,26,37214,1650,No,No,25150
Georgia,2020/5/20,180.3353319,948,22,38162,1672,No,No,27919
Georgia,2020/5/21,180.3353319,807,77,38969,1749,No,No,27919
Georgia,2020/5/22,180.3353319,765,30,39734,1779,No,No,27919
Georgia,2020/5/23,180.3353319,674,15,40408,1794,No,No,27919
Georgia,2020/5/24,180.3353319,581,5,40989,1799,No,No,27919
Georgia,2020/5/25,180.3353319,425,21,41414,1820,No,No,27919
Georgia,2020/5/26,180.3353319,652,47,42066,1867,No,No,27919
Georgia,2020/5/27,180.3353319,647,37,42713,1904,No,No,21335
Georgia,2020/5/28,180.3353319,650,38,43363,1942,No,No,21335
Georgia,2020/5/29,180.3353319,525,11,43888,1953,No,No,21335
Georgia,2020/5/30,180.3353319,448,20,44336,1973,No,No,21335
Georgia,2020/5/31,180.3353319,715,46,45051,2019,No,No,21335
Georgia,2020/6/1,180.3353319,706,38,45757,2057,No,No,21335
Georgia,2020/6/2,180.3353319,306,13,46063,2070,No,No,21335
Georgia,2020/6/3,180.3353319,648,22,46711,2092,No,No,19949
Georgia,2020/6/4,180.3353319,817,24,47528,2116,No,No,19949
Georgia,2020/6/5,180.3353319,752,27,48280,2143,No,No,19949
Georgia,2020/6/6,180.3353319,663,4,48943,2147,No,No,19949
Georgia,2020/6/7,180.3353319,428,1,49371,2148,No,No,19949
Georgia,2020/6/8,180.3353319,624,28,49995,2176,No,No,19949
Georgia,2020/6/9,180.3353319,774,74,50769,2250,No,No,19949
Georgia,2020/6/10,180.3353319,696,42,51465,2292,No,No,18367
Georgia,2020/6/11,180.3353319,867,45,52332,2337,No,No,18367
Georgia,2020/6/12,180.3353319,869,47,53201,2384,No,No,18367
Georgia,2020/6/13,180.3353319,977,27,54178,2411,No,No,18367
Georgia,2020/6/14,180.3353319,696,5,54874,2416,No,No,18367
Georgia,2020/6/15,180.3353319,631,41,55505,2457,No,No,18367
Georgia,2020/6/16,180.3353319,797,35,56302,2492,No,No,18367
Georgia,2020/6/17,180.3353319,915,44,57217,2536,No,No,18671
Georgia,2020/6/18,180.3353319,823,29,58040,2565,No,No,18671
Georgia,2020/6/19,180.3353319,1077,31,59117,2596,No,No,18671
Georgia,2020/6/20,180.3353319,1552,6,60669,2602,No,No,18671
Georgia,2020/6/21,180.3353319,824,1,61493,2603,No,No,18671
Georgia,2020/6/22,180.3353319,1212,4,62705,2607,No,No,18671
Georgia,2020/6/23,180.3353319,1872,39,64577,2646,No,No,18671
Georgia,2020/6/24,180.3353319,1713,12,66290,2658,No,No,18338
Georgia,2020/6/25,180.3353319,1506,46,67796,2704,No,No,18338
Georgia,2020/6/26,180.3353319,1746,23,69542,2727,No,No,18338
Georgia,2020/6/27,180.3353319,1524,6,71066,2733,No,No,18338
Georgia,2020/6/28,180.3353319,1734,2,72800,2735,No,No,18338
Georgia,2020/6/29,180.3353319,2016,4,74816,2739,No,No,18338
Georgia,2020/6/30,180.3353319,2464,19,77280,2758,No,No,18338
Georgia,2020/7/1,180.3353319,2309,21,79589,2779,No,No,19056
Georgia,2020/7/2,180.3353319,2886,22,82475,2801,No,No,19056
Georgia,2020/7/3,180.3353319,2604,7,85079,2808,No,No,19056
Georgia,2020/7/4,180.3353319,2513,1,87592,2809,No,No,19056
Georgia,2020/7/5,180.3353319,1897,3,89489,2812,No,No,19056
Georgia,2020/7/6,180.3353319,1526,17,91015,2829,No,No,19056
Georgia,2020/7/7,180.3353319,2692,21,93707,2850,No,No,19056
Georgia,2020/7/8,180.3353319,2831,21,96538,2871,No,No,20563
Georgia,2020/7/9,180.3353319,2155,9,98693,2880,No,No,20563
Georgia,2020/7/10,180.3353319,4904,35,103597,2915,No,No,20563
Georgia,2020/7/11,180.3353319,2977,31,106574,2946,No,No,20563
Georgia,2020/7/12,180.3353319,1815,5,108389,2951,No,No,20563
Georgia,2020/7/13,180.3353319,3548,21,111937,2972,No,No,20563
Georgia,2020/7/14,180.3353319,2642,24,114579,2996,No,No,20563
Georgia,2020/7/15,180.3353319,3568,34,118147,3030,No,No,23676
Georgia,2020/7/16,180.3353319,2701,13,120848,3043,No,No,23676
Georgia,2020/7/17,180.3353319,3419,28,124267,3071,No,No,23676
Georgia,2020/7/18,180.3353319,4074,34,128341,3105,No,No,23676
Georgia,2020/7/19,180.3353319,2453,5,130794,3110,No,No,23676
Georgia,2020/7/20,180.3353319,1994,3,132788,3113,No,No,23676
Georgia,2020/7/21,180.3353319,3077,73,135865,3186,No,No,23676
Georgia,2020/7/22,180.3353319,3255,78,139120,3264,No,No,17437
Georgia,2020/7/23,180.3353319,4737,24,143857,3288,No,No,17437
Georgia,2020/7/24,180.3353319,3875,80,147732,3368,No,No,17437
Georgia,2020/7/25,180.3353319,3530,53,151262,3421,No,No,17437
Georgia,2020/7/26,180.3353319,2214,3,153476,3424,No,No,17437
Georgia,2020/7/27,180.3353319,2431,11,155907,3435,No,No,17437
Georgia,2020/7/28,180.3353319,4131,53,160038,3488,No,No,17437
Georgia,2020/7/29,180.3353319,3509,78,163547,3566,No,No,11690
Georgia,2020/7/30,180.3353319,3998,30,167545,3596,No,No,11690
Georgia,2020/7/31,180.3353319,3797,78,171342,3674,No,No,11690
Georgia,2020/8/1,180.3353319,3492,70,174834,3744,No,No,11690
Georgia,2020/8/2,180.3353319,2722,14,177556,3758,No,No,11690
Georgia,2020/8/3,180.3353319,1954,2,179510,3760,No,No,11690
Georgia,2020/8/4,180.3353319,2952,75,182462,3835,No,No,11690
Georgia,2020/8/5,180.3353319,3933,64,186395,3899,No,No,9467
Georgia,2020/8/6,180.3353319,2905,43,189300,3942,No,No,9467
Georgia,2020/8/7,180.3353319,3976,87,193276,4029,No,No,9467
Georgia,2020/8/8,180.3353319,4032,66,197308,4095,No,No,9467
Georgia,2020/8/9,180.3353319,2839,13,200147,4108,No,No,9467
Georgia,2020/8/10,180.3353319,2129,30,202276,4138,No,No,9467
Georgia,2020/8/11,180.3353319,3644,117,205920,4255,No,No,9467
Georgia,2020/8/12,180.3353319,3763,105,209683,4360,No,No,11047
Georgia,2020/8/13,180.3353319,2326,80,212009,4440,No,No,11047
Georgia,2020/8/14,180.3353319,3319,34,215328,4474,No,No,11047
Georgia,2020/8/15,180.3353319,3016,94,218344,4568,No,No,11047
Georgia,2020/8/16,180.3353319,1821,32,220165,4600,No,Yes,11047
Georgia,2020/8/17,180.3353319,1676,24,221841,4624,No,Yes,11047
Georgia,2020/8/18,180.3353319,2840,67,224681,4691,No,Yes,11047
Georgia,2020/8/19,180.3353319,2574,53,227255,4744,No,Yes,8676
Georgia,2020/8/20,180.3353319,3033,53,230288,4797,No,Yes,8676
Georgia,2020/8/21,180.3353319,2881,92,233169,4889,No,Yes,8676
Georgia,2020/8/22,180.3353319,2614,93,235783,4982,No,Yes,8676
Georgia,2020/8/23,180.3353319,1619,39,237402,5021,No,Yes,8676
Georgia,2020/8/24,180.3353319,2210,24,239612,5045,No,Yes,8676
Georgia,2020/8/25,180.3353319,2253,102,241865,5147,No,Yes,8676
Georgia,2020/8/26,180.3353319,2629,48,244494,5195,No,Yes,8511
Georgia,2020/8/27,180.3353319,2523,80,247017,5275,No,Yes,8511
Georgia,2020/8/28,180.3353319,2300,77,249317,5352,No,Yes,8511
Georgia,2020/8/29,180.3353319,2359,99,251676,5451,No,Yes,8511
Georgia,2020/8/30,180.3353319,1137,27,252813,5478,No,Yes,8511
Georgia,2020/8/31,180.3353319,1425,28,254238,5506,No,Yes,8511
Georgia,2020/9/1,180.3353319,2306,98,256544,5604,No,Yes,8511
Georgia,2020/9/2,180.3353319,1938,61,258482,5665,No,Yes,8901
Georgia,2020/9/3,180.3353319,2574,70,261056,5735,No,Yes,8901
Georgia,2020/9/4,180.3353319,1991,62,263047,5797,No,Yes,8901
Georgia,2020/9/5,180.3353319,2168,45,265215,5842,No,Yes,8901
Georgia,2020/9/6,180.3353319,1492,58,266707,5900,No,Yes,8901
Georgia,2020/9/7,180.3353319,531,7,267238,5907,No,Yes,8901
Georgia,2020/9/8,180.3353319,1446,24,268684,5931,No,Yes,8901
Georgia,2020/9/9,180.3353319,1940,56,270624,5987,No,Yes,8848
Georgia,2020/9/10,180.3353319,1964,75,272588,6062,No,Yes,8848
Georgia,2020/9/11,180.3353319,1654,41,274242,6103,No,Yes,8848
Georgia,2020/9/12,180.3353319,2077,41,276319,6144,No,Yes,8848
Georgia,2020/9/13,180.3353319,1396,47,277715,6191,No,Yes,8848
Georgia,2020/9/14,180.3353319,984,20,278699,6211,No,Yes,8848
Georgia,2020/9/15,180.3353319,1657,44,280356,6255,No,Yes,8848
Georgia,2020/9/16,180.3353319,2007,21,282363,6276,No,Yes,8679
Georgia,2020/9/17,180.3353319,1856,52,284219,6328,No,Yes,8679
Georgia,2020/9/18,180.3353319,1951,62,286170,6390,No,Yes,8679
Georgia,2020/9/19,180.3353319,1889,60,288059,6450,No,Yes,8679
Georgia,2020/9/20,180.3353319,1037,3,289096,6453,No,Yes,8679
Georgia,2020/9/21,180.3353319,879,2,289975,6455,No,Yes,8679
Georgia,2020/9/22,180.3353319,955,69,290930,6524,No,Yes,8679
Georgia,2020/9/23,180.3353319,1867,96,292797,6620,No,Yes,8805
Georgia,2020/9/24,180.3353319,1537,47,294334,6667,No,Yes,8805
Georgia,2020/9/25,180.3353319,1755,50,296089,6717,No,Yes,8805
Georgia,2020/9/26,180.3353319,1464,41,297553,6758,No,Yes,8805
Georgia,2020/9/27,180.3353319,768,31,298321,6789,No,Yes,8805
Georgia,2020/9/28,180.3353319,642,14,298963,6803,No,Yes,8805
Georgia,2020/9/29,180.3353319,1056,33,300019,6836,No,Yes,8805
Georgia,2020/9/30,180.3353319,1466,25,301485,6861,No,Yes,7732
Georgia,2020/10/1,180.3353319,1525,42,303010,6903,No,No,7732
Georgia,2020/10/2,180.3353319,1396,42,304406,6945,No,No,7732
Georgia,2020/10/3,180.3353319,1535,27,305941,6972,No,No,7732
Georgia,2020/10/4,180.3353319,837,27,306778,6999,No,No,7732
Georgia,2020/10/5,180.3353319,21349,29,328127,7028,No,No,7732
Georgia,2020/10/6,180.3353319,974,34,329101,7062,No,No,7732
Georgia,2020/10/7,180.3353319,1668,27,330769,7089,No,No,8581
Georgia,2020/10/8,180.3353319,1373,36,332142,7125,No,No,8581
Georgia,2020/10/9,180.3353319,1792,53,333934,7178,No,No,8581
Georgia,2020/10/10,180.3353319,1417,45,335351,7223,No,No,8581
Georgia,2020/10/11,180.3353319,1235,23,336586,7246,No,No,8581
Georgia,2020/10/12,180.3353319,2991,13,339577,7259,No,No,8581
Georgia,2020/10/13,180.3353319,1181,23,340758,7282,No,No,8581
Georgia,2020/10/14,180.3353319,1544,16,342302,7298,No,No,7964
Georgia,2020/10/15,180.3353319,1791,22,344093,7320,No,No,7964
Georgia,2020/10/16,180.3353319,1786,62,345879,7382,No,No,7964
Georgia,2020/10/17,180.3353319,1589,47,347468,7429,No,No,7964
Georgia,2020/10/18,180.3353319,1305,31,348773,7460,No,No,7964
Georgia,2020/10/19,180.3353319,1881,19,350654,7479,No,No,7964
Georgia,2020/10/20,180.3353319,1336,15,351990,7494,No,No,7964
Georgia,2020/10/21,180.3353319,1459,29,353449,7523,No,No,7126
Georgia,2020/10/22,180.3353319,1707,24,355156,7547,No,No,7126
Georgia,2020/10/23,180.3353319,2163,37,357319,7584,No,No,7126
Georgia,2020/10/24,180.3353319,1682,41,359001,7625,No,No,7126
Georgia,2020/10/25,180.3353319,1343,1,360344,7626,No,No,7126
Georgia,2020/10/26,180.3353319,3931,18,364275,7644,No,No,7126
Georgia,2020/10/27,180.3353319,1223,17,365498,7661,No,No,7126
Georgia,2020/10/28,180.3353319,1628,31,367126,7692,No,No,7060
Georgia,2020/10/29,180.3353319,1714,45,368840,7737,No,No,7060
Georgia,2020/10/30,180.3353319,1317,31,370157,7768,No,No,7060
Georgia,2020/10/31,180.3353319,2474,22,372631,7790,No,No,7060
Georgia,2020/11/1,180.3353319,1069,2,373700,7792,No,No,7060
Georgia,2020/11/2,180.3353319,3561,18,377261,7810,No,No,7060
Georgia,2020/11/3,180.3353319,1633,27,378894,7837,No,No,7060
Georgia,2020/11/4,180.3353319,3219,466,382113,8303,No,No,8764
Georgia,2020/11/5,180.3353319,2418,56,384531,8359,No,No,8764
Georgia,2020/11/6,180.3353319,2671,30,387202,8389,No,No,8764
Georgia,2020/11/7,180.3353319,2055,38,389257,8427,No,No,8764
Georgia,2020/11/8,180.3353319,1360,1,390617,8428,No,No,8764
Georgia,2020/11/9,180.3353319,1629,29,392246,8457,No,No,8764
Georgia,2020/11/10,180.3353319,4252,50,396498,8507,No,No,8764
Georgia,2020/11/11,180.3353319,2271,75,398769,8582,No,No,9262
Georgia,2020/11/12,180.3353319,2981,73,401750,8655,No,No,9262
Georgia,2020/11/13,180.3353319,2827,23,404577,8678,No,No,9262
Georgia,2020/11/14,180.3353319,3019,51,407596,8729,No,No,9262
Georgia,2020/11/15,180.3353319,1908,1,409504,8730,No,No,9262
Georgia,2020/11/16,180.3353319,1077,10,410581,8740,No,No,9262
Georgia,2020/11/17,180.3353319,4240,38,414821,8778,No,No,9262
Georgia,2020/11/18,180.3353319,3113,55,417934,8833,No,No,11813
Georgia,2020/11/19,180.3353319,3447,34,421381,8867,No,No,11813
Georgia,2020/11/20,180.3353319,3378,37,424759,8904,No,No,11813
Georgia,2020/11/21,180.3353319,5928,36,430687,8940,No,No,11813
Georgia,2020/11/22,180.3353319,2267,15,432954,8955,No,No,11813
Georgia,2020/11/23,180.3353319,1962,17,434916,8972,No,No,11813
Georgia,2020/11/24,180.3353319,3525,7,438441,8979,No,No,11813
Georgia,2020/11/25,180.3353319,3296,75,441737,9054,No,No,7061
Georgia,2020/11/26,180.3353319,3467,35,445204,9089,No,No,7061
Georgia,2020/11/27,180.3353319,2738,41,447942,9130,No,No,7061
Georgia,2020/11/28,180.3353319,2685,43,450627,9173,No,No,7061
Georgia,2020/11/29,180.3353319,1695,16,452322,9189,No,No,7061
Georgia,2020/11/30,180.3353319,2006,9,454328,9198,No,No,7061
Georgia,2020/12/1,180.3353319,4657,55,458985,9253,No,No,7061
Georgia,2020/12/2,180.3353319,5432,48,464417,9301,No,No,7656
Georgia,2020/12/3,180.3353319,5538,76,469955,9377,No,No,7656
Georgia,2020/12/4,180.3353319,6226,66,476181,9443,No,No,7656
Georgia,2020/12/5,180.3353319,4945,63,481126,9506,No,No,7656
Georgia,2020/12/6,180.3353319,1980,10,483106,9516,No,No,7656
Georgia,2020/12/7,180.3353319,5119,43,488225,9559,No,No,7656
Georgia,2020/12/8,180.3353319,5333,23,493558,9582,No,No,7656
Georgia,2020/12/9,180.3353319,5741,48,499299,9630,No,No,7568
Georgia,2020/12/10,180.3353319,7503,53,506802,9683,No,No,7568
Georgia,2020/12/11,180.3353319,5913,55,512715,9738,No,No,7568
Georgia,2020/12/12,180.3353319,6258,41,518973,9779,No,No,7568
Georgia,2020/12/13,180.3353319,4607,2,523580,9781,No,No,7568
Georgia,2020/12/14,180.3353319,3577,22,527157,9803,No,No,7568
Georgia,2020/12/15,180.3353319,7331,53,534488,9856,No,No,7568
Georgia,2020/12/16,180.3353319,6598,57,541086,9913,No,No,7543
Georgia,2020/12/17,180.3353319,7560,61,548646,9974,No,No,7543
Georgia,2020/12/18,180.3353319,7969,35,556615,10009,No,No,7543
Georgia,2020/12/19,180.3353319,5864,45,562479,10054,No,No,7543
Georgia,2020/12/20,180.3353319,5175,2,567654,10056,No,No,7543
Georgia,2020/12/21,180.3353319,3647,16,571301,10072,No,No,7543
Georgia,2020/12/22,180.3353319,8656,63,579957,10135,No,No,7543
Georgia,2020/12/23,180.3353319,7515,58,587472,10193,No,No,5506
Georgia,2020/12/24,180.3353319,10281,63,597753,10256,No,No,5506
Georgia,2020/12/25,180.3353319,5493,47,603246,10303,No,No,5506
Georgia,2020/12/26,180.3353319,3887,49,607133,10352,No,No,5506
Georgia,2020/12/27,180.3353319,3441,4,610574,10356,No,No,5506
Georgia,2020/12/28,180.3353319,4142,7,614716,10363,No,No,5506
Georgia,2020/12/29,180.3353319,9185,76,623901,10439,No,No,5506
Georgia,2020/12/30,180.3353319,8960,64,632861,10503,No,No,10986
Georgia,2020/12/31,180.3353319,11204,85,644065,10588,No,No,10986
Georgia,2021/1/1,180.3353319,10885,22,654950,10610,No,No,10986
Georgia,2021/1/2,180.3353319,7127,2,662077,10612,No,No,10986
Georgia,2021/1/3,180.3353319,5628,4,667705,10616,No,No,10986
Georgia,2021/1/4,180.3353319,5144,7,672849,10623,No,No,10986
Georgia,2021/1/5,180.3353319,9900,102,682749,10725,No,No,10986
Georgia,2021/1/6,180.3353319,7388,89,690137,10814,No,No,14084
Georgia,2021/1/7,180.3353319,9669,64,699806,10878,No,No,14084
Georgia,2021/1/8,180.3353319,12979,80,712785,10958,No,No,14084
Georgia,2021/1/9,180.3353319,11532,138,724317,11096,No,No,14084
Georgia,2021/1/10,180.3353319,7804,1,732121,11097,No,No,14084
Georgia,2021/1/11,180.3353319,7957,16,740078,11113,No,No,14084
Georgia,2021/1/12,180.3353319,9339,184,749417,11297,No,No,14084
Georgia,2021/1/13,180.3353319,8576,138,757993,11435,No,No,11980
Georgia,2021/1/14,180.3353319,8924,164,766917,11599,No,No,11980
Georgia,2021/1/15,180.3353319,9568,158,776485,11757,No,No,11980
Georgia,2021/1/16,180.3353319,8563,143,785048,11900,No,No,11980
Georgia,2021/1/17,180.3353319,6274,6,791322,11906,No,No,11980
Georgia,2021/1/18,180.3353319,4985,61,796307,11967,No,No,11980
Georgia,2021/1/19,180.3353319,8201,212,804508,12179,No,No,11980
Georgia,2021/1/20,180.3353319,7946,194,812454,12373,No,No,11615
Georgia,2021/1/21,180.3353319,8059,111,820513,12484,No,No,11615
Georgia,2021/1/22,180.3353319,8510,169,829023,12653,No,No,11615
Georgia,2021/1/23,180.3353319,9034,181,838057,12834,No,No,11615
Georgia,2021/1/24,180.3353319,4741,4,842798,12838,No,No,11615
Georgia,2021/1/25,180.3353319,4238,52,847036,12890,No,No,11615
Georgia,2021/1/26,180.3353319,8452,175,855488,13065,No,No,11615
Georgia,2021/1/27,180.3353319,6342,157,861830,13222,No,No,12664
Georgia,2021/1/28,180.3353319,7335,182,869165,13404,No,No,12664
Georgia,2021/1/29,180.3353319,6349,153,875514,13557,No,No,12664
Georgia,2021/1/30,180.3353319,6226,219,881740,13776,No,No,12664
Georgia,2021/1/31,180.3353319,3509,2,885249,13778,No,No,12664
Georgia,2021/2/1,180.3353319,3213,43,888462,13821,No,No,12664
Georgia,2021/2/2,180.3353319,4979,203,893441,14024,No,No,12664
Georgia,2021/2/3,180.3353319,5198,129,898639,14153,No,No,13464
Georgia,2021/2/4,180.3353319,5811,162,904450,14315,No,No,13464
Georgia,2021/2/5,180.3353319,4720,98,909170,14413,No,No,13464
Georgia,2021/2/6,180.3353319,4426,229,913596,14642,No,No,13464
Georgia,2021/2/7,180.3353319,3467,0,917063,14642,No,No,13464
Georgia,2021/2/8,180.3353319,2715,37,919778,14679,No,No,13464
Georgia,2021/2/9,180.3353319,3766,170,923544,14849,No,No,13464
Georgia,2021/2/10,180.3353319,3403,117,926947,14966,No,No,12087
Georgia,2021/2/11,180.3353319,4096,84,931043,15050,No,No,12087
Georgia,2021/2/12,180.3353319,3831,189,934874,15239,No,No,12087
Georgia,2021/2/13,180.3353319,3703,138,938577,15377,No,No,12087
Georgia,2021/2/14,180.3353319,1874,20,940451,15397,No,No,12087
Georgia,2021/2/15,180.3353319,2033,54,942484,15451,No,No,12087
Georgia,2021/2/16,180.3353319,2855,240,945339,15691,No,No,12087
Georgia,2021/2/17,180.3353319,3380,88,948719,15779,No,No,11395
Georgia,2021/2/18,180.3353319,3414,127,952133,15906,No,No,11395
Georgia,2021/2/19,180.3353319,3591,204,955724,16110,No,No,11395
Georgia,2021/2/20,180.3353319,3274,123,958998,16233,No,No,11395
Georgia,2021/2/21,180.3353319,1699,2,960697,16235,No,No,11395
Georgia,2021/2/22,180.3353319,1518,78,962215,16313,No,No,11395
Georgia,2021/2/23,180.3353319,3916,88,966131,16401,No,No,11395
Georgia,2021/2/24,180.3353319,3472,131,969603,16532,No,No,11395
Georgia,2021/2/25,180.3353319,3381,131,972984,16663,No,No,11395
Georgia,2021/2/26,180.3353319,3416,19,976400,16682,No,No,11395
Georgia,2021/2/27,180.3353319,3283,74,979683,16756,No,No,11395
Georgia,2021/2/28,180.3353319,2161,1,981844,16757,No,No,11395
Georgia,2021/3/1,180.3353319,2035,77,983879,16834,No,No,11395
Georgia,2021/3/2,180.3353319,3089,102,986968,16936,No,No,11395
Georgia,2021/3/3,180.3353319,2730,143,989698,17079,No,No,11395
Georgia,2021/3/4,180.3353319,2701,119,992399,17198,No,No,11395
Hawaii,2020/3/1,219.5150388,0,0,0,0,No,No,1575
Hawaii,2020/3/2,219.5150388,0,0,0,0,No,No,1575
Hawaii,2020/3/3,219.5150388,0,0,0,0,No,No,1575
Hawaii,2020/3/4,219.5150388,0,0,0,0,No,No,1663
Hawaii,2020/3/5,219.5150388,0,0,0,0,No,No,1663
Hawaii,2020/3/6,219.5150388,1,0,1,0,No,No,1663
Hawaii,2020/3/7,219.5150388,0,0,1,0,No,No,1663
Hawaii,2020/3/8,219.5150388,1,0,2,0,No,No,1663
Hawaii,2020/3/9,219.5150388,0,0,2,0,No,No,1663
Hawaii,2020/3/10,219.5150388,0,0,2,0,No,No,1663
Hawaii,2020/3/11,219.5150388,0,0,2,0,No,No,1819
Hawaii,2020/3/12,219.5150388,0,0,2,0,No,No,1819
Hawaii,2020/3/13,219.5150388,0,0,2,0,No,No,1819
Hawaii,2020/3/14,219.5150388,2,0,4,0,No,No,1819
Hawaii,2020/3/15,219.5150388,3,0,7,0,No,No,1819
Hawaii,2020/3/16,219.5150388,3,0,10,0,No,No,1819
Hawaii,2020/3/17,219.5150388,4,0,14,0,No,No,1819
Hawaii,2020/3/18,219.5150388,2,0,16,0,No,No,10892
Hawaii,2020/3/19,219.5150388,10,0,26,0,No,No,10892
Hawaii,2020/3/20,219.5150388,11,0,37,0,No,No,10892
Hawaii,2020/3/21,219.5150388,11,0,48,0,No,No,10892
Hawaii,2020/3/22,219.5150388,8,0,56,0,No,No,10892
Hawaii,2020/3/23,219.5150388,21,0,77,0,No,No,10892
Hawaii,2020/3/24,219.5150388,13,0,90,0,No,No,10892
Hawaii,2020/3/25,219.5150388,5,0,95,0,Yes,No,80984
Hawaii,2020/3/26,219.5150388,11,0,106,0,Yes,No,80984
Hawaii,2020/3/27,219.5150388,14,0,120,0,Yes,No,80984
Hawaii,2020/3/28,219.5150388,31,0,151,0,Yes,No,80984
Hawaii,2020/3/29,219.5150388,24,0,175,0,Yes,No,80984
Hawaii,2020/3/30,219.5150388,29,0,204,0,Yes,No,80984
Hawaii,2020/3/31,219.5150388,20,1,224,1,Yes,No,80984
Hawaii,2020/4/1,219.5150388,34,0,258,1,Yes,No,106739
Hawaii,2020/4/2,219.5150388,25,1,283,2,Yes,No,106739
Hawaii,2020/4/3,219.5150388,34,1,317,3,Yes,No,106739
Hawaii,2020/4/4,219.5150388,32,0,349,3,Yes,No,106739
Hawaii,2020/4/5,219.5150388,20,1,369,4,Yes,No,106739
Hawaii,2020/4/6,219.5150388,16,1,385,5,Yes,No,106739
Hawaii,2020/4/7,219.5150388,23,0,408,5,Yes,No,106739
Hawaii,2020/4/8,219.5150388,25,0,433,5,Yes,No,77515
Hawaii,2020/4/9,219.5150388,7,1,440,6,Yes,No,77515
Hawaii,2020/4/10,219.5150388,23,2,463,8,Yes,No,77515
Hawaii,2020/4/11,219.5150388,21,0,484,8,Yes,No,77515
Hawaii,2020/4/12,219.5150388,13,1,497,9,Yes,No,77515
Hawaii,2020/4/13,219.5150388,5,0,502,9,Yes,No,77515
Hawaii,2020/4/14,219.5150388,9,0,511,9,Yes,No,77515
Hawaii,2020/4/15,219.5150388,13,0,524,9,Yes,No,66432
Hawaii,2020/4/16,219.5150388,11,0,535,9,Yes,No,66432
Hawaii,2020/4/17,219.5150388,12,0,547,9,Yes,No,66432
Hawaii,2020/4/18,219.5150388,21,0,568,9,Yes,No,66432
Hawaii,2020/4/19,219.5150388,6,1,574,10,Yes,No,66432
Hawaii,2020/4/20,219.5150388,4,0,578,10,Yes,No,66432
Hawaii,2020/4/21,219.5150388,2,2,580,12,Yes,No,66432
Hawaii,2020/4/22,219.5150388,6,0,586,12,Yes,No,74966
Hawaii,2020/4/23,219.5150388,4,0,590,12,Yes,No,74966
Hawaii,2020/4/24,219.5150388,5,1,595,13,Yes,No,74966
Hawaii,2020/4/25,219.5150388,2,1,597,14,Yes,No,74966
Hawaii,2020/4/26,219.5150388,2,0,599,14,Yes,No,74966
Hawaii,2020/4/27,219.5150388,1,2,600,16,Yes,No,74966
Hawaii,2020/4/28,219.5150388,2,0,602,16,Yes,No,74966
Hawaii,2020/4/29,219.5150388,3,0,605,16,Yes,No,28985
Hawaii,2020/4/30,219.5150388,4,0,609,16,Yes,No,28985
Hawaii,2020/5/1,219.5150388,1,0,610,16,Yes,No,28985
Hawaii,2020/5/2,219.5150388,1,0,611,16,Yes,No,28985
Hawaii,2020/5/3,219.5150388,0,1,611,17,Yes,No,28985
Hawaii,2020/5/4,219.5150388,1,0,612,17,Yes,No,28985
Hawaii,2020/5/5,219.5150388,3,0,615,17,Yes,No,28985
Hawaii,2020/5/6,219.5150388,1,0,616,17,Yes,No,26666
Hawaii,2020/5/7,219.5150388,3,0,619,17,Yes,No,26666
Hawaii,2020/5/8,219.5150388,0,0,619,17,Yes,No,26666
Hawaii,2020/5/9,219.5150388,1,0,620,17,Yes,No,26666
Hawaii,2020/5/10,219.5150388,1,0,621,17,Yes,No,26666
Hawaii,2020/5/11,219.5150388,2,0,623,17,Yes,No,26666
Hawaii,2020/5/12,219.5150388,1,0,624,17,Yes,No,26666
Hawaii,2020/5/13,219.5150388,3,0,627,17,Yes,No,25150
Hawaii,2020/5/14,219.5150388,0,0,627,17,Yes,No,25150
Hawaii,2020/5/15,219.5150388,1,0,628,17,Yes,No,25150
Hawaii,2020/5/16,219.5150388,1,0,629,17,Yes,No,25150
Hawaii,2020/5/17,219.5150388,1,0,630,17,Yes,No,25150
Hawaii,2020/5/18,219.5150388,0,0,630,17,Yes,No,25150
Hawaii,2020/5/19,219.5150388,1,0,631,17,Yes,No,25150
Hawaii,2020/5/20,219.5150388,2,0,633,17,Yes,No,27919
Hawaii,2020/5/21,219.5150388,4,0,637,17,Yes,No,27919
Hawaii,2020/5/22,219.5150388,-5,0,632,17,Yes,No,27919
Hawaii,2020/5/23,219.5150388,1,0,633,17,Yes,No,27919
Hawaii,2020/5/24,219.5150388,0,0,633,17,Yes,No,27919
Hawaii,2020/5/25,219.5150388,0,0,633,17,Yes,No,27919
Hawaii,2020/5/26,219.5150388,0,0,633,17,Yes,No,27919
Hawaii,2020/5/27,219.5150388,1,0,634,17,Yes,No,21335
Hawaii,2020/5/28,219.5150388,3,0,637,17,Yes,No,21335
Hawaii,2020/5/29,219.5150388,2,0,639,17,Yes,No,21335
Hawaii,2020/5/30,219.5150388,2,0,641,17,Yes,No,21335
Hawaii,2020/5/31,219.5150388,1,0,642,17,Yes,No,21335
Hawaii,2020/6/1,219.5150388,0,0,642,17,No,No,21335
Hawaii,2020/6/2,219.5150388,1,0,643,17,No,No,21335
Hawaii,2020/6/3,219.5150388,0,0,643,17,No,No,19949
Hawaii,2020/6/4,219.5150388,1,0,644,17,No,No,19949
Hawaii,2020/6/5,219.5150388,9,0,653,17,No,No,19949
Hawaii,2020/6/6,219.5150388,8,0,661,17,No,No,19949
Hawaii,2020/6/7,219.5150388,2,0,663,17,No,No,19949
Hawaii,2020/6/8,219.5150388,1,0,664,17,No,No,19949
Hawaii,2020/6/9,219.5150388,6,0,670,17,No,No,19949
Hawaii,2020/6/10,219.5150388,3,0,673,17,No,No,18367
Hawaii,2020/6/11,219.5150388,7,0,680,17,No,No,18367
Hawaii,2020/6/12,219.5150388,14,0,694,17,No,No,18367
Hawaii,2020/6/13,219.5150388,17,0,711,17,No,No,18367
Hawaii,2020/6/14,219.5150388,5,0,716,17,No,No,18367
Hawaii,2020/6/15,219.5150388,8,0,724,17,No,No,18367
Hawaii,2020/6/16,219.5150388,4,0,728,17,No,No,18367
Hawaii,2020/6/17,219.5150388,4,0,732,17,No,No,18671
Hawaii,2020/6/18,219.5150388,18,0,750,17,No,No,18671
Hawaii,2020/6/19,219.5150388,27,0,777,17,No,No,18671
Hawaii,2020/6/20,219.5150388,14,0,791,17,No,No,18671
Hawaii,2020/6/21,219.5150388,11,0,802,17,No,No,18671
Hawaii,2020/6/22,219.5150388,2,0,804,17,No,No,18671
Hawaii,2020/6/23,219.5150388,3,0,807,17,No,No,18671
Hawaii,2020/6/24,219.5150388,14,0,821,17,No,No,18338
Hawaii,2020/6/25,219.5150388,15,0,836,17,No,No,18338
Hawaii,2020/6/26,219.5150388,14,0,850,17,No,No,18338
Hawaii,2020/6/27,219.5150388,6,1,856,18,No,No,18338
Hawaii,2020/6/28,219.5150388,27,0,883,18,No,No,18338
Hawaii,2020/6/29,219.5150388,1,0,884,18,No,No,18338
Hawaii,2020/6/30,219.5150388,17,0,901,18,No,No,18338
Hawaii,2020/7/1,219.5150388,8,0,909,18,No,No,19056
Hawaii,2020/7/2,219.5150388,20,0,929,18,No,No,19056
Hawaii,2020/7/3,219.5150388,28,1,957,19,No,No,19056
Hawaii,2020/7/4,219.5150388,24,0,981,19,No,No,19056
Hawaii,2020/7/5,219.5150388,24,0,1005,19,No,No,19056
Hawaii,2020/7/6,219.5150388,7,0,1012,19,No,No,19056
Hawaii,2020/7/7,219.5150388,41,0,1053,19,No,No,19056
Hawaii,2020/7/8,219.5150388,23,0,1076,19,No,No,20563
Hawaii,2020/7/9,219.5150388,36,0,1112,19,No,No,20563
Hawaii,2020/7/10,219.5150388,27,0,1139,19,No,No,20563
Hawaii,2020/7/11,219.5150388,42,0,1181,19,No,No,20563
Hawaii,2020/7/12,219.5150388,20,0,1201,19,No,No,20563
Hawaii,2020/7/13,219.5150388,21,2,1222,21,No,No,20563
Hawaii,2020/7/14,219.5150388,21,0,1243,21,No,No,20563
Hawaii,2020/7/15,219.5150388,28,0,1271,21,No,No,23676
Hawaii,2020/7/16,219.5150388,19,0,1290,21,No,No,23676
Hawaii,2020/7/17,219.5150388,22,1,1312,22,No,No,23676
Hawaii,2020/7/18,219.5150388,20,1,1332,23,No,No,23676
Hawaii,2020/7/19,219.5150388,27,0,1359,23,No,No,23676
Hawaii,2020/7/20,219.5150388,12,0,1371,23,No,No,23676
Hawaii,2020/7/21,219.5150388,25,0,1396,23,No,No,23676
Hawaii,2020/7/22,219.5150388,17,1,1413,24,No,No,17437
Hawaii,2020/7/23,219.5150388,55,1,1468,25,No,No,17437
Hawaii,2020/7/24,219.5150388,58,0,1526,25,No,No,17437
Hawaii,2020/7/25,219.5150388,71,0,1597,25,No,No,17437
Hawaii,2020/7/26,219.5150388,63,0,1660,25,No,No,17437
Hawaii,2020/7/27,219.5150388,28,0,1688,25,No,No,17437
Hawaii,2020/7/28,219.5150388,46,0,1734,25,No,No,17437
Hawaii,2020/7/29,219.5150388,108,0,1842,25,No,No,11690
Hawaii,2020/7/30,219.5150388,124,0,1966,25,No,No,11690
Hawaii,2020/7/31,219.5150388,122,0,2088,25,No,No,11690
Hawaii,2020/8/1,219.5150388,86,0,2174,25,No,No,11690
Hawaii,2020/8/2,219.5150388,45,0,2219,25,No,No,11690
Hawaii,2020/8/3,219.5150388,206,0,2425,25,No,No,11690
Hawaii,2020/8/4,219.5150388,143,1,2568,26,No,No,11690
Hawaii,2020/8/5,219.5150388,172,0,2740,26,No,No,9467
Hawaii,2020/8/6,219.5150388,151,2,2891,28,No,No,9467
Hawaii,2020/8/7,219.5150388,201,2,3092,30,No,No,9467
Hawaii,2020/8/8,219.5150388,231,0,3323,30,No,No,9467
Hawaii,2020/8/9,219.5150388,152,0,3475,30,No,No,9467
Hawaii,2020/8/10,219.5150388,140,3,3615,33,No,No,9467
Hawaii,2020/8/11,219.5150388,118,2,3733,35,No,No,9467
Hawaii,2020/8/12,219.5150388,202,2,3935,37,No,No,11047
Hawaii,2020/8/13,219.5150388,354,2,4289,39,No,No,11047
Hawaii,2020/8/14,219.5150388,231,0,4520,39,No,No,11047
Hawaii,2020/8/15,219.5150388,282,0,4802,39,No,No,11047
Hawaii,2020/8/16,219.5150388,217,0,5019,39,No,No,11047
Hawaii,2020/8/17,219.5150388,173,0,5192,39,No,No,11047
Hawaii,2020/8/18,219.5150388,134,1,5326,40,No,No,11047
Hawaii,2020/8/19,219.5150388,260,1,5586,41,No,No,8676
Hawaii,2020/8/20,219.5150388,235,3,5821,44,No,No,8676
Hawaii,2020/8/21,219.5150388,228,1,6049,45,No,No,8676
Hawaii,2020/8/22,219.5150388,284,1,6333,46,No,No,8676
Hawaii,2020/8/23,219.5150388,244,0,6577,46,No,No,8676
Hawaii,2020/8/24,219.5150388,169,2,6746,48,No,No,8676
Hawaii,2020/8/25,219.5150388,215,0,6961,48,No,No,8676
Hawaii,2020/8/26,219.5150388,275,2,7236,50,No,No,8511
Hawaii,2020/8/27,219.5150388,306,4,7542,54,No,No,8511
Hawaii,2020/8/28,219.5150388,264,4,7806,58,No,No,8511
Hawaii,2020/8/29,219.5150388,309,3,8115,61,No,No,8511
Hawaii,2020/8/30,219.5150388,200,1,8315,62,No,No,8511
Hawaii,2020/8/31,219.5150388,132,7,8447,69,No,No,8511
Hawaii,2020/9/1,219.5150388,181,4,8628,73,No,No,8511
Hawaii,2020/9/2,219.5150388,338,1,8966,74,No,No,8901
Hawaii,2020/9/3,219.5150388,211,4,9177,78,No,No,8901
Hawaii,2020/9/4,219.5150388,271,2,9448,80,No,No,8901
Hawaii,2020/9/5,219.5150388,219,3,9667,83,No,No,8901
Hawaii,2020/9/6,219.5150388,162,1,9829,84,No,No,8901
Hawaii,2020/9/7,219.5150388,104,1,9933,85,No,No,8901
Hawaii,2020/9/8,219.5150388,197,2,10130,87,No,No,8901
Hawaii,2020/9/9,219.5150388,98,3,10228,90,No,No,8848
Hawaii,2020/9/10,219.5150388,169,3,10397,93,No,No,8848
Hawaii,2020/9/11,219.5150388,170,2,10567,95,No,No,8848
Hawaii,2020/9/12,219.5150388,129,1,10696,96,No,No,8848
Hawaii,2020/9/13,219.5150388,112,2,10808,98,No,No,8848
Hawaii,2020/9/14,219.5150388,79,0,10887,98,No,No,8848
Hawaii,2020/9/15,219.5150388,64,1,10951,99,No,No,8848
Hawaii,2020/9/16,219.5150388,101,3,11052,102,No,No,8679
Hawaii,2020/9/17,219.5150388,159,4,11211,106,No,No,8679
Hawaii,2020/9/18,219.5150388,137,13,11348,119,No,No,8679
Hawaii,2020/9/19,219.5150388,109,0,11457,119,No,No,8679
Hawaii,2020/9/20,219.5150388,77,0,11534,119,No,No,8679
Hawaii,2020/9/21,219.5150388,56,0,11590,119,No,No,8679
Hawaii,2020/9/22,219.5150388,63,0,11653,119,No,No,8679
Hawaii,2020/9/23,219.5150388,167,2,11820,121,No,No,8805
Hawaii,2020/9/24,219.5150388,88,2,11908,123,No,No,8805
Hawaii,2020/9/25,219.5150388,131,3,12039,126,No,No,8805
Hawaii,2020/9/26,219.5150388,127,4,12166,130,No,No,8805
Hawaii,2020/9/27,219.5150388,98,1,12264,131,No,No,8805
Hawaii,2020/9/28,219.5150388,87,0,12351,131,No,No,8805
Hawaii,2020/9/29,219.5150388,85,2,12436,133,No,No,8805
Hawaii,2020/9/30,219.5150388,119,2,12555,135,No,No,7732
Hawaii,2020/10/1,219.5150388,105,3,12660,138,No,No,7732
Hawaii,2020/10/2,219.5150388,94,3,12754,141,No,No,7732
Hawaii,2020/10/3,219.5150388,133,11,12887,152,No,No,7732
Hawaii,2020/10/4,219.5150388,70,3,12957,155,No,No,7732
Hawaii,2020/10/5,219.5150388,50,1,13007,156,No,No,7732
Hawaii,2020/10/6,219.5150388,83,3,13090,159,No,No,7732
Hawaii,2020/10/7,219.5150388,106,3,13196,162,No,No,8581
Hawaii,2020/10/8,219.5150388,101,1,13297,163,No,No,8581
Hawaii,2020/10/9,219.5150388,164,2,13461,165,No,No,8581
Hawaii,2020/10/10,219.5150388,71,2,13532,167,No,No,8581
Hawaii,2020/10/11,219.5150388,101,1,13633,168,No,No,8581
Hawaii,2020/10/12,219.5150388,42,0,13675,168,No,No,8581
Hawaii,2020/10/13,219.5150388,61,4,13736,172,No,No,8581
Hawaii,2020/10/14,219.5150388,98,10,13834,182,No,No,7964
Hawaii,2020/10/15,219.5150388,88,1,13922,183,No,No,7964
Hawaii,2020/10/16,219.5150388,85,1,14007,184,No,No,7964
Hawaii,2020/10/17,219.5150388,94,1,14101,185,No,No,7964
Hawaii,2020/10/18,219.5150388,82,1,14183,186,No,No,7964
Hawaii,2020/10/19,219.5150388,35,0,14218,186,No,No,7964
Hawaii,2020/10/20,219.5150388,84,2,14302,188,No,No,7964
Hawaii,2020/10/21,219.5150388,77,14,14379,202,No,No,7126
Hawaii,2020/10/22,219.5150388,99,3,14478,205,No,No,7126
Hawaii,2020/10/23,219.5150388,139,3,14617,208,No,No,7126
Hawaii,2020/10/24,219.5150388,89,3,14706,211,No,No,7126
Hawaii,2020/10/25,219.5150388,117,0,14823,211,No,No,7126
Hawaii,2020/10/26,219.5150388,35,0,14858,211,No,No,7126
Hawaii,2020/10/27,219.5150388,62,3,14920,214,No,No,7126
Hawaii,2020/10/28,219.5150388,55,-2,14975,212,No,No,7060
Hawaii,2020/10/29,219.5150388,71,2,15046,214,No,No,7060
Hawaii,2020/10/30,219.5150388,99,1,15145,215,No,No,7060
Hawaii,2020/10/31,219.5150388,62,3,15207,218,No,No,7060
Hawaii,2020/11/1,219.5150388,80,0,15287,218,No,No,7060
Hawaii,2020/11/2,219.5150388,72,0,15359,218,No,No,7060
Hawaii,2020/11/3,219.5150388,82,0,15441,218,No,No,7060
Hawaii,2020/11/4,219.5150388,150,0,15591,218,No,No,8764
Hawaii,2020/11/5,219.5150388,92,0,15683,218,No,No,8764
Hawaii,2020/11/6,219.5150388,133,0,15816,218,No,No,8764
Hawaii,2020/11/7,219.5150388,123,1,15939,219,No,No,8764
Hawaii,2020/11/8,219.5150388,127,1,16066,220,No,No,8764
Hawaii,2020/11/9,219.5150388,58,0,16124,220,No,No,8764
Hawaii,2020/11/10,219.5150388,69,1,16193,221,No,No,8764
Hawaii,2020/11/11,219.5150388,116,0,16309,221,No,No,9262
Hawaii,2020/11/12,219.5150388,94,0,16403,221,No,No,9262
Hawaii,2020/11/13,219.5150388,111,0,16514,221,No,No,9262
Hawaii,2020/11/14,219.5150388,105,0,16619,221,No,No,9262
Hawaii,2020/11/15,219.5150388,0,0,16619,221,No,No,9262
Hawaii,2020/11/16,219.5150388,92,0,16711,221,No,No,9262
Hawaii,2020/11/17,219.5150388,44,0,16755,221,No,No,9262
Hawaii,2020/11/18,219.5150388,62,1,16817,222,No,No,11813
Hawaii,2020/11/19,219.5150388,100,0,16917,222,No,No,11813
Hawaii,2020/11/20,219.5150388,112,0,17029,222,No,No,11813
Hawaii,2020/11/21,219.5150388,153,7,17182,229,No,No,11813
Hawaii,2020/11/22,219.5150388,120,2,17302,231,No,No,11813
Hawaii,2020/11/23,219.5150388,103,0,17405,231,No,No,11813
Hawaii,2020/11/24,219.5150388,56,0,17461,231,No,No,11813
Hawaii,2020/11/25,219.5150388,100,2,17561,233,No,No,7061
Hawaii,2020/11/26,219.5150388,117,2,17678,235,No,No,7061
Hawaii,2020/11/27,219.5150388,118,3,17796,238,No,No,7061
Hawaii,2020/11/28,219.5150388,75,0,17871,238,No,No,7061
Hawaii,2020/11/29,219.5150388,54,4,17925,242,No,No,7061
Hawaii,2020/11/30,219.5150388,81,0,18006,242,No,No,7061
Hawaii,2020/12/1,219.5150388,43,0,18049,242,No,No,7061
Hawaii,2020/12/2,219.5150388,68,0,18117,242,No,No,7656
Hawaii,2020/12/3,219.5150388,139,2,18256,244,No,No,7656
Hawaii,2020/12/4,219.5150388,117,10,18373,254,No,No,7656
Hawaii,2020/12/5,219.5150388,111,5,18484,259,No,No,7656
Hawaii,2020/12/6,219.5150388,97,1,18581,260,No,No,7656
Hawaii,2020/12/7,219.5150388,78,0,18659,260,No,No,7656
Hawaii,2020/12/8,219.5150388,53,0,18712,260,No,No,7656
Hawaii,2020/12/9,219.5150388,73,4,18785,264,No,No,7568
Hawaii,2020/12/10,219.5150388,116,2,18901,266,No,No,7568
Hawaii,2020/12/11,219.5150388,128,1,19029,267,No,No,7568
Hawaii,2020/12/12,219.5150388,196,2,19225,269,No,No,7568
Hawaii,2020/12/13,219.5150388,77,3,19302,272,No,No,7568
Hawaii,2020/12/14,219.5150388,187,0,19489,272,No,No,7568
Hawaii,2020/12/15,219.5150388,52,0,19541,272,No,No,7568
Hawaii,2020/12/16,219.5150388,104,4,19645,276,No,No,7543
Hawaii,2020/12/17,219.5150388,136,2,19781,278,No,No,7543
Hawaii,2020/12/18,219.5150388,156,1,19937,279,No,No,7543
Hawaii,2020/12/19,219.5150388,152,0,20089,279,No,No,7543
Hawaii,2020/12/20,219.5150388,202,1,20291,280,No,No,7543
Hawaii,2020/12/21,219.5150388,132,0,20423,280,No,No,7543
Hawaii,2020/12/22,219.5150388,64,0,20487,280,No,No,7543
Hawaii,2020/12/23,219.5150388,95,3,20582,283,No,No,5506
Hawaii,2020/12/24,219.5150388,125,0,20707,283,No,No,5506
Hawaii,2020/12/25,219.5150388,154,0,20861,283,No,No,5506
Hawaii,2020/12/26,219.5150388,109,0,20970,283,No,No,5506
Hawaii,2020/12/27,219.5150388,94,0,21064,283,No,No,5506
Hawaii,2020/12/28,219.5150388,45,0,21109,283,No,No,5506
Hawaii,2020/12/29,219.5150388,71,0,21180,283,No,No,5506
Hawaii,2020/12/30,219.5150388,104,0,21284,283,No,No,10986
Hawaii,2020/12/31,219.5150388,175,3,21459,286,No,No,10986
Hawaii,2021/1/1,219.5150388,277,1,21736,287,No,No,10986
Hawaii,2021/1/2,219.5150388,159,0,21895,287,No,No,10986
Hawaii,2021/1/3,219.5150388,122,0,22017,287,No,No,10986
Hawaii,2021/1/4,219.5150388,75,0,22092,287,No,No,10986
Hawaii,2021/1/5,219.5150388,107,0,22199,287,No,No,10986
Hawaii,2021/1/6,219.5150388,126,10,22325,297,No,No,14084
Hawaii,2021/1/7,219.5150388,286,0,22611,297,No,No,14084
Hawaii,2021/1/8,219.5150388,283,4,22894,301,No,No,14084
Hawaii,2021/1/9,219.5150388,228,4,23122,305,No,No,14084
Hawaii,2021/1/10,219.5150388,178,1,23300,306,No,No,14084
Hawaii,2021/1/11,219.5150388,162,0,23462,306,No,No,14084
Hawaii,2021/1/12,219.5150388,108,0,23570,306,No,No,14084
Hawaii,2021/1/13,219.5150388,93,3,23663,309,No,No,11980
Hawaii,2021/1/14,219.5150388,164,6,23827,315,No,No,11980
Hawaii,2021/1/15,219.5150388,205,0,24032,315,No,No,11980
Hawaii,2021/1/16,219.5150388,156,2,24188,317,No,No,11980
Hawaii,2021/1/17,219.5150388,121,2,24309,319,No,No,11980
Hawaii,2021/1/18,219.5150388,115,0,24424,319,No,No,11980
Hawaii,2021/1/19,219.5150388,59,2,24483,321,No,No,11980
Hawaii,2021/1/20,219.5150388,68,1,24551,322,No,No,11615
Hawaii,2021/1/21,219.5150388,112,3,24663,325,No,No,11615
Hawaii,2021/1/22,219.5150388,160,4,24823,329,No,No,11615
Hawaii,2021/1/23,219.5150388,127,4,24950,333,No,No,11615
Hawaii,2021/1/24,219.5150388,143,6,25093,339,No,No,11615
Hawaii,2021/1/25,219.5150388,116,0,25209,339,No,No,11615
Hawaii,2021/1/26,219.5150388,63,59,25272,398,No,No,11615
Hawaii,2021/1/27,219.5150388,94,3,25366,401,No,No,12664
Hawaii,2021/1/28,219.5150388,94,2,25460,403,No,No,12664
Hawaii,2021/1/29,219.5150388,139,1,25599,404,No,No,12664
Hawaii,2021/1/30,219.5150388,109,0,25708,404,No,No,12664
Hawaii,2021/1/31,219.5150388,78,3,25786,407,No,No,12664
Hawaii,2021/2/1,219.5150388,84,0,25870,407,No,No,12664
Hawaii,2021/2/2,219.5150388,62,0,25932,407,No,No,12664
Hawaii,2021/2/3,219.5150388,68,4,26000,411,No,No,13464
Hawaii,2021/2/4,219.5150388,101,2,26101,413,No,No,13464
Hawaii,2021/2/5,219.5150388,120,0,26221,413,No,No,13464
Hawaii,2021/2/6,219.5150388,104,0,26325,413,No,No,13464
Hawaii,2021/2/7,219.5150388,73,2,26398,415,No,No,13464
Hawaii,2021/2/8,219.5150388,30,0,26428,415,No,No,13464
Hawaii,2021/2/9,219.5150388,28,0,26456,415,No,No,13464
Hawaii,2021/2/10,219.5150388,51,5,26507,420,No,No,12087
Hawaii,2021/2/11,219.5150388,84,1,26591,421,No,No,12087
Hawaii,2021/2/12,219.5150388,81,1,26672,422,No,No,12087
Hawaii,2021/2/13,219.5150388,57,0,26729,422,No,No,12087
Hawaii,2021/2/14,219.5150388,43,1,26772,423,No,No,12087
Hawaii,2021/2/15,219.5150388,31,0,26803,423,No,No,12087
Hawaii,2021/2/16,219.5150388,16,0,26819,423,No,No,12087
Hawaii,2021/2/17,219.5150388,27,1,26846,424,No,No,11395
Hawaii,2021/2/18,219.5150388,60,1,26906,425,No,No,11395
Hawaii,2021/2/19,219.5150388,56,2,26962,427,No,No,11395
Hawaii,2021/2/20,219.5150388,49,0,27011,427,No,No,11395
Hawaii,2021/2/21,219.5150388,64,1,27075,428,No,No,11395
Hawaii,2021/2/22,219.5150388,49,0,27124,428,No,No,11395
Hawaii,2021/2/23,219.5150388,44,0,27168,428,No,No,11395
Hawaii,2021/2/24,219.5150388,43,4,27211,432,No,No,11395
Hawaii,2021/2/25,219.5150388,36,0,27247,432,No,No,11395
Hawaii,2021/2/26,219.5150388,73,2,27320,434,No,No,11395
Hawaii,2021/2/27,219.5150388,99,2,27419,436,No,No,11395
Hawaii,2021/2/28,219.5150388,54,0,27473,436,No,No,11395
Hawaii,2021/3/1,219.5150388,26,0,27499,436,No,No,11395
Hawaii,2021/3/2,219.5150388,33,0,27532,436,No,No,11395
Hawaii,2021/3/3,219.5150388,17,2,27549,438,No,No,11395
Hawaii,2021/3/4,219.5150388,55,0,27604,438,No,No,11395
Idaho,2020/3/1,21.38737628,0,0,0,0,No,No,1575
Idaho,2020/3/2,21.38737628,0,0,0,0,No,No,1575
Idaho,2020/3/3,21.38737628,0,0,0,0,No,No,1575
Idaho,2020/3/4,21.38737628,0,0,0,0,No,No,1663
Idaho,2020/3/5,21.38737628,0,0,0,0,No,No,1663
Idaho,2020/3/6,21.38737628,0,0,0,0,No,No,1663
Idaho,2020/3/7,21.38737628,0,0,0,0,No,No,1663
Idaho,2020/3/8,21.38737628,0,0,0,0,No,No,1663
Idaho,2020/3/9,21.38737628,0,0,0,0,No,No,1663
Idaho,2020/3/10,21.38737628,0,0,0,0,No,No,1663
Idaho,2020/3/11,21.38737628,0,0,0,0,No,No,1819
Idaho,2020/3/12,21.38737628,0,0,0,0,No,No,1819
Idaho,2020/3/13,21.38737628,1,0,1,0,No,No,1819
Idaho,2020/3/14,21.38737628,4,0,5,0,No,No,1819
Idaho,2020/3/15,21.38737628,0,0,5,0,No,No,1819
Idaho,2020/3/16,21.38737628,0,0,5,0,No,No,1819
Idaho,2020/3/17,21.38737628,4,0,9,0,No,No,1819
Idaho,2020/3/18,21.38737628,2,0,11,0,No,No,10892
Idaho,2020/3/19,21.38737628,12,0,23,0,No,No,10892
Idaho,2020/3/20,21.38737628,8,0,31,0,No,No,10892
Idaho,2020/3/21,21.38737628,11,0,42,0,No,No,10892
Idaho,2020/3/22,21.38737628,5,0,47,0,No,No,10892
Idaho,2020/3/23,21.38737628,3,0,50,0,No,No,10892
Idaho,2020/3/24,21.38737628,23,0,73,0,No,No,10892
Idaho,2020/3/25,21.38737628,50,0,123,0,Yes,No,80984
Idaho,2020/3/26,21.38737628,66,3,189,3,Yes,No,80984
Idaho,2020/3/27,21.38737628,43,1,232,4,Yes,No,80984
Idaho,2020/3/28,21.38737628,30,1,262,5,Yes,No,80984
Idaho,2020/3/29,21.38737628,48,1,310,6,Yes,No,80984
Idaho,2020/3/30,21.38737628,105,1,415,7,Yes,No,80984
Idaho,2020/3/31,21.38737628,111,2,526,9,Yes,No,80984
Idaho,2020/4/1,21.38737628,143,0,669,9,Yes,No,106739
Idaho,2020/4/2,21.38737628,222,0,891,9,Yes,No,106739
Idaho,2020/4/3,21.38737628,121,1,1012,10,Yes,No,106739
Idaho,2020/4/4,21.38737628,64,0,1076,10,Yes,No,106739
Idaho,2020/4/5,21.38737628,24,0,1100,10,Yes,No,106739
Idaho,2020/4/6,21.38737628,70,3,1170,13,Yes,No,106739
Idaho,2020/4/7,21.38737628,40,2,1210,15,Yes,No,106739
Idaho,2020/4/8,21.38737628,22,4,1232,19,Yes,No,77515
Idaho,2020/4/9,21.38737628,134,5,1366,24,Yes,No,77515
Idaho,2020/4/10,21.38737628,59,1,1425,25,Yes,No,77515
Idaho,2020/4/11,21.38737628,13,2,1438,27,Yes,No,77515
Idaho,2020/4/12,21.38737628,19,0,1457,27,Yes,No,77515
Idaho,2020/4/13,21.38737628,42,6,1499,33,Yes,No,77515
Idaho,2020/4/14,21.38737628,39,6,1538,39,Yes,No,77515
Idaho,2020/4/15,21.38737628,49,2,1587,41,Yes,No,66432
Idaho,2020/4/16,21.38737628,22,0,1609,41,Yes,No,66432
Idaho,2020/4/17,21.38737628,46,2,1655,43,Yes,No,66432
Idaho,2020/4/18,21.38737628,13,1,1668,44,Yes,No,66432
Idaho,2020/4/19,21.38737628,4,1,1672,45,Yes,No,66432
Idaho,2020/4/20,21.38737628,64,3,1736,48,Yes,No,66432
Idaho,2020/4/21,21.38737628,30,3,1766,51,Yes,No,66432
Idaho,2020/4/22,21.38737628,36,3,1802,54,Yes,No,74966
Idaho,2020/4/23,21.38737628,34,0,1836,54,Yes,No,74966
Idaho,2020/4/24,21.38737628,34,0,1870,54,Yes,No,74966
Idaho,2020/4/25,21.38737628,17,2,1887,56,Yes,No,74966
Idaho,2020/4/26,21.38737628,10,0,1897,56,Yes,No,74966
Idaho,2020/4/27,21.38737628,20,2,1917,58,Yes,No,74966
Idaho,2020/4/28,21.38737628,35,2,1952,60,Yes,No,74966
Idaho,2020/4/29,21.38737628,32,0,1984,60,Yes,No,28985
Idaho,2020/4/30,21.38737628,32,3,2016,63,Yes,No,28985
Idaho,2020/5/1,21.38737628,19,0,2035,63,No,No,28985
Idaho,2020/5/2,21.38737628,26,1,2061,64,No,No,28985
Idaho,2020/5/3,21.38737628,-2,0,2059,64,No,No,28985
Idaho,2020/5/4,21.38737628,47,0,2106,64,No,No,28985
Idaho,2020/5/5,21.38737628,21,2,2127,66,No,No,28985
Idaho,2020/5/6,21.38737628,31,1,2158,67,No,No,26666
Idaho,2020/5/7,21.38737628,20,0,2178,67,No,No,26666
Idaho,2020/5/8,21.38737628,27,0,2205,67,No,No,26666
Idaho,2020/5/9,21.38737628,25,0,2230,67,No,No,26666
Idaho,2020/5/10,21.38737628,2,0,2232,67,No,No,26666
Idaho,2020/5/11,21.38737628,29,2,2261,69,No,No,26666
Idaho,2020/5/12,21.38737628,33,0,2294,69,No,No,26666
Idaho,2020/5/13,21.38737628,31,0,2325,69,No,No,25150
Idaho,2020/5/14,21.38737628,27,3,2352,72,No,No,25150
Idaho,2020/5/15,21.38737628,37,1,2389,73,No,No,25150
Idaho,2020/5/16,21.38737628,30,0,2419,73,No,No,25150
Idaho,2020/5/17,21.38737628,2,0,2421,73,No,No,25150
Idaho,2020/5/18,21.38737628,34,1,2455,74,No,No,25150
Idaho,2020/5/19,21.38737628,21,3,2476,77,No,No,25150
Idaho,2020/5/20,21.38737628,30,0,2506,77,No,No,27919
Idaho,2020/5/21,21.38737628,28,0,2534,77,No,No,27919
Idaho,2020/5/22,21.38737628,61,2,2595,79,No,No,27919
Idaho,2020/5/23,21.38737628,31,0,2626,79,No,No,27919
Idaho,2020/5/24,21.38737628,24,0,2650,79,No,No,27919
Idaho,2020/5/25,21.38737628,14,0,2664,79,No,No,27919
Idaho,2020/5/26,21.38737628,35,2,2699,81,No,No,27919
Idaho,2020/5/27,21.38737628,32,1,2731,82,No,No,21335
Idaho,2020/5/28,21.38737628,39,0,2770,82,No,No,21335
Idaho,2020/5/29,21.38737628,34,0,2804,82,No,No,21335
Idaho,2020/5/30,21.38737628,36,0,2840,82,No,No,21335
Idaho,2020/5/31,21.38737628,15,0,2855,82,No,No,21335
Idaho,2020/6/1,21.38737628,53,1,2908,83,No,No,21335
Idaho,2020/6/2,21.38737628,27,0,2935,83,No,No,21335
Idaho,2020/6/3,21.38737628,55,0,2990,83,No,No,19949
Idaho,2020/6/4,21.38737628,64,0,3054,83,No,No,19949
Idaho,2020/6/5,21.38737628,57,0,3111,83,No,No,19949
Idaho,2020/6/6,21.38737628,28,0,3139,83,No,No,19949
Idaho,2020/6/7,21.38737628,14,0,3153,83,No,No,19949
Idaho,2020/6/8,21.38737628,44,0,3197,83,No,No,19949
Idaho,2020/6/9,21.38737628,29,2,3226,85,No,No,19949
Idaho,2020/6/10,21.38737628,36,0,3262,85,No,No,18367
Idaho,2020/6/11,21.38737628,41,1,3303,86,No,No,18367
Idaho,2020/6/12,21.38737628,51,1,3354,87,No,No,18367
Idaho,2020/6/13,21.38737628,45,0,3399,87,No,Yes,18367
Idaho,2020/6/14,21.38737628,14,1,3413,88,No,Yes,18367
Idaho,2020/6/15,21.38737628,59,1,3472,89,No,Yes,18367
Idaho,2020/6/16,21.38737628,71,0,3543,89,No,Yes,18367
Idaho,2020/6/17,21.38737628,91,0,3634,89,No,Yes,18671
Idaho,2020/6/18,21.38737628,110,1,3744,90,No,Yes,18671
Idaho,2020/6/19,21.38737628,127,0,3871,90,No,Yes,18671
Idaho,2020/6/20,21.38737628,135,0,4006,90,No,Yes,18671
Idaho,2020/6/21,21.38737628,19,0,4025,90,No,Yes,18671
Idaho,2020/6/22,21.38737628,242,0,4267,90,No,Yes,18671
Idaho,2020/6/23,21.38737628,145,0,4412,90,No,Yes,18671
Idaho,2020/6/24,21.38737628,238,1,4650,91,No,Yes,18338
Idaho,2020/6/25,21.38737628,219,0,4869,91,No,Yes,18338
Idaho,2020/6/26,21.38737628,280,0,5149,91,No,Yes,18338
Idaho,2020/6/27,21.38737628,170,1,5319,92,No,Yes,18338
Idaho,2020/6/28,21.38737628,224,-1,5543,91,No,Yes,18338
Idaho,2020/6/29,21.38737628,227,0,5770,91,No,Yes,18338
Idaho,2020/6/30,21.38737628,354,1,6124,92,No,Yes,18338
Idaho,2020/7/1,21.38737628,255,0,6379,92,No,Yes,19056
Idaho,2020/7/2,21.38737628,309,1,6688,93,No,Yes,19056
Idaho,2020/7/3,21.38737628,346,1,7034,94,No,Yes,19056
Idaho,2020/7/4,21.38737628,397,0,7431,94,No,Yes,19056
Idaho,2020/7/5,21.38737628,368,0,7799,94,No,Yes,19056
Idaho,2020/7/6,21.38737628,423,0,8222,94,No,Yes,19056
Idaho,2020/7/7,21.38737628,360,0,8582,94,No,Yes,19056
Idaho,2020/7/8,21.38737628,422,4,9004,98,No,Yes,20563
Idaho,2020/7/9,21.38737628,594,3,9598,101,No,Yes,20563
Idaho,2020/7/10,21.38737628,475,0,10073,101,No,Yes,20563
Idaho,2020/7/11,21.38737628,511,1,10584,102,No,Yes,20563
Idaho,2020/7/12,21.38737628,387,0,10971,102,No,Yes,20563
Idaho,2020/7/13,21.38737628,560,0,11531,102,No,Yes,20563
Idaho,2020/7/14,21.38737628,431,1,11962,103,No,Yes,20563
Idaho,2020/7/15,21.38737628,637,8,12599,111,No,Yes,23676
Idaho,2020/7/16,21.38737628,662,3,13261,114,No,Yes,23676
Idaho,2020/7/17,21.38737628,618,5,13879,119,No,Yes,23676
Idaho,2020/7/18,21.38737628,554,1,14433,120,No,Yes,23676
Idaho,2020/7/19,21.38737628,527,0,14960,120,No,Yes,23676
Idaho,2020/7/20,21.38737628,420,3,15380,123,No,Yes,23676
Idaho,2020/7/21,21.38737628,519,4,15899,127,No,Yes,23676
Idaho,2020/7/22,21.38737628,496,9,16395,136,No,Yes,17437
Idaho,2020/7/23,21.38737628,467,6,16862,142,No,Yes,17437
Idaho,2020/7/24,21.38737628,549,6,17411,148,No,Yes,17437
Idaho,2020/7/25,21.38737628,509,2,17920,150,No,Yes,17437
Idaho,2020/7/26,21.38737628,342,0,18262,150,No,Yes,17437
Idaho,2020/7/27,21.38737628,574,9,18836,159,No,Yes,17437
Idaho,2020/7/28,21.38737628,482,9,19318,168,No,Yes,17437
Idaho,2020/7/29,21.38737628,492,8,19810,176,No,Yes,11690
Idaho,2020/7/30,21.38737628,568,4,20378,180,No,Yes,11690
Idaho,2020/7/31,21.38737628,475,13,20853,193,No,Yes,11690
Idaho,2020/8/1,21.38737628,378,4,21231,197,No,Yes,11690
Idaho,2020/8/2,21.38737628,234,0,21465,197,No,Yes,11690
Idaho,2020/8/3,21.38737628,373,5,21838,202,No,Yes,11690
Idaho,2020/8/4,21.38737628,519,12,22357,214,No,Yes,11690
Idaho,2020/8/5,21.38737628,497,4,22854,218,No,Yes,9467
Idaho,2020/8/6,21.38737628,656,9,23510,227,No,Yes,9467
Idaho,2020/8/7,21.38737628,563,4,24073,231,No,Yes,9467
Idaho,2020/8/8,21.38737628,520,5,24593,236,No,Yes,9467
Idaho,2020/8/9,21.38737628,204,1,24797,237,No,Yes,9467
Idaho,2020/8/10,21.38737628,470,2,25267,239,No,Yes,9467
Idaho,2020/8/11,21.38737628,500,9,25767,248,No,Yes,9467
Idaho,2020/8/12,21.38737628,513,3,26280,251,No,Yes,11047
Idaho,2020/8/13,21.38737628,534,5,26814,256,No,Yes,11047
Idaho,2020/8/14,21.38737628,498,11,27312,267,No,Yes,11047
Idaho,2020/8/15,21.38737628,308,2,27620,269,No,Yes,11047
Idaho,2020/8/16,21.38737628,174,0,27794,269,No,Yes,11047
Idaho,2020/8/17,21.38737628,319,6,28113,275,No,Yes,11047
Idaho,2020/8/18,21.38737628,373,8,28486,283,No,Yes,11047
Idaho,2020/8/19,21.38737628,343,9,28829,292,No,Yes,8676
Idaho,2020/8/20,21.38737628,423,7,29252,299,No,Yes,8676
Idaho,2020/8/21,21.38737628,258,6,29510,305,No,Yes,8676
Idaho,2020/8/22,21.38737628,298,2,29808,307,No,Yes,8676
Idaho,2020/8/23,21.38737628,165,1,29973,308,No,Yes,8676
Idaho,2020/8/24,21.38737628,287,7,30260,315,No,Yes,8676
Idaho,2020/8/25,21.38737628,388,13,30648,328,No,Yes,8676
Idaho,2020/8/26,21.38737628,320,9,30968,337,No,Yes,8511
Idaho,2020/8/27,21.38737628,358,6,31326,343,No,Yes,8511
Idaho,2020/8/28,21.38737628,317,14,31643,357,No,Yes,8511
Idaho,2020/8/29,21.38737628,231,2,31874,359,No,Yes,8511
Idaho,2020/8/30,21.38737628,160,1,32034,360,No,Yes,8511
Idaho,2020/8/31,21.38737628,222,4,32256,364,No,Yes,8511
Idaho,2020/9/1,21.38737628,447,6,32703,370,No,Yes,8511
Idaho,2020/9/2,21.38737628,356,4,33059,374,No,Yes,8901
Idaho,2020/9/3,21.38737628,302,1,33361,375,No,Yes,8901
Idaho,2020/9/4,21.38737628,267,11,33628,386,No,Yes,8901
Idaho,2020/9/5,21.38737628,256,0,33884,386,No,Yes,8901
Idaho,2020/9/6,21.38737628,169,1,34053,387,No,Yes,8901
Idaho,2020/9/7,21.38737628,100,0,34153,387,No,Yes,8901
Idaho,2020/9/8,21.38737628,308,3,34461,390,No,Yes,8901
Idaho,2020/9/9,21.38737628,246,16,34707,406,No,Yes,8848
Idaho,2020/9/10,21.38737628,320,1,35027,407,No,Yes,8848
Idaho,2020/9/11,21.38737628,327,8,35354,415,No,Yes,8848
Idaho,2020/9/12,21.38737628,234,1,35588,416,No,Yes,8848
Idaho,2020/9/13,21.38737628,105,0,35693,416,No,Yes,8848
Idaho,2020/9/14,21.38737628,291,4,35984,420,No,Yes,8848
Idaho,2020/9/15,21.38737628,322,5,36306,425,No,Yes,8848
Idaho,2020/9/16,21.38737628,288,5,36594,430,No,Yes,8679
Idaho,2020/9/17,21.38737628,330,5,36924,435,No,Yes,8679
Idaho,2020/9/18,21.38737628,434,4,37358,439,No,Yes,8679
Idaho,2020/9/19,21.38737628,266,2,37624,441,No,Yes,8679
Idaho,2020/9/20,21.38737628,144,2,37768,443,No,Yes,8679
Idaho,2020/9/21,21.38737628,428,4,38196,447,No,Yes,8679
Idaho,2020/9/22,21.38737628,480,5,38676,452,No,Yes,8679
Idaho,2020/9/23,21.38737628,354,2,39030,454,No,Yes,8805
Idaho,2020/9/24,21.38737628,517,4,39547,458,No,Yes,8805
Idaho,2020/9/25,21.38737628,681,0,40228,458,No,Yes,8805
Idaho,2020/9/26,21.38737628,183,2,40411,460,No,Yes,8805
Idaho,2020/9/27,21.38737628,90,0,40501,460,No,Yes,8805
Idaho,2020/9/28,21.38737628,885,0,41386,460,No,Yes,8805
Idaho,2020/9/29,21.38737628,468,6,41854,466,No,Yes,8805
Idaho,2020/9/30,21.38737628,695,3,42549,469,No,Yes,7732
Idaho,2020/10/1,21.38737628,366,4,42915,473,No,Yes,7732
Idaho,2020/10/2,21.38737628,613,5,43528,478,No,Yes,7732
Idaho,2020/10/3,21.38737628,174,2,43702,480,No,Yes,7732
Idaho,2020/10/4,21.38737628,262,2,43964,482,No,Yes,7732
Idaho,2020/10/5,21.38737628,868,5,44832,487,No,Yes,7732
Idaho,2020/10/6,21.38737628,655,7,45487,494,No,Yes,7732
Idaho,2020/10/7,21.38737628,746,8,46233,502,No,Yes,8581
Idaho,2020/10/8,21.38737628,615,2,46848,504,No,Yes,8581
Idaho,2020/10/9,21.38737628,826,2,47674,506,No,Yes,8581
Idaho,2020/10/10,21.38737628,253,2,47927,508,No,Yes,8581
Idaho,2020/10/11,21.38737628,228,0,48155,508,No,Yes,8581
Idaho,2020/10/12,21.38737628,508,3,48663,511,No,Yes,8581
Idaho,2020/10/13,21.38737628,1324,3,49987,514,No,Yes,8581
Idaho,2020/10/14,21.38737628,547,6,50534,520,No,Yes,7964
Idaho,2020/10/15,21.38737628,937,1,51471,521,No,Yes,7964
Idaho,2020/10/16,21.38737628,763,8,52234,529,No,Yes,7964
Idaho,2020/10/17,21.38737628,348,3,52582,532,No,Yes,7964
Idaho,2020/10/18,21.38737628,510,0,53092,532,No,Yes,7964
Idaho,2020/10/19,21.38737628,1031,3,54123,535,No,Yes,7964
Idaho,2020/10/20,21.38737628,1030,6,55153,541,No,Yes,7964
Idaho,2020/10/21,21.38737628,769,10,55922,551,No,Yes,7126
Idaho,2020/10/22,21.38737628,1022,9,56944,560,No,Yes,7126
Idaho,2020/10/23,21.38737628,1139,8,58083,568,No,Yes,7126
Idaho,2020/10/24,21.38737628,881,5,58964,573,No,Yes,7126
Idaho,2020/10/25,21.38737628,380,1,59344,574,No,Yes,7126
Idaho,2020/10/26,21.38737628,1056,8,60400,582,No,Yes,7126
Idaho,2020/10/27,21.38737628,882,6,61282,588,No,Yes,7126
Idaho,2020/10/28,21.38737628,915,12,62197,600,No,Yes,7060
Idaho,2020/10/29,21.38737628,998,18,63195,618,No,Yes,7060
Idaho,2020/10/30,21.38737628,980,9,64175,627,No,Yes,7060
Idaho,2020/10/31,21.38737628,622,3,64797,630,No,Yes,7060
Idaho,2020/11/1,21.38737628,475,1,65272,631,No,Yes,7060
Idaho,2020/11/2,21.38737628,977,10,66249,641,No,Yes,7060
Idaho,2020/11/3,21.38737628,1255,8,67504,649,No,Yes,7060
Idaho,2020/11/4,21.38737628,1287,16,68791,665,No,Yes,8764
Idaho,2020/11/5,21.38737628,1214,8,70005,673,No,Yes,8764
Idaho,2020/11/6,21.38737628,1491,12,71496,685,No,Yes,8764
Idaho,2020/11/7,21.38737628,1032,0,72528,685,No,Yes,8764
Idaho,2020/11/8,21.38737628,684,6,73212,691,No,Yes,8764
Idaho,2020/11/9,21.38737628,1501,13,74713,704,No,Yes,8764
Idaho,2020/11/10,21.38737628,1297,16,76010,720,No,Yes,8764
Idaho,2020/11/11,21.38737628,1526,18,77536,738,No,Yes,9262
Idaho,2020/11/12,21.38737628,1341,15,78877,753,No,Yes,9262
Idaho,2020/11/13,21.38737628,1563,3,80440,756,No,Yes,9262
Idaho,2020/11/14,21.38737628,1185,7,81625,763,No,Yes,9262
Idaho,2020/11/15,21.38737628,920,0,82545,763,No,Yes,9262
Idaho,2020/11/16,21.38737628,1361,10,83906,773,No,Yes,9262
Idaho,2020/11/17,21.38737628,1477,30,85383,803,No,Yes,9262
Idaho,2020/11/18,21.38737628,1637,12,87020,815,No,Yes,11813
Idaho,2020/11/19,21.38737628,1622,23,88642,838,No,Yes,11813
Idaho,2020/11/20,21.38737628,1704,11,90346,849,No,Yes,11813
Idaho,2020/11/21,21.38737628,966,2,91312,851,No,Yes,11813
Idaho,2020/11/22,21.38737628,623,1,91935,852,No,Yes,11813
Idaho,2020/11/23,21.38737628,1667,17,93602,869,No,Yes,11813
Idaho,2020/11/24,21.38737628,1986,12,95588,881,No,Yes,11813
Idaho,2020/11/25,21.38737628,1419,20,97007,901,No,Yes,7061
Idaho,2020/11/26,21.38737628,0,0,97007,901,No,Yes,7061
Idaho,2020/11/27,21.38737628,2141,13,99148,914,No,Yes,7061
Idaho,2020/11/28,21.38737628,836,5,99984,919,No,Yes,7061
Idaho,2020/11/29,21.38737628,774,6,100758,925,No,Yes,7061
Idaho,2020/11/30,21.38737628,1400,12,102158,937,No,Yes,7061
Idaho,2020/12/1,21.38737628,1484,29,103642,966,No,Yes,7061
Idaho,2020/12/2,21.38737628,1608,36,105250,1002,No,Yes,7656
Idaho,2020/12/3,21.38737628,1632,21,106882,1023,No,Yes,7656
Idaho,2020/12/4,21.38737628,1859,14,108741,1037,No,Yes,7656
Idaho,2020/12/5,21.38737628,1023,0,109764,1037,No,Yes,7656
Idaho,2020/12/6,21.38737628,789,3,110553,1040,No,Yes,7656
Idaho,2020/12/7,21.38737628,1880,22,112433,1062,No,Yes,7656
Idaho,2020/12/8,21.38737628,1978,19,114411,1081,No,Yes,7656
Idaho,2020/12/9,21.38737628,2266,43,116677,1124,No,Yes,7568
Idaho,2020/12/10,21.38737628,1675,21,118352,1145,No,Yes,7568
Idaho,2020/12/11,21.38737628,1582,24,119934,1169,No,Yes,7568
Idaho,2020/12/12,21.38737628,769,4,120703,1173,No,Yes,7568
Idaho,2020/12/13,21.38737628,540,6,121243,1179,No,Yes,7568
Idaho,2020/12/14,21.38737628,1436,20,122679,1199,No,Yes,7568
Idaho,2020/12/15,21.38737628,1607,20,124286,1219,No,Yes,7568
Idaho,2020/12/16,21.38737628,1548,28,125834,1247,No,Yes,7543
Idaho,2020/12/17,21.38737628,1390,19,127224,1266,No,Yes,7543
Idaho,2020/12/18,21.38737628,1274,14,128498,1280,No,Yes,7543
Idaho,2020/12/19,21.38737628,836,0,129334,1280,No,Yes,7543
Idaho,2020/12/20,21.38737628,705,4,130039,1284,No,Yes,7543
Idaho,2020/12/21,21.38737628,1429,21,131468,1305,No,Yes,7543
Idaho,2020/12/22,21.38737628,1482,12,132950,1317,No,Yes,7543
Idaho,2020/12/23,21.38737628,1308,26,134258,1343,No,Yes,5506
Idaho,2020/12/24,21.38737628,1125,10,135383,1353,No,Yes,5506
Idaho,2020/12/25,21.38737628,0,0,135383,1353,No,Yes,5506
Idaho,2020/12/26,21.38737628,503,4,135886,1357,No,Yes,5506
Idaho,2020/12/27,21.38737628,395,0,136281,1357,No,Yes,5506
Idaho,2020/12/28,21.38737628,1168,24,137449,1381,No,Yes,5506
Idaho,2020/12/29,21.38737628,1460,15,138909,1396,No,Yes,5506
Idaho,2020/12/30,21.38737628,1241,13,140150,1409,No,Yes,10986
Idaho,2020/12/31,21.38737628,1238,29,141388,1438,No,Yes,10986
Idaho,2021/1/1,21.38737628,0,0,141388,1438,No,Yes,10986
Idaho,2021/1/2,21.38737628,902,13,142290,1451,No,Yes,10986
Idaho,2021/1/3,21.38737628,278,0,142568,1451,No,Yes,10986
Idaho,2021/1/4,21.38737628,1265,11,143833,1462,No,Yes,10986
Idaho,2021/1/5,21.38737628,1301,12,145134,1474,No,Yes,10986
Idaho,2021/1/6,21.38737628,1188,21,146322,1495,No,Yes,14084
Idaho,2021/1/7,21.38737628,1178,24,147500,1519,No,Yes,14084
Idaho,2021/1/8,21.38737628,1078,7,148578,1526,No,Yes,14084
Idaho,2021/1/9,21.38737628,738,4,149316,1530,No,Yes,14084
Idaho,2021/1/10,21.38737628,426,6,149742,1536,No,Yes,14084
Idaho,2021/1/11,21.38737628,815,16,150557,1552,No,Yes,14084
Idaho,2021/1/12,21.38737628,917,11,151474,1563,No,Yes,14084
Idaho,2021/1/13,21.38737628,1086,13,152560,1576,No,Yes,11980
Idaho,2021/1/14,21.38737628,946,17,153506,1593,No,Yes,11980
Idaho,2021/1/15,21.38737628,1279,13,154785,1606,No,Yes,11980
Idaho,2021/1/16,21.38737628,572,1,155357,1607,No,Yes,11980
Idaho,2021/1/17,21.38737628,260,2,155617,1609,No,Yes,11980
Idaho,2021/1/18,21.38737628,24,0,155641,1609,No,Yes,11980
Idaho,2021/1/19,21.38737628,1428,30,157069,1639,No,Yes,11980
Idaho,2021/1/20,21.38737628,676,-2,157745,1637,No,Yes,11615
Idaho,2021/1/21,21.38737628,655,21,158400,1658,No,Yes,11615
Idaho,2021/1/22,21.38737628,600,11,159000,1669,No,Yes,11615
Idaho,2021/1/23,21.38737628,406,1,159406,1670,No,Yes,11615
Idaho,2021/1/24,21.38737628,175,1,159581,1671,No,Yes,11615
Idaho,2021/1/25,21.38737628,601,16,160182,1687,No,Yes,11615
Idaho,2021/1/26,21.38737628,545,4,160727,1691,No,Yes,11615
Idaho,2021/1/27,21.38737628,642,25,161369,1716,No,Yes,12664
Idaho,2021/1/28,21.38737628,494,8,161863,1724,No,Yes,12664
Idaho,2021/1/29,21.38737628,619,3,162482,1727,No,Yes,12664
Idaho,2021/1/30,21.38737628,280,0,162762,1727,No,Yes,12664
Idaho,2021/1/31,21.38737628,0,0,162762,1727,No,Yes,12664
Idaho,2021/2/1,21.38737628,529,10,163291,1737,No,Yes,12664
Idaho,2021/2/2,21.38737628,490,6,163781,1743,No,Yes,12664
Idaho,2021/2/3,21.38737628,476,7,164257,1750,No,Yes,13464
Idaho,2021/2/4,21.38737628,439,-1,164696,1749,No,Yes,13464
Idaho,2021/2/5,21.38737628,362,11,165058,1760,No,Yes,13464
Idaho,2021/2/6,21.38737628,201,9,165259,1769,No,Yes,13464
Idaho,2021/2/7,21.38737628,0,0,165259,1769,No,Yes,13464
Idaho,2021/2/8,21.38737628,567,9,165826,1778,No,Yes,13464
Idaho,2021/2/9,21.38737628,415,4,166241,1782,No,Yes,13464
Idaho,2021/2/10,21.38737628,415,11,166656,1793,No,Yes,12087
Idaho,2021/2/11,21.38737628,370,0,167026,1793,No,Yes,12087
Idaho,2021/2/12,21.38737628,324,8,167350,1801,No,Yes,12087
Idaho,2021/2/13,21.38737628,216,4,167566,1805,No,Yes,12087
Idaho,2021/2/14,21.38737628,0,0,167566,1805,No,Yes,12087
Idaho,2021/2/15,21.38737628,0,0,167566,1805,No,Yes,12087
Idaho,2021/2/16,21.38737628,531,3,168097,1808,No,Yes,12087
Idaho,2021/2/17,21.38737628,406,11,168503,1819,No,Yes,11395
Idaho,2021/2/18,21.38737628,280,9,168783,1828,No,Yes,11395
Idaho,2021/2/19,21.38737628,301,1,169084,1829,No,Yes,11395
Idaho,2021/2/20,21.38737628,145,0,169229,1829,No,Yes,11395
Idaho,2021/2/21,21.38737628,0,0,169229,1829,No,Yes,11395
Idaho,2021/2/22,21.38737628,494,-1,169723,1828,No,Yes,11395
Idaho,2021/2/23,21.38737628,290,14,170013,1842,No,Yes,11395
Idaho,2021/2/24,21.38737628,338,0,170351,1842,No,Yes,11395
Idaho,2021/2/25,21.38737628,384,13,170735,1855,No,Yes,11395
Idaho,2021/2/26,21.38737628,336,7,171071,1862,No,Yes,11395
Idaho,2021/2/27,21.38737628,138,0,171209,1862,No,Yes,11395
Idaho,2021/2/28,21.38737628,0,0,171209,1862,No,Yes,11395
Idaho,2021/3/1,21.38737628,409,7,171618,1869,No,Yes,11395
Idaho,2021/3/2,21.38737628,413,5,172031,1874,No,Yes,11395
Idaho,2021/3/3,21.38737628,411,5,172442,1879,No,Yes,11395
Idaho,2021/3/4,21.38737628,279,0,172721,1879,No,Yes,11395
Illinois,2020/3/1,224.6776773,3,0,3,0,No,No,1575
Illinois,2020/3/2,224.6776773,1,0,4,0,No,No,1575
Illinois,2020/3/3,224.6776773,0,0,4,0,No,No,1575
Illinois,2020/3/4,224.6776773,0,0,4,0,No,No,1663
Illinois,2020/3/5,224.6776773,1,0,5,0,No,No,1663
Illinois,2020/3/6,224.6776773,1,0,6,0,No,No,1663
Illinois,2020/3/7,224.6776773,0,0,6,0,No,No,1663
Illinois,2020/3/8,224.6776773,1,0,7,0,No,No,1663
Illinois,2020/3/9,224.6776773,4,0,11,0,No,No,1663
Illinois,2020/3/10,224.6776773,8,0,19,0,No,No,1663
Illinois,2020/3/11,224.6776773,6,0,25,0,No,No,1819
Illinois,2020/3/12,224.6776773,7,0,32,0,No,No,1819
Illinois,2020/3/13,224.6776773,14,0,46,0,No,No,1819
Illinois,2020/3/14,224.6776773,20,0,66,0,No,No,1819
Illinois,2020/3/15,224.6776773,28,0,94,0,No,No,1819
Illinois,2020/3/16,224.6776773,10,0,104,0,No,No,1819
Illinois,2020/3/17,224.6776773,55,1,159,1,No,No,1819
Illinois,2020/3/18,224.6776773,127,0,286,1,No,No,10892
Illinois,2020/3/19,224.6776773,134,3,420,4,No,No,10892
Illinois,2020/3/20,224.6776773,163,1,583,5,No,No,10892
Illinois,2020/3/21,224.6776773,168,1,751,6,Yes,No,10892
Illinois,2020/3/22,224.6776773,296,3,1047,9,Yes,No,10892
Illinois,2020/3/23,224.6776773,238,3,1285,12,Yes,No,10892
Illinois,2020/3/24,224.6776773,250,4,1535,16,Yes,No,10892
Illinois,2020/3/25,224.6776773,339,5,1874,21,Yes,No,80984
Illinois,2020/3/26,224.6776773,664,5,2538,26,Yes,No,80984
Illinois,2020/3/27,224.6776773,491,11,3029,37,Yes,No,80984
Illinois,2020/3/28,224.6776773,518,13,3547,50,Yes,No,80984
Illinois,2020/3/29,224.6776773,1068,21,4615,71,Yes,No,80984
Illinois,2020/3/30,224.6776773,455,13,5070,84,Yes,No,80984
Illinois,2020/3/31,224.6776773,922,23,5992,107,Yes,No,80984
Illinois,2020/4/1,224.6776773,986,39,6978,146,Yes,No,106739
Illinois,2020/4/2,224.6776773,717,19,7695,165,Yes,No,106739
Illinois,2020/4/3,224.6776773,1209,47,8904,212,Yes,No,106739
Illinois,2020/4/4,224.6776773,1453,36,10357,248,Yes,No,106739
Illinois,2020/4/5,224.6776773,919,35,11276,283,Yes,No,106739
Illinois,2020/4/6,224.6776773,986,26,12262,309,Yes,No,106739
Illinois,2020/4/7,224.6776773,1287,75,13549,384,Yes,No,106739
Illinois,2020/4/8,224.6776773,1529,80,15078,464,Yes,No,77515
Illinois,2020/4/9,224.6776773,1344,70,16422,534,Yes,No,77515
Illinois,2020/4/10,224.6776773,1465,73,17887,607,Yes,No,77515
Illinois,2020/4/11,224.6776773,1293,75,19180,682,Yes,No,77515
Illinois,2020/4/12,224.6776773,1672,45,20852,727,Yes,No,77515
Illinois,2020/4/13,224.6776773,1173,73,22025,800,Yes,No,77515
Illinois,2020/4/14,224.6776773,1222,78,23247,878,Yes,No,77515
Illinois,2020/4/15,224.6776773,1346,80,24593,958,Yes,No,66432
Illinois,2020/4/16,224.6776773,1141,123,25734,1081,Yes,No,66432
Illinois,2020/4/17,224.6776773,1841,61,27575,1142,Yes,No,66432
Illinois,2020/4/18,224.6776773,1585,130,29160,1272,Yes,No,66432
Illinois,2020/4/19,224.6776773,1197,30,30357,1302,Yes,No,66432
Illinois,2020/4/20,224.6776773,1151,57,31508,1359,Yes,No,66432
Illinois,2020/4/21,224.6776773,1551,120,33059,1479,Yes,No,66432
Illinois,2020/4/22,224.6776773,2049,98,35108,1577,Yes,No,74966
Illinois,2020/4/23,224.6776773,1827,119,36935,1696,Yes,No,74966
Illinois,2020/4/24,224.6776773,2723,108,39658,1804,Yes,No,74966
Illinois,2020/4/25,224.6776773,2119,80,41777,1884,Yes,No,74966
Illinois,2020/4/26,224.6776773,2126,59,43903,1943,Yes,No,74966
Illinois,2020/4/27,224.6776773,1980,49,45883,1992,Yes,No,74966
Illinois,2020/4/28,224.6776773,2219,140,48102,2132,Yes,No,74966
Illinois,2020/4/29,224.6776773,2253,89,50355,2221,Yes,No,28985
Illinois,2020/4/30,224.6776773,2563,140,52918,2361,Yes,No,28985
Illinois,2020/5/1,224.6776773,3137,103,56055,2464,Yes,No,28985
Illinois,2020/5/2,224.6776773,2450,112,58505,2576,Yes,No,28985
Illinois,2020/5/3,224.6776773,2994,56,61499,2632,Yes,No,28985
Illinois,2020/5/4,224.6776773,2341,41,63840,2673,Yes,No,28985
Illinois,2020/5/5,224.6776773,2049,170,65889,2843,Yes,No,28985
Illinois,2020/5/6,224.6776773,2275,134,68164,2977,Yes,No,26666
Illinois,2020/5/7,224.6776773,2638,162,70802,3139,Yes,No,26666
Illinois,2020/5/8,224.6776773,2886,123,73688,3262,Yes,No,26666
Illinois,2020/5/9,224.6776773,2320,100,76008,3362,Yes,No,26666
Illinois,2020/5/10,224.6776773,1654,64,77662,3426,Yes,No,26666
Illinois,2020/5/11,224.6776773,1461,54,79123,3480,Yes,No,26666
Illinois,2020/5/12,224.6776773,4045,137,83168,3617,Yes,No,26666
Illinois,2020/5/13,224.6776773,1706,198,84874,3815,Yes,No,25150
Illinois,2020/5/14,224.6776773,3207,130,88081,3945,Yes,No,25150
Illinois,2020/5/15,224.6776773,2447,130,90528,4075,Yes,No,25150
Illinois,2020/5/16,224.6776773,2141,74,92669,4149,Yes,No,25150
Illinois,2020/5/17,224.6776773,1691,49,94360,4198,Yes,No,25150
Illinois,2020/5/18,224.6776773,2418,59,96778,4257,Yes,No,25150
Illinois,2020/5/19,224.6776773,1520,142,98298,4399,Yes,No,25150
Illinois,2020/5/20,224.6776773,2415,148,100713,4547,Yes,No,27919
Illinois,2020/5/21,224.6776773,2282,87,102995,4634,Yes,No,27919
Illinois,2020/5/22,224.6776773,2715,106,105710,4740,Yes,No,27919
Illinois,2020/5/23,224.6776773,2390,77,108100,4817,Yes,No,27919
Illinois,2020/5/24,224.6776773,2441,67,110541,4884,Yes,No,27919
Illinois,2020/5/25,224.6776773,1707,28,112248,4912,Yes,No,27919
Illinois,2020/5/26,224.6776773,1238,48,113486,4960,Yes,No,27919
Illinois,2020/5/27,224.6776773,1126,158,114612,5118,Yes,No,21335
Illinois,2020/5/28,224.6776773,1516,107,116128,5225,Yes,No,21335
Illinois,2020/5/29,224.6776773,1666,83,117794,5308,Yes,No,21335
Illinois,2020/5/30,224.6776773,1496,60,119290,5368,No,No,21335
Illinois,2020/5/31,224.6776773,1298,58,120588,5426,No,No,21335
Illinois,2020/6/1,224.6776773,1078,32,121666,5458,No,No,21335
Illinois,2020/6/2,224.6776773,1578,109,123244,5567,No,No,21335
Illinois,2020/6/3,224.6776773,1035,98,124279,5665,No,No,19949
Illinois,2020/6/4,224.6776773,870,107,125149,5772,No,No,19949
Illinois,2020/6/5,224.6776773,1168,62,126317,5834,No,No,19949
Illinois,2020/6/6,224.6776773,934,64,127251,5898,No,No,19949
Illinois,2020/6/7,224.6776773,819,41,128070,5939,No,No,19949
Illinois,2020/6/8,224.6776773,1473,203,129543,6142,No,No,19949
Illinois,2020/6/9,224.6776773,778,95,130321,6237,No,No,19949
Illinois,2020/6/10,224.6776773,568,65,130889,6302,No,No,18367
Illinois,2020/6/11,224.6776773,842,86,131731,6388,No,No,18367
Illinois,2020/6/12,224.6776773,758,81,132489,6469,No,No,18367
Illinois,2020/6/13,224.6776773,628,22,133117,6491,No,No,18367
Illinois,2020/6/14,224.6776773,602,21,133719,6512,No,No,18367
Illinois,2020/6/15,224.6776773,528,31,134247,6543,No,No,18367
Illinois,2020/6/16,224.6776773,619,65,134866,6608,No,No,18367
Illinois,2020/6/17,224.6776773,550,79,135416,6687,No,No,18671
Illinois,2020/6/18,224.6776773,665,50,136081,6737,No,No,18671
Illinois,2020/6/19,224.6776773,836,64,136917,6801,No,No,18671
Illinois,2020/6/20,224.6776773,618,45,137535,6846,No,No,18671
Illinois,2020/6/21,224.6776773,619,19,138154,6865,No,No,18671
Illinois,2020/6/22,224.6776773,461,24,138615,6889,No,No,18671
Illinois,2020/6/23,224.6776773,667,36,139282,6925,No,No,18671
Illinois,2020/6/24,224.6776773,743,61,140025,6986,No,No,18338
Illinois,2020/6/25,224.6776773,910,38,140935,7024,No,No,18338
Illinois,2020/6/26,224.6776773,877,35,141812,7059,No,No,18338
Illinois,2020/6/27,224.6776773,724,24,142536,7083,No,No,18338
Illinois,2020/6/28,224.6776773,581,15,143117,7098,No,No,18338
Illinois,2020/6/29,224.6776773,768,17,143885,7115,No,No,18338
Illinois,2020/6/30,224.6776773,776,21,144661,7136,No,No,18338
Illinois,2020/7/1,224.6776773,880,24,145541,7160,No,No,19056
Illinois,2020/7/2,224.6776773,866,37,146407,7197,No,No,19056
Illinois,2020/7/3,224.6776773,886,25,147293,7222,No,No,19056
Illinois,2020/7/4,224.6776773,858,12,148151,7234,No,No,19056
Illinois,2020/7/5,224.6776773,579,7,148730,7241,No,No,19056
Illinois,2020/7/6,224.6776773,698,9,149428,7250,No,No,19056
Illinois,2020/7/7,224.6776773,682,31,150110,7281,No,No,19056
Illinois,2020/7/8,224.6776773,945,34,151055,7315,No,No,20563
Illinois,2020/7/9,224.6776773,1133,18,152188,7333,No,No,20563
Illinois,2020/7/10,224.6776773,1218,16,153406,7349,No,No,20563
Illinois,2020/7/11,224.6776773,1124,23,154530,7372,No,No,20563
Illinois,2020/7/12,224.6776773,825,19,155355,7391,No,No,20563
Illinois,2020/7/13,224.6776773,933,7,156288,7398,No,No,20563
Illinois,2020/7/14,224.6776773,767,27,157055,7425,No,No,20563
Illinois,2020/7/15,224.6776773,1396,10,158451,7435,No,No,23676
Illinois,2020/7/16,224.6776773,1225,22,159676,7457,No,No,23676
Illinois,2020/7/17,224.6776773,1366,11,161042,7468,No,No,23676
Illinois,2020/7/18,224.6776773,1257,18,162299,7486,No,No,23676
Illinois,2020/7/19,224.6776773,985,5,163284,7491,No,No,23676
Illinois,2020/7/20,224.6776773,1268,9,164552,7500,No,No,23676
Illinois,2020/7/21,224.6776773,982,21,165534,7521,No,No,23676
Illinois,2020/7/22,224.6776773,1608,23,167142,7544,No,No,17437
Illinois,2020/7/23,224.6776773,1624,19,168766,7563,No,No,17437
Illinois,2020/7/24,224.6776773,1610,17,170376,7580,No,No,17437
Illinois,2020/7/25,224.6776773,1293,13,171669,7593,No,No,17437
Illinois,2020/7/26,224.6776773,1410,2,173079,7595,No,No,17437
Illinois,2020/7/27,224.6776773,1363,24,174442,7619,No,No,17437
Illinois,2020/7/28,224.6776773,1146,26,175588,7645,No,No,17437
Illinois,2020/7/29,224.6776773,1379,16,176967,7661,No,No,11690
Illinois,2020/7/30,224.6776773,1865,16,178832,7677,No,No,11690
Illinois,2020/7/31,224.6776773,1869,26,180701,7703,No,No,11690
Illinois,2020/8/1,224.6776773,1531,4,182232,7707,No,No,11690
Illinois,2020/8/2,224.6776773,1482,11,183714,7718,No,No,11690
Illinois,2020/8/3,224.6776773,1524,10,185238,7728,No,No,11690
Illinois,2020/8/4,224.6776773,1360,19,186598,7747,No,No,11690
Illinois,2020/8/5,224.6776773,1876,29,188474,7776,No,No,9467
Illinois,2020/8/6,224.6776773,1991,20,190465,7796,No,No,9467
Illinois,2020/8/7,224.6776773,2017,37,192482,7833,No,No,9467
Illinois,2020/8/8,224.6776773,2049,13,194531,7846,No,No,9467
Illinois,2020/8/9,224.6776773,1366,6,195897,7852,No,No,9467
Illinois,2020/8/10,224.6776773,1429,2,197326,7854,No,No,9467
Illinois,2020/8/11,224.6776773,1593,25,198919,7879,No,No,9467
Illinois,2020/8/12,224.6776773,1729,28,200648,7907,No,No,11047
Illinois,2020/8/13,224.6776773,1929,27,202577,7934,No,No,11047
Illinois,2020/8/14,224.6776773,2250,19,204827,7953,No,No,11047
Illinois,2020/8/15,224.6776773,1678,6,206505,7959,No,No,11047
Illinois,2020/8/16,224.6776773,1563,14,208068,7973,No,No,11047
Illinois,2020/8/17,224.6776773,1874,17,209942,7990,No,No,11047
Illinois,2020/8/18,224.6776773,1864,27,211806,8017,No,No,11047
Illinois,2020/8/19,224.6776773,2082,20,213888,8037,No,No,8676
Illinois,2020/8/20,224.6776773,2001,27,215889,8064,No,No,8676
Illinois,2020/8/21,224.6776773,2222,22,218111,8086,No,No,8676
Illinois,2020/8/22,224.6776773,2348,21,220459,8107,No,No,8676
Illinois,2020/8/23,224.6776773,1833,7,222292,8114,No,No,8676
Illinois,2020/8/24,224.6776773,1764,9,224056,8123,No,No,8676
Illinois,2020/8/25,224.6776773,1756,32,225812,8155,No,No,8676
Illinois,2020/8/26,224.6776773,2060,31,227872,8186,No,No,8511
Illinois,2020/8/27,224.6776773,1726,20,229598,8206,No,No,8511
Illinois,2020/8/28,224.6776773,2454,23,232052,8229,No,No,8511
Illinois,2020/8/29,224.6776773,1754,7,233806,8236,No,No,8511
Illinois,2020/8/30,224.6776773,1973,12,235779,8248,No,No,8511
Illinois,2020/8/31,224.6776773,1903,10,237682,8258,No,No,8511
Illinois,2020/9/1,224.6776773,1433,41,239115,8299,No,No,8511
Illinois,2020/9/2,224.6776773,2167,23,241282,8322,No,No,8901
Illinois,2020/9/3,224.6776773,1433,25,242715,8347,No,No,8901
Illinois,2020/9/4,224.6776773,5538,39,248253,8386,No,No,8901
Illinois,2020/9/5,224.6776773,2629,19,250882,8405,No,No,8901
Illinois,2020/9/6,224.6776773,1424,4,252306,8409,No,No,8901
Illinois,2020/9/7,224.6776773,1343,8,253649,8417,No,No,8901
Illinois,2020/9/8,224.6776773,1580,14,255229,8431,No,No,8901
Illinois,2020/9/9,224.6776773,1385,26,256614,8457,No,No,8848
Illinois,2020/9/10,224.6776773,1959,23,258573,8480,No,No,8848
Illinois,2020/9/11,224.6776773,2376,42,260949,8522,No,No,8848
Illinois,2020/9/12,224.6776773,2008,24,262957,8546,No,No,8848
Illinois,2020/9/13,224.6776773,1383,16,264340,8562,No,No,8848
Illinois,2020/9/14,224.6776773,1529,9,265869,8571,No,No,8848
Illinois,2020/9/15,224.6776773,1511,18,267380,8589,No,No,8848
Illinois,2020/9/16,224.6776773,1902,33,269282,8622,No,No,8679
Illinois,2020/9/17,224.6776773,2088,21,271370,8643,No,No,8679
Illinois,2020/9/18,224.6776773,2226,23,273596,8666,No,No,8679
Illinois,2020/9/19,224.6776773,2461,22,276057,8688,No,No,8679
Illinois,2020/9/20,224.6776773,1316,12,277373,8700,No,No,8679
Illinois,2020/9/21,224.6776773,1659,17,279032,8717,No,No,8679
Illinois,2020/9/22,224.6776773,1479,24,280511,8741,No,No,8679
Illinois,2020/9/23,224.6776773,1820,21,282331,8762,No,No,8805
Illinois,2020/9/24,224.6776773,2289,31,284620,8793,No,No,8805
Illinois,2020/9/25,224.6776773,2755,33,287375,8826,No,No,8805
Illinois,2020/9/26,224.6776773,2308,21,289683,8847,No,No,8805
Illinois,2020/9/27,224.6776773,1588,12,291271,8859,No,No,8805
Illinois,2020/9/28,224.6776773,1898,18,293169,8877,No,No,8805
Illinois,2020/9/29,224.6776773,1504,24,294673,8901,No,No,8805
Illinois,2020/9/30,224.6776773,2262,34,296935,8935,No,No,7732
Illinois,2020/10/1,224.6776773,2176,21,299111,8956,No,No,7732
Illinois,2020/10/2,224.6776773,2429,51,301540,9007,No,No,7732
Illinois,2020/10/3,224.6776773,2267,26,303807,9033,No,No,7732
Illinois,2020/10/4,224.6776773,1411,17,305218,9050,No,No,7732
Illinois,2020/10/5,224.6776773,2210,21,307428,9071,No,No,7732
Illinois,2020/10/6,224.6776773,1562,29,308990,9100,No,No,7732
Illinois,2020/10/7,224.6776773,2624,38,311614,9138,No,No,8581
Illinois,2020/10/8,224.6776773,3111,35,314725,9173,No,No,8581
Illinois,2020/10/9,224.6776773,2776,34,317501,9207,No,No,8581
Illinois,2020/10/10,224.6776773,2782,28,320283,9235,No,No,8581
Illinois,2020/10/11,224.6776773,2702,10,322985,9245,No,No,8581
Illinois,2020/10/12,224.6776773,2770,13,325755,9258,No,No,8581
Illinois,2020/10/13,224.6776773,3405,30,329160,9288,No,No,8581
Illinois,2020/10/14,224.6776773,2964,47,332124,9335,No,No,7964
Illinois,2020/10/15,224.6776773,4087,57,336211,9392,No,No,7964
Illinois,2020/10/16,224.6776773,5008,55,341219,9447,No,No,7964
Illinois,2020/10/17,224.6776773,3568,27,344787,9474,No,No,7964
Illinois,2020/10/18,224.6776773,4083,17,348870,9491,No,No,7964
Illinois,2020/10/19,224.6776773,3579,29,352449,9520,No,No,7964
Illinois,2020/10/20,224.6776773,3702,42,356151,9562,No,No,7964
Illinois,2020/10/21,224.6776773,4009,60,360160,9622,No,No,7126
Illinois,2020/10/22,224.6776773,4960,41,365120,9663,No,No,7126
Illinois,2020/10/23,224.6776773,5014,41,370134,9704,No,No,7126
Illinois,2020/10/24,224.6776773,5900,61,376034,9765,No,No,7126
Illinois,2020/10/25,224.6776773,4031,23,380065,9788,No,No,7126
Illinois,2020/10/26,224.6776773,5019,23,385084,9811,No,No,7126
Illinois,2020/10/27,224.6776773,4004,49,389088,9860,No,No,7126
Illinois,2020/10/28,224.6776773,6116,52,395204,9912,No,No,7060
Illinois,2020/10/29,224.6776773,6418,51,401622,9963,No,No,7060
Illinois,2020/10/30,224.6776773,8519,49,410141,10012,No,No,7060
Illinois,2020/10/31,224.6776773,6416,18,416557,10030,No,No,7060
Illinois,2020/11/1,224.6776773,8303,61,424860,10091,No,No,7060
Illinois,2020/11/2,224.6776773,6421,24,431281,10115,No,No,7060
Illinois,2020/11/3,224.6776773,6598,62,437879,10177,No,No,7060
Illinois,2020/11/4,224.6776773,7658,62,445537,10239,No,No,8764
Illinois,2020/11/5,224.6776773,9991,95,455528,10334,No,No,8764
Illinois,2020/11/6,224.6776773,11356,78,466884,10412,No,No,8764
Illinois,2020/11/7,224.6776773,12177,86,479061,10498,No,No,8764
Illinois,2020/11/8,224.6776773,9919,50,488980,10548,No,No,8764
Illinois,2020/11/9,224.6776773,11035,29,500015,10577,No,No,8764
Illinois,2020/11/10,224.6776773,12673,81,512688,10658,No,No,8764
Illinois,2020/11/11,224.6776773,12384,147,525072,10805,No,No,9262
Illinois,2020/11/12,224.6776773,12788,50,537860,10855,No,No,9262
Illinois,2020/11/13,224.6776773,15223,52,553083,10907,No,No,9262
Illinois,2020/11/14,224.6776773,11003,191,564086,11098,No,No,9262
Illinois,2020/11/15,224.6776773,10636,72,574722,11170,No,No,9262
Illinois,2020/11/16,224.6776773,11847,47,586569,11217,No,No,9262
Illinois,2020/11/17,224.6776773,12789,110,599358,11327,No,No,9262
Illinois,2020/11/18,224.6776773,8698,161,608056,11488,No,No,11813
Illinois,2020/11/19,224.6776773,14813,183,622869,11671,No,No,11813
Illinois,2020/11/20,224.6776773,12954,143,635823,11814,No,No,11813
Illinois,2020/11/21,224.6776773,11651,153,647474,11967,No,No,11813
Illinois,2020/11/22,224.6776773,9928,97,657402,12064,No,No,11813
Illinois,2020/11/23,224.6776773,8463,77,665865,12141,No,No,11813
Illinois,2020/11/24,224.6776773,9678,153,675543,12294,No,No,11813
Illinois,2020/11/25,224.6776773,11312,171,686855,12465,No,No,7061
Illinois,2020/11/26,224.6776773,11509,144,698364,12609,No,No,7061
Illinois,2020/11/27,224.6776773,7759,96,706123,12705,No,No,7061
Illinois,2020/11/28,224.6776773,7947,147,714070,12852,No,No,7061
Illinois,2020/11/29,224.6776773,7417,43,721487,12895,No,No,7061
Illinois,2020/11/30,224.6776773,6338,120,727825,13015,No,No,7061
Illinois,2020/12/1,224.6776773,12685,160,740510,13175,No,No,7061
Illinois,2020/12/2,224.6776773,9698,258,750208,13433,No,No,7656
Illinois,2020/12/3,224.6776773,11001,217,761209,13650,No,No,7656
Illinois,2020/12/4,224.6776773,10487,158,771696,13808,No,No,7656
Illinois,2020/12/5,224.6776773,9745,220,781441,14028,No,No,7656
Illinois,2020/12/6,224.6776773,7481,99,788922,14127,No,No,7656
Illinois,2020/12/7,224.6776773,8867,107,797789,14234,No,No,7656
Illinois,2020/12/8,224.6776773,8005,158,805794,14392,No,No,7656
Illinois,2020/12/9,224.6776773,8196,229,813990,14621,No,No,7568
Illinois,2020/12/10,224.6776773,11146,231,825136,14852,No,No,7568
Illinois,2020/12/11,224.6776773,9532,224,834668,15076,No,No,7568
Illinois,2020/12/12,224.6776773,8660,156,843328,15232,No,No,7568
Illinois,2020/12/13,224.6776773,7084,108,850412,15340,No,No,7568
Illinois,2020/12/14,224.6776773,7448,118,857860,15458,No,No,7568
Illinois,2020/12/15,224.6776773,7401,133,865261,15591,No,No,7568
Illinois,2020/12/16,224.6776773,7033,189,872294,15780,No,No,7543
Illinois,2020/12/17,224.6776773,8935,207,881229,15987,No,No,7543
Illinois,2020/12/18,224.6776773,7249,219,888478,16206,No,No,7543
Illinois,2020/12/19,224.6776773,7525,120,896003,16326,No,No,7543
Illinois,2020/12/20,224.6776773,5921,81,901924,16407,No,No,7543
Illinois,2020/12/21,224.6776773,4993,123,906917,16530,No,No,7543
Illinois,2020/12/22,224.6776773,6348,147,913265,16677,No,No,7543
Illinois,2020/12/23,224.6776773,6727,169,919992,16846,No,No,5506
Illinois,2020/12/24,224.6776773,6975,118,926967,16964,No,No,5506
Illinois,2020/12/25,224.6776773,5460,191,932427,17155,No,No,5506
Illinois,2020/12/26,224.6776773,3422,70,935849,17225,No,No,5506
Illinois,2020/12/27,224.6776773,3822,111,939671,17336,No,No,5506
Illinois,2020/12/28,224.6776773,4731,140,944402,17476,No,No,5506
Illinois,2020/12/29,224.6776773,5720,130,950122,17606,No,No,5506
Illinois,2020/12/30,224.6776773,7731,207,957853,17813,No,No,10986
Illinois,2020/12/31,224.6776773,7987,166,965840,17979,No,No,10986
Illinois,2021/1/1,224.6776773,447,0,966287,17979,No,No,10986
Illinois,2021/1/2,224.6776773,11390,238,977677,18217,No,No,10986
Illinois,2021/1/3,224.6776773,4428,105,982105,18322,No,No,10986
Illinois,2021/1/4,224.6776773,5354,92,987459,18414,No,No,10986
Illinois,2021/1/5,224.6776773,7052,155,994511,18569,No,No,10986
Illinois,2021/1/6,224.6776773,7444,169,1001955,18738,No,No,14084
Illinois,2021/1/7,224.6776773,8853,206,1010808,18944,No,No,14084
Illinois,2021/1/8,224.6776773,9203,166,1020011,19110,No,No,14084
Illinois,2021/1/9,224.6776773,6628,102,1026639,19212,No,No,14084
Illinois,2021/1/10,224.6776773,4649,83,1031288,19295,No,No,14084
Illinois,2021/1/11,224.6776773,5162,70,1036450,19365,No,No,14084
Illinois,2021/1/12,224.6776773,6591,132,1043041,19497,No,No,14084
Illinois,2021/1/13,224.6776773,5743,122,1048784,19619,No,No,11980
Illinois,2021/1/14,224.6776773,6766,109,1055550,19728,No,No,11980
Illinois,2021/1/15,224.6776773,6571,148,1062121,19876,No,No,11980
Illinois,2021/1/16,224.6776773,5109,145,1067230,20021,No,No,11980
Illinois,2021/1/17,224.6776773,4077,31,1071307,20052,No,No,11980
Illinois,2021/1/18,224.6776773,3412,67,1074719,20119,No,No,11980
Illinois,2021/1/19,224.6776773,4588,35,1079307,20154,No,No,11980
Illinois,2021/1/20,224.6776773,4827,131,1084134,20285,No,No,11615
Illinois,2021/1/21,224.6776773,4876,138,1089010,20423,No,No,11615
Illinois,2021/1/22,224.6776773,6907,112,1095917,20535,No,No,11615
Illinois,2021/1/23,224.6776773,5120,110,1101037,20645,No,No,11615
Illinois,2021/1/24,224.6776773,3169,35,1104206,20680,No,No,11615
Illinois,2021/1/25,224.6776773,3182,64,1107388,20744,No,No,11615
Illinois,2021/1/26,224.6776773,3640,109,1111028,20853,No,No,11615
Illinois,2021/1/27,224.6776773,3770,97,1114798,20950,No,No,12664
Illinois,2021/1/28,224.6776773,4206,124,1119004,21074,No,No,12664
Illinois,2021/1/29,224.6776773,4148,73,1123152,21147,No,No,12664
Illinois,2021/1/30,224.6776773,3296,66,1126448,21213,No,No,12664
Illinois,2021/1/31,224.6776773,2057,29,1128505,21242,No,No,12664
Illinois,2021/2/1,224.6776773,2707,31,1131212,21273,No,No,12664
Illinois,2021/2/2,224.6776773,2479,63,1133691,21336,No,No,12664
Illinois,2021/2/3,224.6776773,3346,84,1137037,21420,No,No,13464
Illinois,2021/2/4,224.6776773,3304,77,1140341,21497,No,Yes,13464
Illinois,2021/2/5,224.6776773,3620,106,1143961,21603,No,Yes,13464
Illinois,2021/2/6,224.6776773,2991,73,1146952,21676,No,Yes,13464
Illinois,2021/2/7,224.6776773,1995,62,1148947,21738,No,Yes,13464
Illinois,2021/2/8,224.6776773,1922,41,1150869,21779,No,Yes,13464
Illinois,2021/2/9,224.6776773,2073,23,1152942,21802,No,Yes,13464
Illinois,2021/2/10,224.6776773,2860,67,1155802,21869,No,Yes,12087
Illinois,2021/2/11,224.6776773,2793,116,1158595,21985,No,Yes,12087
Illinois,2021/2/12,224.6776773,2611,42,1161206,22027,No,Yes,12087
Illinois,2021/2/13,224.6776773,2026,60,1163232,22087,No,Yes,12087
Illinois,2021/2/14,224.6776773,1511,34,1164743,22121,No,Yes,12087
Illinois,2021/2/15,224.6776773,1355,45,1166098,22166,No,Yes,12087
Illinois,2021/2/16,224.6776773,1791,33,1167889,22199,No,Yes,12087
Illinois,2021/2/17,224.6776773,1858,25,1169747,22224,No,Yes,11395
Illinois,2021/2/18,224.6776773,1940,73,1171687,22297,No,Yes,11395
Illinois,2021/2/19,224.6776773,2210,71,1173897,22368,No,Yes,11395
Illinois,2021/2/20,224.6776773,1884,58,1175781,22426,No,Yes,11395
Illinois,2021/2/21,224.6776773,1520,40,1177301,22466,No,Yes,11395
Illinois,2021/2/22,224.6776773,1401,40,1178702,22506,No,Yes,11395
Illinois,2021/2/23,224.6776773,1719,22,1180421,22528,No,Yes,11395
Illinois,2021/2/24,224.6776773,1981,47,1182402,22575,No,Yes,11395
Illinois,2021/2/25,224.6776773,1972,32,1184374,22607,No,Yes,11395
Illinois,2021/2/26,224.6776773,2619,68,1186993,22675,No,Yes,11395
Illinois,2021/2/27,224.6776773,1739,35,1188732,22710,No,Yes,11395
Illinois,2021/2/28,224.6776773,1190,25,1189922,22735,No,Yes,11395
Illinois,2021/3/1,224.6776773,1285,24,1191207,22759,No,Yes,11395
Illinois,2021/3/2,224.6776773,1653,44,1192860,22803,No,Yes,11395
Illinois,2021/3/3,224.6776773,2100,50,1194960,22853,No,Yes,11395
Illinois,2021/3/4,224.6776773,1779,49,1196739,22902,No,Yes,11395
Indiana,2020/3/1,185.5065719,0,0,0,0,No,No,1575
Indiana,2020/3/2,185.5065719,0,0,0,0,No,No,1575
Indiana,2020/3/3,185.5065719,0,0,0,0,No,No,1575
Indiana,2020/3/4,185.5065719,0,0,0,0,No,No,1663
Indiana,2020/3/5,185.5065719,0,0,0,0,No,No,1663
Indiana,2020/3/6,185.5065719,1,0,1,0,No,No,1663
Indiana,2020/3/7,185.5065719,0,0,1,0,No,No,1663
Indiana,2020/3/8,185.5065719,1,0,2,0,No,No,1663
Indiana,2020/3/9,185.5065719,2,0,4,0,No,No,1663
Indiana,2020/3/10,185.5065719,2,0,6,0,No,No,1663
Indiana,2020/3/11,185.5065719,5,0,11,0,No,No,1819
Indiana,2020/3/12,185.5065719,1,0,12,0,No,No,1819
Indiana,2020/3/13,185.5065719,0,0,12,0,No,No,1819
Indiana,2020/3/14,185.5065719,3,0,15,0,No,No,1819
Indiana,2020/3/15,185.5065719,4,0,19,0,No,No,1819
Indiana,2020/3/16,185.5065719,5,1,24,1,No,No,1819
Indiana,2020/3/17,185.5065719,6,1,30,2,No,No,1819
Indiana,2020/3/18,185.5065719,9,0,39,2,No,No,10892
Indiana,2020/3/19,185.5065719,17,0,56,2,No,No,10892
Indiana,2020/3/20,185.5065719,25,3,81,5,No,No,10892
Indiana,2020/3/21,185.5065719,47,1,128,6,No,No,10892
Indiana,2020/3/22,185.5065719,76,3,204,9,No,No,10892
Indiana,2020/3/23,185.5065719,60,3,264,12,No,No,10892
Indiana,2020/3/24,185.5065719,107,5,371,17,Yes,No,10892
Indiana,2020/3/25,185.5065719,113,2,484,19,Yes,No,80984
Indiana,2020/3/26,185.5065719,177,4,661,23,Yes,No,80984
Indiana,2020/3/27,185.5065719,331,9,992,32,Yes,No,80984
Indiana,2020/3/28,185.5065719,247,6,1239,38,Yes,No,80984
Indiana,2020/3/29,185.5065719,283,2,1522,40,Yes,No,80984
Indiana,2020/3/30,185.5065719,275,4,1797,44,Yes,No,80984
Indiana,2020/3/31,185.5065719,380,17,2177,61,Yes,No,80984
Indiana,2020/4/1,185.5065719,401,19,2578,80,Yes,No,106739
Indiana,2020/4/2,185.5065719,478,14,3056,94,Yes,No,106739
Indiana,2020/4/3,185.5065719,399,24,3455,118,Yes,No,106739
Indiana,2020/4/4,185.5065719,520,18,3975,136,Yes,No,106739
Indiana,2020/4/5,185.5065719,462,15,4437,151,Yes,No,106739
Indiana,2020/4/6,185.5065719,549,20,4986,171,Yes,No,106739
Indiana,2020/4/7,185.5065719,558,37,5544,208,Yes,No,106739
Indiana,2020/4/8,185.5065719,442,38,5986,246,Yes,No,77515
Indiana,2020/4/9,185.5065719,414,49,6400,295,Yes,No,77515
Indiana,2020/4/10,185.5065719,560,58,6960,353,Yes,No,77515
Indiana,2020/4/11,185.5065719,534,36,7494,389,Yes,No,77515
Indiana,2020/4/12,185.5065719,496,16,7990,405,Yes,No,77515
Indiana,2020/4/13,185.5065719,310,9,8300,414,Yes,No,77515
Indiana,2020/4/14,185.5065719,298,44,8598,458,Yes,No,77515
Indiana,2020/4/15,185.5065719,432,53,9030,511,Yes,No,66432
Indiana,2020/4/16,185.5065719,589,43,9619,554,Yes,No,66432
Indiana,2020/4/17,185.5065719,616,45,10235,599,Yes,No,66432
Indiana,2020/4/18,185.5065719,495,34,10730,633,Yes,No,66432
Indiana,2020/4/19,185.5065719,571,19,11301,652,Yes,No,66432
Indiana,2020/4/20,185.5065719,483,14,11784,666,Yes,No,66432
Indiana,2020/4/21,185.5065719,430,65,12214,731,Yes,No,66432
Indiana,2020/4/22,185.5065719,361,33,12575,764,Yes,No,74966
Indiana,2020/4/23,185.5065719,621,47,13196,811,Yes,No,74966
Indiana,2020/4/24,185.5065719,652,40,13848,851,Yes,No,74966
Indiana,2020/4/25,185.5065719,719,46,14567,897,Yes,No,74966
Indiana,2020/4/26,185.5065719,620,31,15187,928,Yes,No,74966
Indiana,2020/4/27,185.5065719,950,4,16137,932,Yes,No,74966
Indiana,2020/4/28,185.5065719,646,60,16783,992,Yes,No,74966
Indiana,2020/4/29,185.5065719,626,73,17409,1065,Yes,No,28985
Indiana,2020/4/30,185.5065719,690,49,18099,1114,Yes,No,28985
Indiana,2020/5/1,185.5065719,842,61,18941,1175,Yes,No,28985
Indiana,2020/5/2,185.5065719,688,54,19629,1229,No,No,28985
Indiana,2020/5/3,185.5065719,638,17,20267,1246,No,No,28985
Indiana,2020/5/4,185.5065719,588,18,20855,1264,No,No,28985
Indiana,2020/5/5,185.5065719,568,62,21423,1326,No,No,28985
Indiana,2020/5/6,185.5065719,863,51,22286,1377,No,No,26666
Indiana,2020/5/7,185.5065719,656,37,22942,1414,No,No,26666
Indiana,2020/5/8,185.5065719,678,33,23620,1447,No,No,26666
Indiana,2020/5/9,185.5065719,619,43,24239,1490,No,No,26666
Indiana,2020/5/10,185.5065719,394,18,24633,1508,No,No,26666
Indiana,2020/5/11,185.5065719,501,32,25134,1540,No,No,26666
Indiana,2020/5/12,185.5065719,542,38,25676,1578,No,No,26666
Indiana,2020/5/13,185.5065719,368,41,26044,1619,No,No,25150
Indiana,2020/5/14,185.5065719,583,27,26627,1646,No,No,25150
Indiana,2020/5/15,185.5065719,654,45,27281,1691,No,No,25150
Indiana,2020/5/16,185.5065719,638,50,27919,1741,No,No,25150
Indiana,2020/5/17,185.5065719,500,10,28419,1751,No,No,25150
Indiana,2020/5/18,185.5065719,478,14,28897,1765,No,No,25150
Indiana,2020/5/19,185.5065719,505,59,29402,1824,No,No,25150
Indiana,2020/5/20,185.5065719,584,40,29986,1864,No,No,27919
Indiana,2020/5/21,185.5065719,687,49,30673,1913,No,No,27919
Indiana,2020/5/22,185.5065719,492,28,31165,1941,No,No,27919
Indiana,2020/5/23,185.5065719,509,23,31674,1964,No,No,27919
Indiana,2020/5/24,185.5065719,477,12,32151,1976,No,No,27919
Indiana,2020/5/25,185.5065719,338,8,32489,1984,No,No,27919
Indiana,2020/5/26,185.5065719,367,20,32856,2004,No,No,27919
Indiana,2020/5/27,185.5065719,386,26,33242,2030,No,No,21335
Indiana,2020/5/28,185.5065719,643,38,33885,2068,No,No,21335
Indiana,2020/5/29,185.5065719,514,42,34399,2110,No,No,21335
Indiana,2020/5/30,185.5065719,665,15,35064,2125,No,No,21335
Indiana,2020/5/31,185.5065719,365,9,35429,2134,No,No,21335
Indiana,2020/6/1,185.5065719,255,8,35684,2142,No,No,21335
Indiana,2020/6/2,185.5065719,445,55,36129,2197,No,No,21335
Indiana,2020/6/3,185.5065719,480,10,36609,2207,No,No,19949
Indiana,2020/6/4,185.5065719,396,24,37005,2231,No,No,19949
Indiana,2020/6/5,185.5065719,494,27,37499,2258,No,No,19949
Indiana,2020/6/6,185.5065719,429,34,37928,2292,No,No,19949
Indiana,2020/6/7,185.5065719,400,11,38328,2303,No,No,19949
Indiana,2020/6/8,185.5065719,225,13,38553,2316,No,No,19949
Indiana,2020/6/9,185.5065719,432,23,38985,2339,No,No,19949
Indiana,2020/6/10,185.5065719,312,16,39297,2355,No,No,18367
Indiana,2020/6/11,185.5065719,417,25,39714,2380,No,No,18367
Indiana,2020/6/12,185.5065719,400,16,40114,2396,No,No,18367
Indiana,2020/6/13,185.5065719,421,17,40535,2413,No,No,18367
Indiana,2020/6/14,185.5065719,366,9,40901,2422,No,No,18367
Indiana,2020/6/15,185.5065719,521,11,41422,2433,No,No,18367
Indiana,2020/6/16,185.5065719,358,14,41780,2447,No,No,18367
Indiana,2020/6/17,185.5065719,256,28,42036,2475,No,No,18671
Indiana,2020/6/18,185.5065719,444,16,42480,2491,No,No,18671
Indiana,2020/6/19,185.5065719,321,25,42801,2516,No,No,18671
Indiana,2020/6/20,185.5065719,334,20,43135,2536,No,No,18671
Indiana,2020/6/21,185.5065719,361,4,43496,2540,No,No,18671
Indiana,2020/6/22,185.5065719,213,13,43709,2553,No,No,18671
Indiana,2020/6/23,185.5065719,258,16,43967,2569,No,No,18671
Indiana,2020/6/24,185.5065719,293,9,44260,2578,No,No,18338
Indiana,2020/6/25,185.5065719,519,8,44779,2586,No,No,18338
Indiana,2020/6/26,185.5065719,490,9,45269,2595,No,No,18338
Indiana,2020/6/27,185.5065719,438,21,45707,2616,No,No,18338
Indiana,2020/6/28,185.5065719,364,3,46071,2619,No,No,18338
Indiana,2020/6/29,185.5065719,299,5,46370,2624,No,No,18338
Indiana,2020/6/30,185.5065719,370,16,46740,2640,No,No,18338
Indiana,2020/7/1,185.5065719,376,10,47116,2650,No,No,19056
Indiana,2020/7/2,185.5065719,437,12,47553,2662,No,No,19056
Indiana,2020/7/3,185.5065719,546,20,48099,2682,No,No,19056
Indiana,2020/7/4,185.5065719,529,5,48628,2687,No,No,19056
Indiana,2020/7/5,185.5065719,575,6,49203,2693,No,No,19056
Indiana,2020/7/6,185.5065719,357,5,49560,2698,No,No,19056
Indiana,2020/7/7,185.5065719,299,19,49859,2717,No,No,19056
Indiana,2020/7/8,185.5065719,450,15,50309,2732,No,No,20563
Indiana,2020/7/9,185.5065719,520,7,50829,2739,No,No,20563
Indiana,2020/7/10,185.5065719,738,9,51567,2748,No,No,20563
Indiana,2020/7/11,185.5065719,791,8,52358,2756,No,No,20563
Indiana,2020/7/12,185.5065719,534,4,52892,2760,No,No,20563
Indiana,2020/7/13,185.5065719,435,2,53327,2762,No,No,20563
Indiana,2020/7/14,185.5065719,674,13,54001,2775,No,No,20563
Indiana,2020/7/15,185.5065719,697,10,54698,2785,No,No,23676
Indiana,2020/7/16,185.5065719,715,10,55413,2795,No,No,23676
Indiana,2020/7/17,185.5065719,747,8,56160,2803,No,No,23676
Indiana,2020/7/18,185.5065719,885,17,57045,2820,No,No,23676
Indiana,2020/7/19,185.5065719,920,2,57965,2822,No,No,23676
Indiana,2020/7/20,185.5065719,642,3,58607,2825,No,No,23676
Indiana,2020/7/21,185.5065719,737,21,59344,2846,No,No,23676
Indiana,2020/7/22,185.5065719,782,17,60126,2863,No,No,17437
Indiana,2020/7/23,185.5065719,953,17,61079,2880,No,No,17437
Indiana,2020/7/24,185.5065719,1002,4,62081,2884,No,No,17437
Indiana,2020/7/25,185.5065719,949,11,63030,2895,No,No,17437
Indiana,2020/7/26,185.5065719,851,8,63881,2903,No,No,17437
Indiana,2020/7/27,185.5065719,536,3,64417,2906,No,Yes,17437
Indiana,2020/7/28,185.5065719,841,18,65258,2924,No,Yes,17437
Indiana,2020/7/29,185.5065719,660,8,65918,2932,No,Yes,11690
Indiana,2020/7/30,185.5065719,965,14,66883,2946,No,Yes,11690
Indiana,2020/7/31,185.5065719,917,19,67800,2965,No,Yes,11690
Indiana,2020/8/1,185.5065719,973,6,68773,2971,No,Yes,11690
Indiana,2020/8/2,185.5065719,758,4,69531,2975,No,Yes,11690
Indiana,2020/8/3,185.5065719,580,5,70111,2980,No,Yes,11690
Indiana,2020/8/4,185.5065719,833,16,70944,2996,No,Yes,11690
Indiana,2020/8/5,185.5065719,741,11,71685,3007,No,Yes,9467
Indiana,2020/8/6,185.5065719,1056,6,72741,3013,No,Yes,9467
Indiana,2020/8/7,185.5065719,1245,10,73986,3023,No,Yes,9467
Indiana,2020/8/8,185.5065719,1039,13,75025,3036,No,Yes,9467
Indiana,2020/8/9,185.5065719,1046,5,76071,3041,No,Yes,9467
Indiana,2020/8/10,185.5065719,663,3,76734,3044,No,Yes,9467
Indiana,2020/8/11,185.5065719,891,25,77625,3069,No,Yes,9467
Indiana,2020/8/12,185.5065719,712,17,78337,3086,No,Yes,11047
Indiana,2020/8/13,185.5065719,1067,19,79404,3105,No,Yes,11047
Indiana,2020/8/14,185.5065719,1103,8,80507,3113,No,Yes,11047
Indiana,2020/8/15,185.5065719,1054,15,81561,3128,No,Yes,11047
Indiana,2020/8/16,185.5065719,743,5,82304,3133,No,Yes,11047
Indiana,2020/8/17,185.5065719,605,2,82909,3135,No,Yes,11047
Indiana,2020/8/18,185.5065719,890,30,83799,3165,No,Yes,11047
Indiana,2020/8/19,185.5065719,509,15,84308,3180,No,Yes,8676
Indiana,2020/8/20,185.5065719,949,11,85257,3191,No,Yes,8676
Indiana,2020/8/21,185.5065719,1055,17,86312,3208,No,Yes,8676
Indiana,2020/8/22,185.5065719,1013,10,87325,3218,No,Yes,8676
Indiana,2020/8/23,185.5065719,617,2,87942,3220,No,Yes,8676
Indiana,2020/8/24,185.5065719,1660,5,89602,3225,No,Yes,8676
Indiana,2020/8/25,185.5065719,858,16,90460,3241,No,Yes,8676
Indiana,2020/8/26,185.5065719,943,18,91403,3259,No,Yes,8511
Indiana,2020/8/27,185.5065719,1163,7,92566,3266,No,No,8511
Indiana,2020/8/28,185.5065719,821,11,93387,3277,No,No,8511
Indiana,2020/8/29,185.5065719,1125,8,94512,3285,No,No,8511
Indiana,2020/8/30,185.5065719,882,6,95394,3291,No,No,8511
Indiana,2020/8/31,185.5065719,883,5,96277,3296,No,No,8511
Indiana,2020/9/1,185.5065719,711,16,96988,3312,No,No,8511
Indiana,2020/9/2,185.5065719,865,13,97853,3325,No,No,8901
Indiana,2020/9/3,185.5065719,1118,7,98971,3332,No,No,8901
Indiana,2020/9/4,185.5065719,1040,18,100011,3350,No,No,8901
Indiana,2020/9/5,185.5065719,1083,12,101094,3362,No,No,8901
Indiana,2020/9/6,185.5065719,843,2,101937,3364,No,No,8901
Indiana,2020/9/7,185.5065719,590,4,102527,3368,No,No,8901
Indiana,2020/9/8,185.5065719,390,12,102917,3380,No,No,8901
Indiana,2020/9/9,185.5065719,724,17,103641,3397,No,No,8848
Indiana,2020/9/10,185.5065719,788,13,104429,3410,No,No,8848
Indiana,2020/9/11,185.5065719,1274,10,105703,3420,No,No,8848
Indiana,2020/9/12,185.5065719,1074,17,106777,3437,No,No,8848
Indiana,2020/9/13,185.5065719,1243,1,108020,3438,No,No,8848
Indiana,2020/9/14,185.5065719,735,1,108755,3439,No,No,8848
Indiana,2020/9/15,185.5065719,690,21,109445,3460,No,No,8848
Indiana,2020/9/16,185.5065719,580,12,110025,3472,No,No,8679
Indiana,2020/9/17,185.5065719,838,6,110863,3478,No,No,8679
Indiana,2020/9/18,185.5065719,1037,17,111900,3495,No,No,8679
Indiana,2020/9/19,185.5065719,1082,8,112982,3503,No,No,8679
Indiana,2020/9/20,185.5065719,746,3,113728,3506,No,No,8679
Indiana,2020/9/21,185.5065719,523,6,114251,3512,No,No,8679
Indiana,2020/9/22,185.5065719,613,8,114864,3520,No,No,8679
Indiana,2020/9/23,185.5065719,714,10,115578,3530,No,No,8805
Indiana,2020/9/24,185.5065719,903,18,116481,3548,No,No,8805
Indiana,2020/9/25,185.5065719,1175,18,117656,3566,No,No,8805
Indiana,2020/9/26,185.5065719,1163,11,118819,3577,No,No,8805
Indiana,2020/9/27,185.5065719,902,3,119721,3580,No,No,8805
Indiana,2020/9/28,185.5065719,860,11,120581,3591,No,No,8805
Indiana,2020/9/29,185.5065719,746,21,121327,3612,No,No,8805
Indiana,2020/9/30,185.5065719,968,20,122295,3632,No,No,7732
Indiana,2020/10/1,185.5065719,1164,13,123459,3645,No,No,7732
Indiana,2020/10/2,185.5065719,1500,11,124959,3656,No,No,7732
Indiana,2020/10/3,185.5065719,1455,13,126414,3669,No,No,7732
Indiana,2020/10/4,185.5065719,1087,5,127501,3674,No,No,7732
Indiana,2020/10/5,185.5065719,784,7,128285,3681,No,No,7732
Indiana,2020/10/6,185.5065719,996,30,129281,3711,No,No,7732
Indiana,2020/10/7,185.5065719,1288,16,130569,3727,No,No,8581
Indiana,2020/10/8,185.5065719,1461,15,132030,3742,No,No,8581
Indiana,2020/10/9,185.5065719,1834,19,133864,3761,No,No,8581
Indiana,2020/10/10,185.5065719,1925,21,135789,3782,No,No,8581
Indiana,2020/10/11,185.5065719,1570,7,137359,3789,No,No,8581
Indiana,2020/10/12,185.5065719,1574,6,138933,3795,No,No,8581
Indiana,2020/10/13,185.5065719,1572,27,140505,3822,No,No,8581
Indiana,2020/10/14,185.5065719,1165,14,141670,3836,No,No,7964
Indiana,2020/10/15,185.5065719,1947,28,143617,3864,No,No,7964
Indiana,2020/10/16,185.5065719,2298,23,145915,3887,No,No,7964
Indiana,2020/10/17,185.5065719,2485,31,148400,3918,No,No,7964
Indiana,2020/10/18,185.5065719,1605,19,150005,3937,No,No,7964
Indiana,2020/10/19,185.5065719,1583,23,151588,3960,No,No,7964
Indiana,2020/10/20,185.5065719,1500,48,153088,4008,No,No,7964
Indiana,2020/10/21,185.5065719,1734,15,154822,4023,No,No,7126
Indiana,2020/10/22,185.5065719,2856,42,157678,4065,No,No,7126
Indiana,2020/10/23,185.5065719,2467,27,160145,4092,No,No,7126
Indiana,2020/10/24,185.5065719,2741,26,162886,4118,No,No,7126
Indiana,2020/10/25,185.5065719,2152,12,165038,4130,No,No,7126
Indiana,2020/10/26,185.5065719,1972,13,167010,4143,No,No,7126
Indiana,2020/10/27,185.5065719,1986,51,168996,4194,No,No,7126
Indiana,2020/10/28,185.5065719,2570,33,171566,4227,No,No,7060
Indiana,2020/10/29,185.5065719,3624,33,175190,4260,No,No,7060
Indiana,2020/10/30,185.5065719,3182,26,178372,4286,No,No,7060
Indiana,2020/10/31,185.5065719,3465,46,181837,4332,No,No,7060
Indiana,2020/11/1,185.5065719,2752,32,184589,4364,No,No,7060
Indiana,2020/11/2,185.5065719,3076,26,187665,4390,No,No,7060
Indiana,2020/11/3,185.5065719,2890,49,190555,4439,No,No,7060
Indiana,2020/11/4,185.5065719,3706,25,194261,4464,No,No,8764
Indiana,2020/11/5,185.5065719,4423,47,198684,4511,No,No,8764
Indiana,2020/11/6,185.5065719,4648,36,203332,4547,No,No,8764
Indiana,2020/11/7,185.5065719,4911,45,208243,4592,No,No,8764
Indiana,2020/11/8,185.5065719,4652,37,212895,4629,No,No,8764
Indiana,2020/11/9,185.5065719,4133,35,217028,4664,No,No,8764
Indiana,2020/11/10,185.5065719,4866,67,221894,4731,No,No,8764
Indiana,2020/11/11,185.5065719,5041,31,226935,4762,No,No,9262
Indiana,2020/11/12,185.5065719,6605,51,233540,4813,No,No,9262
Indiana,2020/11/13,185.5065719,5599,50,239139,4863,No,No,9262
Indiana,2020/11/14,185.5065719,8327,25,247466,4888,No,No,9262
Indiana,2020/11/15,185.5065719,6706,22,254172,4910,No,No,9262
Indiana,2020/11/16,185.5065719,5146,26,259318,4936,No,No,9262
Indiana,2020/11/17,185.5065719,5492,89,264810,5025,No,No,9262
Indiana,2020/11/18,185.5065719,6037,59,270847,5084,No,No,11813
Indiana,2020/11/19,185.5065719,7295,59,278142,5143,No,No,11813
Indiana,2020/11/20,185.5065719,6818,63,284960,5206,No,No,11813
Indiana,2020/11/21,185.5065719,6878,40,291838,5246,No,No,11813
Indiana,2020/11/22,185.5065719,6183,59,298021,5305,No,No,11813
Indiana,2020/11/23,185.5065719,5554,27,303575,5332,No,No,11813
Indiana,2020/11/24,185.5065719,5643,103,309218,5435,No,No,11813
Indiana,2020/11/25,185.5065719,5994,63,315212,5498,No,No,7061
Indiana,2020/11/26,185.5065719,6383,63,321595,5561,No,No,7061
Indiana,2020/11/27,185.5065719,5639,33,327234,5594,No,No,7061
Indiana,2020/11/28,185.5065719,4491,69,331725,5663,No,No,7061
Indiana,2020/11/29,185.5065719,4302,22,336027,5685,No,No,7061
Indiana,2020/11/30,185.5065719,5667,38,341694,5723,No,No,7061
Indiana,2020/12/1,185.5065719,5403,141,347097,5864,No,No,7061
Indiana,2020/12/2,185.5065719,6625,109,353722,5973,No,No,7656
Indiana,2020/12/3,185.5065719,8460,60,362182,6033,No,No,7656
Indiana,2020/12/4,185.5065719,7909,89,370091,6122,No,No,7656
Indiana,2020/12/5,185.5065719,7699,85,377790,6207,No,No,7656
Indiana,2020/12/6,185.5065719,6601,35,384391,6242,No,No,7656
Indiana,2020/12/7,185.5065719,5657,42,390048,6284,No,No,7656
Indiana,2020/12/8,185.5065719,5401,126,395449,6410,No,No,7656
Indiana,2020/12/9,185.5065719,5770,96,401219,6506,No,No,7568
Indiana,2020/12/10,185.5065719,6536,97,407755,6603,No,No,7568
Indiana,2020/12/11,185.5065719,7206,70,414961,6673,No,No,7568
Indiana,2020/12/12,185.5065719,7407,85,422368,6758,No,No,7568
Indiana,2020/12/13,185.5065719,5907,47,428275,6805,No,No,7568
Indiana,2020/12/14,185.5065719,4967,35,433242,6840,No,No,7568
Indiana,2020/12/15,185.5065719,4271,128,437513,6968,No,No,7568
Indiana,2020/12/16,185.5065719,6221,133,443734,7101,No,No,7543
Indiana,2020/12/17,185.5065719,6340,79,450074,7180,No,No,7543
Indiana,2020/12/18,185.5065719,5954,85,456028,7265,No,No,7543
Indiana,2020/12/19,185.5065719,4738,73,460766,7338,No,No,7543
Indiana,2020/12/20,185.5065719,6492,66,467258,7404,No,No,7543
Indiana,2020/12/21,185.5065719,3866,34,471124,7438,No,No,7543
Indiana,2020/12/22,185.5065719,3673,143,474797,7581,No,No,7543
Indiana,2020/12/23,185.5065719,4679,64,479476,7645,No,No,5506
Indiana,2020/12/24,185.5065719,6205,85,485681,7730,No,No,5506
Indiana,2020/12/25,185.5065719,5444,40,491125,7770,No,No,5506
Indiana,2020/12/26,185.5065719,3842,31,494967,7801,No,No,5506
Indiana,2020/12/27,185.5065719,1828,42,496795,7843,No,No,5506
Indiana,2020/12/28,185.5065719,2461,43,499256,7886,No,No,5506
Indiana,2020/12/29,185.5065719,3986,165,503242,8051,No,No,5506
Indiana,2020/12/30,185.5065719,4737,109,507979,8160,No,No,10986
Indiana,2020/12/31,185.5065719,6476,103,514455,8263,No,No,10986
Indiana,2021/1/1,185.5065719,6295,108,520750,8371,No,No,10986
Indiana,2021/1/2,185.5065719,5315,39,526065,8410,No,No,10986
Indiana,2021/1/3,185.5065719,2989,65,529054,8475,No,No,10986
Indiana,2021/1/4,185.5065719,3617,39,532671,8514,No,No,10986
Indiana,2021/1/5,185.5065719,3413,149,536084,8663,No,No,10986
Indiana,2021/1/6,185.5065719,6151,80,542235,8743,No,No,14084
Indiana,2021/1/7,185.5065719,7279,80,549514,8823,No,No,14084
Indiana,2021/1/8,185.5065719,6099,69,555613,8892,No,No,14084
Indiana,2021/1/9,185.5065719,5966,74,561579,8966,No,No,14084
Indiana,2021/1/10,185.5065719,5091,19,566670,8985,No,No,14084
Indiana,2021/1/11,185.5065719,3685,31,570355,9016,No,No,14084
Indiana,2021/1/12,185.5065719,3150,88,573505,9104,No,No,14084
Indiana,2021/1/13,185.5065719,3648,59,577153,9163,No,No,11980
Indiana,2021/1/14,185.5065719,4381,39,581534,9202,No,No,11980
Indiana,2021/1/15,185.5065719,4672,44,586206,9246,No,No,11980
Indiana,2021/1/16,185.5065719,3887,41,590093,9287,No,No,11980
Indiana,2021/1/17,185.5065719,3169,23,593262,9310,No,No,11980
Indiana,2021/1/18,185.5065719,2498,30,595760,9340,No,No,11980
Indiana,2021/1/19,185.5065719,2734,126,598494,9466,No,No,11980
Indiana,2021/1/20,185.5065719,2886,63,601380,9529,No,No,11615
Indiana,2021/1/21,185.5065719,3624,64,605004,9593,No,No,11615
Indiana,2021/1/22,185.5065719,3494,49,608498,9642,No,No,11615
Indiana,2021/1/23,185.5065719,3102,51,611600,9693,No,No,11615
Indiana,2021/1/24,185.5065719,2520,23,614120,9716,No,No,11615
Indiana,2021/1/25,185.5065719,2190,12,616310,9728,No,No,11615
Indiana,2021/1/26,185.5065719,1727,79,618037,9807,No,No,11615
Indiana,2021/1/27,185.5065719,2238,38,620275,9845,No,No,12664
Indiana,2021/1/28,185.5065719,2819,34,623094,9879,No,No,12664
Indiana,2021/1/29,185.5065719,2636,46,625730,9925,No,No,12664
Indiana,2021/1/30,185.5065719,2339,42,628069,9967,No,No,12664
Indiana,2021/1/31,185.5065719,1724,7,629793,9974,No,No,12664
Indiana,2021/2/1,185.5065719,1709,15,631502,9989,No,No,12664
Indiana,2021/2/2,185.5065719,1541,65,633043,10054,No,No,12664
Indiana,2021/2/3,185.5065719,1427,37,634470,10091,No,No,13464
Indiana,2021/2/4,185.5065719,2360,1546,636830,11637,No,No,13464
Indiana,2021/2/5,185.5065719,1484,49,638314,11686,No,No,13464
Indiana,2021/2/6,185.5065719,2819,66,641133,11752,No,No,13464
Indiana,2021/2/7,185.5065719,1732,65,642865,11817,No,No,13464
Indiana,2021/2/8,185.5065719,1033,58,643898,11875,No,No,13464
Indiana,2021/2/9,185.5065719,1136,67,645034,11942,No,No,13464
Indiana,2021/2/10,185.5065719,1442,59,646476,12001,No,No,12087
Indiana,2021/2/11,185.5065719,1707,26,648183,12027,No,No,12087
Indiana,2021/2/12,185.5065719,1427,90,649610,12117,No,No,12087
Indiana,2021/2/13,185.5065719,1232,32,650842,12149,No,No,12087
Indiana,2021/2/14,185.5065719,1218,24,652060,12173,No,No,12087
Indiana,2021/2/15,185.5065719,776,18,652836,12191,No,No,12087
Indiana,2021/2/16,185.5065719,877,40,653713,12231,No,No,12087
Indiana,2021/2/17,185.5065719,923,19,654636,12250,No,No,11395
Indiana,2021/2/18,185.5065719,760,31,655396,12281,No,No,11395
Indiana,2021/2/19,185.5065719,1037,44,656433,12325,No,No,11395
Indiana,2021/2/20,185.5065719,1415,11,657848,12336,No,No,11395
Indiana,2021/2/21,185.5065719,882,36,658730,12372,No,No,11395
Indiana,2021/2/22,185.5065719,817,35,659547,12407,No,No,11395
Indiana,2021/2/23,185.5065719,682,43,660229,12450,No,No,11395
Indiana,2021/2/24,185.5065719,1012,17,661241,12467,No,No,11395
Indiana,2021/2/25,185.5065719,1091,27,662332,12494,No,No,11395
Indiana,2021/2/26,185.5065719,950,37,663282,12531,No,No,11395
Indiana,2021/2/27,185.5065719,867,25,664149,12556,No,No,11395
Indiana,2021/2/28,185.5065719,731,17,664880,12573,No,No,11395
Indiana,2021/3/1,185.5065719,542,22,665422,12595,No,No,11395
Indiana,2021/3/2,185.5065719,540,28,665962,12623,No,No,11395
Indiana,2021/3/3,185.5065719,769,10,666731,12633,No,No,11395
Indiana,2021/3/4,185.5065719,937,30,667668,12663,No,No,11395
Iowa,2020/3/1,56.05027536,0,0,0,0,No,No,1575
Iowa,2020/3/2,56.05027536,0,0,0,0,No,No,1575
Iowa,2020/3/3,56.05027536,0,0,0,0,No,No,1575
Iowa,2020/3/4,56.05027536,0,0,0,0,No,No,1663
Iowa,2020/3/5,56.05027536,0,0,0,0,No,No,1663
Iowa,2020/3/6,56.05027536,0,0,0,0,No,No,1663
Iowa,2020/3/7,56.05027536,0,0,0,0,No,No,1663
Iowa,2020/3/8,56.05027536,3,0,3,0,No,No,1663
Iowa,2020/3/9,56.05027536,5,0,8,0,No,No,1663
Iowa,2020/3/10,56.05027536,5,0,13,0,No,No,1663
Iowa,2020/3/11,56.05027536,1,0,14,0,No,No,1819
Iowa,2020/3/12,56.05027536,2,0,16,0,No,No,1819
Iowa,2020/3/13,56.05027536,1,0,17,0,No,No,1819
Iowa,2020/3/14,56.05027536,1,0,18,0,No,No,1819
Iowa,2020/3/15,56.05027536,4,0,22,0,No,No,1819
Iowa,2020/3/16,56.05027536,0,0,22,0,No,No,1819
Iowa,2020/3/17,56.05027536,7,0,29,0,No,No,1819
Iowa,2020/3/18,56.05027536,9,0,38,0,No,No,10892
Iowa,2020/3/19,56.05027536,6,0,44,0,No,No,10892
Iowa,2020/3/20,56.05027536,1,0,45,0,No,No,10892
Iowa,2020/3/21,56.05027536,23,0,68,0,No,No,10892
Iowa,2020/3/22,56.05027536,22,0,90,0,No,No,10892
Iowa,2020/3/23,56.05027536,15,0,105,0,No,No,10892
Iowa,2020/3/24,56.05027536,19,1,124,1,No,No,10892
Iowa,2020/3/25,56.05027536,23,0,147,1,No,No,80984
Iowa,2020/3/26,56.05027536,32,0,179,1,No,No,80984
Iowa,2020/3/27,56.05027536,57,2,236,3,No,No,80984
Iowa,2020/3/28,56.05027536,62,0,298,3,No,No,80984
Iowa,2020/3/29,56.05027536,38,1,336,4,No,No,80984
Iowa,2020/3/30,56.05027536,88,2,424,6,No,No,80984
Iowa,2020/3/31,56.05027536,74,1,498,7,No,No,80984
Iowa,2020/4/1,56.05027536,51,2,549,9,No,No,106739
Iowa,2020/4/2,56.05027536,65,2,614,11,No,No,106739
Iowa,2020/4/3,56.05027536,85,0,699,11,No,No,106739
Iowa,2020/4/4,56.05027536,87,0,786,11,No,No,106739
Iowa,2020/4/5,56.05027536,82,11,868,22,No,No,106739
Iowa,2020/4/6,56.05027536,78,3,946,25,No,No,106739
Iowa,2020/4/7,56.05027536,102,1,1048,26,No,No,106739
Iowa,2020/4/8,56.05027536,97,1,1145,27,No,No,77515
Iowa,2020/4/9,56.05027536,125,0,1270,27,No,No,77515
Iowa,2020/4/10,56.05027536,118,4,1388,31,No,No,77515
Iowa,2020/4/11,56.05027536,122,3,1510,34,No,No,77515
Iowa,2020/4/12,56.05027536,77,7,1587,41,No,No,77515
Iowa,2020/4/13,56.05027536,123,3,1710,44,No,No,77515
Iowa,2020/4/14,56.05027536,189,0,1899,44,No,No,77515
Iowa,2020/4/15,56.05027536,96,9,1995,53,No,No,66432
Iowa,2020/4/16,56.05027536,146,7,2141,60,No,No,66432
Iowa,2020/4/17,56.05027536,191,4,2332,64,No,No,66432
Iowa,2020/4/18,56.05027536,181,10,2513,74,No,No,66432
Iowa,2020/4/19,56.05027536,402,1,2915,75,No,No,66432
Iowa,2020/4/20,56.05027536,260,4,3175,79,No,No,66432
Iowa,2020/4/21,56.05027536,466,4,3641,83,No,No,66432
Iowa,2020/4/22,56.05027536,123,7,3764,90,No,No,74966
Iowa,2020/4/23,56.05027536,175,6,3939,96,No,No,74966
Iowa,2020/4/24,56.05027536,520,11,4459,107,No,No,74966
Iowa,2020/4/25,56.05027536,650,5,5109,112,No,No,74966
Iowa,2020/4/26,56.05027536,381,6,5490,118,No,No,74966
Iowa,2020/4/27,56.05027536,378,9,5868,127,No,No,74966
Iowa,2020/4/28,56.05027536,508,9,6376,136,No,No,74966
Iowa,2020/4/29,56.05027536,467,12,6843,148,No,No,28985
Iowa,2020/4/30,56.05027536,302,14,7145,162,No,No,28985
Iowa,2020/5/1,56.05027536,738,8,7883,170,No,No,28985
Iowa,2020/5/2,56.05027536,758,5,8641,175,No,No,28985
Iowa,2020/5/3,56.05027536,528,9,9169,184,No,No,28985
Iowa,2020/5/4,56.05027536,534,4,9703,188,No,No,28985
Iowa,2020/5/5,56.05027536,408,19,10111,207,No,No,28985
Iowa,2020/5/6,56.05027536,293,12,10404,219,No,No,26666
Iowa,2020/5/7,56.05027536,655,12,11059,231,No,No,26666
Iowa,2020/5/8,56.05027536,398,12,11457,243,No,No,26666
Iowa,2020/5/9,56.05027536,214,9,11671,252,No,No,26666
Iowa,2020/5/10,56.05027536,288,13,11959,265,No,No,26666
Iowa,2020/5/11,56.05027536,414,6,12373,271,No,No,26666
Iowa,2020/5/12,56.05027536,539,18,12912,289,No,No,26666
Iowa,2020/5/13,56.05027536,377,17,13289,306,No,No,25150
Iowa,2020/5/14,56.05027536,386,12,13675,318,No,No,25150
Iowa,2020/5/15,56.05027536,374,18,14049,336,No,No,25150
Iowa,2020/5/16,56.05027536,279,10,14328,346,No,No,25150
Iowa,2020/5/17,56.05027536,323,5,14651,351,No,No,25150
Iowa,2020/5/18,56.05027536,304,4,14955,355,No,No,25150
Iowa,2020/5/19,56.05027536,341,12,15296,367,No,No,25150
Iowa,2020/5/20,56.05027536,572,33,15868,400,No,No,27919
Iowa,2020/5/21,56.05027536,302,14,16170,414,No,No,27919
Iowa,2020/5/22,56.05027536,340,27,16510,441,No,No,27919
Iowa,2020/5/23,56.05027536,388,5,16898,446,No,No,27919
Iowa,2020/5/24,56.05027536,536,10,17434,456,No,No,27919
Iowa,2020/5/25,56.05027536,194,4,17628,460,No,No,27919
Iowa,2020/5/26,56.05027536,371,20,17999,480,No,No,27919
Iowa,2020/5/27,56.05027536,447,16,18446,496,No,No,21335
Iowa,2020/5/28,56.05027536,226,14,18672,510,No,No,21335
Iowa,2020/5/29,56.05027536,347,15,19019,525,No,No,21335
Iowa,2020/5/30,56.05027536,317,6,19336,531,No,No,21335
Iowa,2020/5/31,56.05027536,285,6,19621,537,No,No,21335
Iowa,2020/6/1,56.05027536,168,21,19789,558,No,No,21335
Iowa,2020/6/2,56.05027536,228,6,20017,564,No,No,21335
Iowa,2020/6/3,56.05027536,359,10,20376,574,No,No,19949
Iowa,2020/6/4,56.05027536,567,16,20943,590,No,No,19949
Iowa,2020/6/5,56.05027536,389,7,21332,597,No,No,19949
Iowa,2020/6/6,56.05027536,195,5,21527,602,No,No,19949
Iowa,2020/6/7,56.05027536,267,4,21794,606,No,No,19949
Iowa,2020/6/8,56.05027536,317,17,22111,623,No,No,19949
Iowa,2020/6/9,56.05027536,160,6,22271,629,No,No,19949
Iowa,2020/6/10,56.05027536,462,9,22733,638,No,No,18367
Iowa,2020/6/11,56.05027536,370,3,23103,641,No,No,18367
Iowa,2020/6/12,56.05027536,352,9,23455,650,No,No,18367
Iowa,2020/6/13,56.05027536,337,1,23792,651,No,No,18367
Iowa,2020/6/14,56.05027536,167,1,23959,652,No,No,18367
Iowa,2020/6/15,56.05027536,151,9,24110,661,No,No,18367
Iowa,2020/6/16,56.05027536,153,9,24263,670,No,No,18367
Iowa,2020/6/17,56.05027536,353,7,24616,677,No,No,18671
Iowa,2020/6/18,56.05027536,343,3,24959,680,No,No,18671
Iowa,2020/6/19,56.05027536,465,1,25424,681,No,No,18671
Iowa,2020/6/20,56.05027536,128,4,25552,685,No,No,18671
Iowa,2020/6/21,56.05027536,468,1,26020,686,No,No,18671
Iowa,2020/6/22,56.05027536,197,1,26217,687,No,No,18671
Iowa,2020/6/23,56.05027536,253,3,26470,690,No,No,18671
Iowa,2020/6/24,56.05027536,427,4,26897,694,No,No,18338
Iowa,2020/6/25,56.05027536,487,8,27384,702,No,No,18338
Iowa,2020/6/26,56.05027536,444,2,27828,704,No,No,18338
Iowa,2020/6/27,56.05027536,375,0,28203,704,No,No,18338
Iowa,2020/6/28,56.05027536,317,2,28520,706,No,No,18338
Iowa,2020/6/29,56.05027536,354,6,28874,712,No,No,18338
Iowa,2020/6/30,56.05027536,278,5,29152,717,No,No,18338
Iowa,2020/7/1,56.05027536,466,0,29618,717,No,No,19056
Iowa,2020/7/2,56.05027536,641,2,30259,719,No,No,19056
Iowa,2020/7/3,56.05027536,372,2,30631,721,No,No,19056
Iowa,2020/7/4,56.05027536,536,0,31167,721,No,No,19056
Iowa,2020/7/5,56.05027536,445,0,31612,721,No,No,19056
Iowa,2020/7/6,56.05027536,152,4,31764,725,No,No,19056
Iowa,2020/7/7,56.05027536,389,7,32153,732,No,No,19056
Iowa,2020/7/8,56.05027536,563,7,32716,739,No,No,20563
Iowa,2020/7/9,56.05027536,600,3,33316,742,No,No,20563
Iowa,2020/7/10,56.05027536,916,6,34232,748,No,No,20563
Iowa,2020/7/11,56.05027536,463,0,34695,748,No,No,20563
Iowa,2020/7/12,56.05027536,715,4,35410,752,No,No,20563
Iowa,2020/7/13,56.05027536,221,3,35631,755,No,No,20563
Iowa,2020/7/14,56.05027536,311,4,35942,759,No,No,20563
Iowa,2020/7/15,56.05027536,594,18,36536,777,No,No,23676
Iowa,2020/7/16,56.05027536,878,4,37414,781,No,No,23676
Iowa,2020/7/17,56.05027536,489,4,37903,785,No,No,23676
Iowa,2020/7/18,56.05027536,411,5,38314,790,No,No,23676
Iowa,2020/7/19,56.05027536,499,3,38813,793,No,No,23676
Iowa,2020/7/20,56.05027536,530,5,39343,798,No,No,23676
Iowa,2020/7/21,56.05027536,378,10,39721,808,No,No,23676
Iowa,2020/7/22,56.05027536,487,6,40208,814,No,No,17437
Iowa,2020/7/23,56.05027536,588,6,40796,820,No,No,17437
Iowa,2020/7/24,56.05027536,638,6,41434,826,No,No,17437
Iowa,2020/7/25,56.05027536,452,0,41886,826,No,No,17437
Iowa,2020/7/26,56.05027536,471,3,42357,829,No,No,17437
Iowa,2020/7/27,56.05027536,339,7,42696,836,No,No,17437
Iowa,2020/7/28,56.05027536,232,3,42928,839,No,No,17437
Iowa,2020/7/29,56.05027536,695,15,43623,854,No,No,11690
Iowa,2020/7/30,56.05027536,662,11,44285,865,No,No,11690
Iowa,2020/7/31,56.05027536,468,7,44753,872,No,No,11690
Iowa,2020/8/1,56.05027536,540,2,45293,874,No,No,11690
Iowa,2020/8/2,56.05027536,430,4,45723,878,No,No,11690
Iowa,2020/8/3,56.05027536,182,6,45905,884,No,No,11690
Iowa,2020/8/4,56.05027536,326,4,46231,888,No,No,11690
Iowa,2020/8/5,56.05027536,605,12,46836,900,No,No,9467
Iowa,2020/8/6,56.05027536,723,12,47559,912,No,No,9467
Iowa,2020/8/7,56.05027536,361,3,47920,915,No,No,9467
Iowa,2020/8/8,56.05027536,391,11,48311,926,No,No,9467
Iowa,2020/8/9,56.05027536,608,5,48919,931,No,No,9467
Iowa,2020/8/10,56.05027536,245,4,49164,935,No,No,9467
Iowa,2020/8/11,56.05027536,357,11,49521,946,No,No,9467
Iowa,2020/8/12,56.05027536,452,7,49973,953,No,No,11047
Iowa,2020/8/13,56.05027536,705,11,50678,964,No,No,11047
Iowa,2020/8/14,56.05027536,594,8,51272,972,No,No,11047
Iowa,2020/8/15,56.05027536,793,3,52065,975,No,No,11047
Iowa,2020/8/16,56.05027536,382,0,52447,975,No,No,11047
Iowa,2020/8/17,56.05027536,382,12,52829,987,No,No,11047
Iowa,2020/8/18,56.05027536,372,15,53201,1002,No,No,11047
Iowa,2020/8/19,56.05027536,340,9,53541,1011,No,No,8676
Iowa,2020/8/20,56.05027536,992,5,54533,1016,No,No,8676
Iowa,2020/8/21,56.05027536,798,14,55331,1030,No,No,8676
Iowa,2020/8/22,56.05027536,665,3,55996,1033,No,No,8676
Iowa,2020/8/23,56.05027536,445,4,56441,1037,No,No,8676
Iowa,2020/8/24,56.05027536,500,10,56941,1047,No,No,8676
Iowa,2020/8/25,56.05027536,665,12,57606,1059,No,No,8676
Iowa,2020/8/26,56.05027536,1258,18,58864,1077,No,No,8511
Iowa,2020/8/27,56.05027536,2620,14,61484,1091,No,No,8511
Iowa,2020/8/28,56.05027536,1344,17,62828,1108,No,No,8511
Iowa,2020/8/29,56.05027536,1008,2,63836,1110,No,No,8511
Iowa,2020/8/30,56.05027536,763,3,64599,1113,No,No,8511
Iowa,2020/8/31,56.05027536,653,7,65252,1120,No,No,8511
Iowa,2020/9/1,56.05027536,594,5,65846,1125,No,No,8511
Iowa,2020/9/2,56.05027536,617,9,66463,1134,No,No,8901
Iowa,2020/9/3,56.05027536,1230,3,67693,1137,No,No,8901
Iowa,2020/9/4,56.05027536,1064,21,68757,1158,No,No,8901
Iowa,2020/9/5,56.05027536,933,7,69690,1165,No,No,8901
Iowa,2020/9/6,56.05027536,520,2,70210,1167,No,No,8901
Iowa,2020/9/7,56.05027536,327,3,70537,1170,No,No,8901
Iowa,2020/9/8,56.05027536,481,15,71018,1185,No,No,8901
Iowa,2020/9/9,56.05027536,576,19,71594,1204,No,No,8848
Iowa,2020/9/10,56.05027536,954,4,72548,1208,No,No,8848
Iowa,2020/9/11,56.05027536,851,8,73399,1216,No,No,8848
Iowa,2020/9/12,56.05027536,805,2,74204,1218,No,No,8848
Iowa,2020/9/13,56.05027536,471,2,74675,1220,No,No,8848
Iowa,2020/9/14,56.05027536,394,13,75069,1233,No,No,8848
Iowa,2020/9/15,56.05027536,653,1,75722,1234,No,No,8848
Iowa,2020/9/16,56.05027536,958,14,76680,1248,No,No,8679
Iowa,2020/9/17,56.05027536,1185,9,77865,1257,No,No,8679
Iowa,2020/9/18,56.05027536,974,7,78839,1264,No,No,8679
Iowa,2020/9/19,56.05027536,946,1,79785,1265,No,No,8679
Iowa,2020/9/20,56.05027536,625,0,80410,1265,No,No,8679
Iowa,2020/9/21,56.05027536,596,19,81006,1284,No,No,8679
Iowa,2020/9/22,56.05027536,668,9,81674,1293,No,No,8679
Iowa,2020/9/23,56.05027536,1282,5,82956,1298,No,No,8805
Iowa,2020/9/24,56.05027536,1037,5,83993,1303,No,No,8805
Iowa,2020/9/25,56.05027536,1038,9,85031,1312,No,No,8805
Iowa,2020/9/26,56.05027536,877,2,85908,1314,No,No,8805
Iowa,2020/9/27,56.05027536,716,2,86624,1316,No,No,8805
Iowa,2020/9/28,56.05027536,632,8,87256,1324,No,No,8805
Iowa,2020/9/29,56.05027536,978,17,88234,1341,No,No,8805
Iowa,2020/9/30,56.05027536,1014,17,89248,1358,No,No,7732
Iowa,2020/10/1,56.05027536,1235,8,90483,1366,No,No,7732
Iowa,2020/10/2,56.05027536,1000,11,91483,1377,No,No,7732
Iowa,2020/10/3,56.05027536,819,4,92302,1381,No,No,7732
Iowa,2020/10/4,56.05027536,442,6,92744,1387,No,No,7732
Iowa,2020/10/5,56.05027536,517,12,93261,1399,No,No,7732
Iowa,2020/10/6,56.05027536,648,15,93909,1414,No,No,7732
Iowa,2020/10/7,56.05027536,1296,5,95205,1419,No,No,8581
Iowa,2020/10/8,56.05027536,1544,14,96749,1433,No,No,8581
Iowa,2020/10/9,56.05027536,1274,21,98023,1454,No,No,8581
Iowa,2020/10/10,56.05027536,1076,6,99099,1460,No,No,8581
Iowa,2020/10/11,56.05027536,842,2,99941,1462,No,No,8581
Iowa,2020/10/12,56.05027536,510,19,100451,1481,No,No,8581
Iowa,2020/10/13,56.05027536,1080,10,101531,1491,No,No,8581
Iowa,2020/10/14,56.05027536,1374,14,102905,1505,No,No,7964
Iowa,2020/10/15,56.05027536,1327,11,104232,1516,No,No,7964
Iowa,2020/10/16,56.05027536,1514,8,105746,1524,No,No,7964
Iowa,2020/10/17,56.05027536,952,4,106698,1528,No,No,7964
Iowa,2020/10/18,56.05027536,636,4,107334,1532,No,No,7964
Iowa,2020/10/19,56.05027536,780,16,108114,1548,No,No,7964
Iowa,2020/10/20,56.05027536,1096,28,109210,1576,No,No,7964
Iowa,2020/10/21,56.05027536,1234,18,110444,1594,No,No,7126
Iowa,2020/10/22,56.05027536,1798,23,112242,1617,No,No,7126
Iowa,2020/10/23,56.05027536,1354,12,113596,1629,No,No,7126
Iowa,2020/10/24,56.05027536,1356,5,114952,1634,No,No,7126
Iowa,2020/10/25,56.05027536,1286,1,116238,1635,No,No,7126
Iowa,2020/10/26,56.05027536,960,22,117198,1657,No,No,7126
Iowa,2020/10/27,56.05027536,1654,23,118852,1680,No,No,7126
Iowa,2020/10/28,56.05027536,2059,11,120911,1691,No,No,7060
Iowa,2020/10/29,56.05027536,2321,14,123232,1705,No,No,7060
Iowa,2020/10/30,56.05027536,2741,9,125973,1714,No,No,7060
Iowa,2020/10/31,56.05027536,2825,2,128798,1716,No,No,7060
Iowa,2020/11/1,56.05027536,2299,17,131097,1733,No,No,7060
Iowa,2020/11/2,56.05027536,1600,22,132697,1755,No,No,7060
Iowa,2020/11/3,56.05027536,1879,25,134576,1780,No,No,7060
Iowa,2020/11/4,56.05027536,2739,21,137315,1801,No,No,8764
Iowa,2020/11/5,56.05027536,5480,13,142795,1814,No,No,8764
Iowa,2020/11/6,56.05027536,3472,14,146267,1828,No,No,8764
Iowa,2020/11/7,56.05027536,4372,14,150639,1842,No,No,8764
Iowa,2020/11/8,56.05027536,4944,3,155583,1845,No,No,8764
Iowa,2020/11/9,56.05027536,4327,27,159910,1872,No,No,8764
Iowa,2020/11/10,56.05027536,3917,26,163827,1898,No,No,8764
Iowa,2020/11/11,56.05027536,4630,29,168457,1927,No,No,9262
Iowa,2020/11/12,56.05027536,4944,20,173401,1947,No,No,9262
Iowa,2020/11/13,56.05027536,5489,25,178890,1972,No,No,9262
Iowa,2020/11/14,56.05027536,4667,13,183557,1985,No,No,9262
Iowa,2020/11/15,56.05027536,2757,4,186314,1989,No,No,9262
Iowa,2020/11/16,56.05027536,3283,34,189597,2023,No,No,9262
Iowa,2020/11/17,56.05027536,3599,41,193196,2064,No,No,9262
Iowa,2020/11/18,56.05027536,4336,38,197532,2102,No,No,11813
Iowa,2020/11/19,56.05027536,4040,25,201572,2127,No,No,11813
Iowa,2020/11/20,56.05027536,4346,32,205918,2159,No,No,11813
Iowa,2020/11/21,56.05027536,3285,32,209203,2191,No,No,11813
Iowa,2020/11/22,56.05027536,2461,11,211664,2202,No,No,11813
Iowa,2020/11/23,56.05027536,3128,20,214792,2222,No,No,11813
Iowa,2020/11/24,56.05027536,2994,49,217786,2271,No,No,11813
Iowa,2020/11/25,56.05027536,3502,41,221288,2312,No,No,7061
Iowa,2020/11/26,56.05027536,2035,37,223323,2349,No,No,7061
Iowa,2020/11/27,56.05027536,1742,11,225065,2360,No,No,7061
Iowa,2020/11/28,56.05027536,2116,15,227181,2375,No,No,7061
Iowa,2020/11/29,56.05027536,1509,24,228690,2399,No,No,7061
Iowa,2020/11/30,56.05027536,1944,27,230634,2426,No,No,7061
Iowa,2020/12/1,56.05027536,2428,23,233062,2449,No,No,7061
Iowa,2020/12/2,56.05027536,3097,69,236159,2518,No,No,7656
Iowa,2020/12/3,56.05027536,2563,85,238722,2603,No,No,7656
Iowa,2020/12/4,56.05027536,2809,62,241531,2665,No,No,7656
Iowa,2020/12/5,56.05027536,1854,17,243385,2682,No,No,7656
Iowa,2020/12/6,56.05027536,1304,35,244689,2717,No,No,7656
Iowa,2020/12/7,56.05027536,1296,6,245985,2723,No,No,7656
Iowa,2020/12/8,56.05027536,252,192,246237,2915,No,No,7656
Iowa,2020/12/9,56.05027536,2545,102,248782,3017,No,No,7568
Iowa,2020/12/10,56.05027536,2245,99,251027,3116,No,No,7568
Iowa,2020/12/11,56.05027536,2585,77,253612,3193,No,No,7568
Iowa,2020/12/12,56.05027536,1397,15,255009,3208,No,No,7568
Iowa,2020/12/13,56.05027536,1240,1,256249,3209,No,No,7568
Iowa,2020/12/14,56.05027536,653,60,256902,3269,No,No,7568
Iowa,2020/12/15,56.05027536,1351,68,258253,3337,No,No,7568
Iowa,2020/12/16,56.05027536,2531,17,260784,3354,No,No,7543
Iowa,2020/12/17,56.05027536,1426,97,262210,3451,No,No,7543
Iowa,2020/12/18,56.05027536,2519,0,264729,3451,No,No,7543
Iowa,2020/12/19,56.05027536,2230,82,266959,3533,No,No,7543
Iowa,2020/12/20,56.05027536,370,56,267329,3589,No,No,7543
Iowa,2020/12/21,56.05027536,1407,0,268736,3589,No,No,7543
Iowa,2020/12/22,56.05027536,1558,64,270294,3653,No,No,7543
Iowa,2020/12/23,56.05027536,1818,15,272112,3668,No,No,5506
Iowa,2020/12/24,56.05027536,1549,71,273661,3739,No,No,5506
Iowa,2020/12/25,56.05027536,605,5,274266,3744,No,No,5506
Iowa,2020/12/26,56.05027536,527,0,274793,3744,No,No,5506
Iowa,2020/12/27,56.05027536,506,1,275299,3745,No,No,5506
Iowa,2020/12/28,56.05027536,1350,0,276649,3745,No,No,5506
Iowa,2020/12/29,56.05027536,1661,67,278310,3812,No,No,5506
Iowa,2020/12/30,56.05027536,1757,10,280067,3822,No,No,10986
Iowa,2020/12/31,56.05027536,1645,69,281712,3891,No,No,10986
Iowa,2021/1/1,56.05027536,1268,7,282980,3898,No,No,10986
Iowa,2021/1/2,56.05027536,915,48,283895,3946,No,No,10986
Iowa,2021/1/3,56.05027536,820,0,284715,3946,No,No,10986
Iowa,2021/1/4,56.05027536,1641,46,286356,3992,No,No,10986
Iowa,2021/1/5,56.05027536,1942,7,288298,3999,No,No,10986
Iowa,2021/1/6,56.05027536,2478,61,290776,4060,No,No,14084
Iowa,2021/1/7,56.05027536,2413,5,293189,4065,No,No,14084
Iowa,2021/1/8,56.05027536,1573,59,294762,4124,No,No,14084
Iowa,2021/1/9,56.05027536,1409,3,296171,4127,No,No,14084
Iowa,2021/1/10,56.05027536,511,11,296682,4138,No,No,14084
Iowa,2021/1/11,56.05027536,1092,1,297774,4139,No,No,14084
Iowa,2021/1/12,56.05027536,1480,83,299254,4222,No,No,14084
Iowa,2021/1/13,56.05027536,1907,10,301161,4232,No,No,11980
Iowa,2021/1/14,56.05027536,1398,19,302559,4251,No,No,11980
Iowa,2021/1/15,56.05027536,1368,6,303927,4257,No,No,11980
Iowa,2021/1/16,56.05027536,821,64,304748,4321,No,No,11980
Iowa,2021/1/17,56.05027536,403,2,305151,4323,No,No,11980
Iowa,2021/1/18,56.05027536,931,1,306082,4324,No,No,11980
Iowa,2021/1/19,56.05027536,1220,8,307302,4332,No,No,11980
Iowa,2021/1/20,56.05027536,1485,62,308787,4394,No,No,11615
Iowa,2021/1/21,56.05027536,1653,51,310440,4445,No,No,11615
Iowa,2021/1/22,56.05027536,1255,33,311695,4478,No,No,11615
Iowa,2021/1/23,56.05027536,930,8,312625,4486,No,No,11615
Iowa,2021/1/24,56.05027536,515,1,313140,4487,No,No,11615
Iowa,2021/1/25,56.05027536,767,1,313907,4488,No,No,11615
Iowa,2021/1/26,56.05027536,1095,4,315002,4492,No,No,11615
Iowa,2021/1/27,56.05027536,1112,8,316114,4500,No,No,12664
Iowa,2021/1/28,56.05027536,1010,32,317124,4532,No,No,12664
Iowa,2021/1/29,56.05027536,565,45,317689,4577,No,No,12664
Iowa,2021/1/30,56.05027536,1421,74,319110,4651,No,No,12664
Iowa,2021/1/31,56.05027536,298,250,319408,4901,No,No,12664
Iowa,2021/2/1,56.05027536,779,5,320187,4906,No,No,12664
Iowa,2021/2/2,56.05027536,1087,13,321274,4919,No,No,12664
Iowa,2021/2/3,56.05027536,1034,56,322308,4975,No,No,13464
Iowa,2021/2/4,56.05027536,908,58,323216,5033,No,No,13464
Iowa,2021/2/5,56.05027536,581,34,323797,5067,No,No,13464
Iowa,2021/2/6,56.05027536,509,41,324306,5108,No,No,13464
Iowa,2021/2/7,56.05027536,284,0,324590,5108,No,No,13464
Iowa,2021/2/8,56.05027536,629,2,325219,5110,No,No,13464
Iowa,2021/2/9,56.05027536,931,35,326150,5145,No,No,13464
Iowa,2021/2/10,56.05027536,911,29,327061,5174,No,No,12087
Iowa,2021/2/11,56.05027536,371,22,327432,5196,No,No,12087
Iowa,2021/2/12,56.05027536,1133,27,328565,5223,No,No,12087
Iowa,2021/2/13,56.05027536,474,13,329039,5236,No,No,12087
Iowa,2021/2/14,56.05027536,219,0,329258,5236,No,No,12087
Iowa,2021/2/15,56.05027536,468,1,329726,5237,No,No,12087
Iowa,2021/2/16,56.05027536,592,26,330318,5263,No,No,12087
Iowa,2021/2/17,56.05027536,588,43,330906,5306,No,No,11395
Iowa,2021/2/18,56.05027536,596,15,331502,5321,No,No,11395
Iowa,2021/2/19,56.05027536,245,15,331747,5336,No,No,11395
Iowa,2021/2/20,56.05027536,478,0,332225,5336,No,No,11395
Iowa,2021/2/21,56.05027536,415,0,332640,5336,No,No,11395
Iowa,2021/2/22,56.05027536,447,38,333087,5374,No,No,11395
Iowa,2021/2/23,56.05027536,875,26,333962,5400,No,No,11395
Iowa,2021/2/24,56.05027536,703,15,334665,5415,No,No,11395
Iowa,2021/2/25,56.05027536,557,23,335222,5438,No,No,11395
Iowa,2021/2/26,56.05027536,618,25,335840,5463,No,No,11395
Iowa,2021/2/27,56.05027536,430,7,336270,5470,No,No,11395
Iowa,2021/2/28,56.05027536,185,0,336455,5470,No,No,11395
Iowa,2021/3/1,56.05027536,435,2,336890,5472,No,No,11395
Iowa,2021/3/2,56.05027536,606,26,337496,5498,No,No,11395
Iowa,2021/3/3,56.05027536,513,3,338009,5501,No,No,11395
Iowa,2021/3/4,56.05027536,579,35,338588,5536,No,No,11395
Kansas,2020/3/1,35.41420305,0,0,0,0,No,No,1575
Kansas,2020/3/2,35.41420305,0,0,0,0,No,No,1575
Kansas,2020/3/3,35.41420305,0,0,0,0,No,No,1575
Kansas,2020/3/4,35.41420305,0,0,0,0,No,No,1663
Kansas,2020/3/5,35.41420305,0,0,0,0,No,No,1663
Kansas,2020/3/6,35.41420305,0,0,0,0,No,No,1663
Kansas,2020/3/7,35.41420305,1,0,1,0,No,No,1663
Kansas,2020/3/8,35.41420305,0,0,1,0,No,No,1663
Kansas,2020/3/9,35.41420305,0,0,1,0,No,No,1663
Kansas,2020/3/10,35.41420305,0,0,1,0,No,No,1663
Kansas,2020/3/11,35.41420305,0,0,1,0,No,No,1819
Kansas,2020/3/12,35.41420305,4,1,5,1,No,No,1819
Kansas,2020/3/13,35.41420305,1,0,6,1,No,No,1819
Kansas,2020/3/14,35.41420305,2,0,8,1,No,No,1819
Kansas,2020/3/15,35.41420305,1,0,9,1,No,No,1819
Kansas,2020/3/16,35.41420305,2,0,11,1,No,No,1819
Kansas,2020/3/17,35.41420305,6,0,17,1,No,No,1819
Kansas,2020/3/18,35.41420305,5,0,22,1,No,No,10892
Kansas,2020/3/19,35.41420305,13,0,35,1,No,No,10892
Kansas,2020/3/20,35.41420305,14,0,49,1,No,No,10892
Kansas,2020/3/21,35.41420305,8,1,57,2,No,No,10892
Kansas,2020/3/22,35.41420305,9,0,66,2,No,No,10892
Kansas,2020/3/23,35.41420305,16,0,82,2,No,No,10892
Kansas,2020/3/24,35.41420305,20,1,102,3,No,No,10892
Kansas,2020/3/25,35.41420305,32,0,134,3,No,No,80984
Kansas,2020/3/26,35.41420305,39,0,173,3,No,No,80984
Kansas,2020/3/27,35.41420305,40,1,213,4,No,No,80984
Kansas,2020/3/28,35.41420305,59,2,272,6,No,No,80984
Kansas,2020/3/29,35.41420305,61,1,333,7,No,No,80984
Kansas,2020/3/30,35.41420305,41,2,374,9,Yes,No,80984
Kansas,2020/3/31,35.41420305,61,1,435,10,Yes,No,80984
Kansas,2020/4/1,35.41420305,54,1,489,11,Yes,No,106739
Kansas,2020/4/2,35.41420305,65,3,554,14,Yes,No,106739
Kansas,2020/4/3,35.41420305,71,5,625,19,Yes,No,106739
Kansas,2020/4/4,35.41420305,77,2,702,21,Yes,No,106739
Kansas,2020/4/5,35.41420305,67,2,769,23,Yes,No,106739
Kansas,2020/4/6,35.41420305,85,2,854,25,Yes,No,106739
Kansas,2020/4/7,35.41420305,51,5,905,30,Yes,No,106739
Kansas,2020/4/8,35.41420305,150,8,1055,38,Yes,No,77515
Kansas,2020/4/9,35.41420305,61,4,1116,42,Yes,No,77515
Kansas,2020/4/10,35.41420305,64,8,1180,50,Yes,No,77515
Kansas,2020/4/11,35.41420305,102,5,1282,55,Yes,No,77515
Kansas,2020/4/12,35.41420305,55,1,1337,56,Yes,No,77515
Kansas,2020/4/13,35.41420305,47,7,1384,63,Yes,No,77515
Kansas,2020/4/14,35.41420305,56,6,1440,69,Yes,No,77515
Kansas,2020/4/15,35.41420305,63,7,1503,76,Yes,No,66432
Kansas,2020/4/16,35.41420305,92,4,1595,80,Yes,No,66432
Kansas,2020/4/17,35.41420305,137,4,1732,84,Yes,No,66432
Kansas,2020/4/18,35.41420305,88,2,1820,86,Yes,No,66432
Kansas,2020/4/19,35.41420305,77,8,1897,94,Yes,No,66432
Kansas,2020/4/20,35.41420305,133,7,2030,101,Yes,No,66432
Kansas,2020/4/21,35.41420305,84,6,2114,107,Yes,No,66432
Kansas,2020/4/22,35.41420305,177,4,2291,111,Yes,No,74966
Kansas,2020/4/23,35.41420305,335,1,2626,112,Yes,No,74966
Kansas,2020/4/24,35.41420305,216,5,2842,117,Yes,No,74966
Kansas,2020/4/25,35.41420305,249,2,3091,119,Yes,No,74966
Kansas,2020/4/26,35.41420305,107,1,3198,120,Yes,No,74966
Kansas,2020/4/27,35.41420305,209,6,3407,126,Yes,No,74966
Kansas,2020/4/28,35.41420305,194,1,3601,127,Yes,No,74966
Kansas,2020/4/29,35.41420305,210,5,3811,132,Yes,No,28985
Kansas,2020/4/30,35.41420305,494,1,4305,133,Yes,No,28985
Kansas,2020/5/1,35.41420305,205,3,4510,136,Yes,No,28985
Kansas,2020/5/2,35.41420305,353,4,4863,140,Yes,No,28985
Kansas,2020/5/3,35.41420305,314,2,5177,142,Yes,No,28985
Kansas,2020/5/4,35.41420305,208,12,5385,154,No,No,28985
Kansas,2020/5/5,35.41420305,242,6,5627,160,No,No,28985
Kansas,2020/5/6,35.41420305,266,3,5893,163,No,No,26666
Kansas,2020/5/7,35.41420305,347,1,6240,164,No,No,26666
Kansas,2020/5/8,35.41420305,511,3,6751,167,No,No,26666
Kansas,2020/5/9,35.41420305,172,5,6923,172,No,No,26666
Kansas,2020/5/10,35.41420305,122,0,7045,172,No,No,26666
Kansas,2020/5/11,35.41420305,116,2,7161,174,No,No,26666
Kansas,2020/5/12,35.41420305,191,4,7352,178,No,No,26666
Kansas,2020/5/13,35.41420305,200,1,7552,179,No,No,25150
Kansas,2020/5/14,35.41420305,116,2,7668,181,No,No,25150
Kansas,2020/5/15,35.41420305,338,6,8006,187,No,No,25150
Kansas,2020/5/16,35.41420305,53,2,8059,189,No,No,25150
Kansas,2020/5/17,35.41420305,7,0,8066,189,No,No,25150
Kansas,2020/5/18,35.41420305,373,1,8439,190,No,No,25150
Kansas,2020/5/19,35.41420305,49,3,8488,193,No,No,25150
Kansas,2020/5/20,35.41420305,173,4,8661,197,No,No,27919
Kansas,2020/5/21,35.41420305,110,2,8771,199,No,No,27919
Kansas,2020/5/22,35.41420305,297,1,9068,200,No,No,27919
Kansas,2020/5/23,35.41420305,51,0,9119,200,No,No,27919
Kansas,2020/5/24,35.41420305,16,0,9135,200,No,No,27919
Kansas,2020/5/25,35.41420305,137,1,9272,201,No,No,27919
Kansas,2020/5/26,35.41420305,80,3,9352,204,No,No,27919
Kansas,2020/5/27,35.41420305,101,3,9453,207,No,No,21335
Kansas,2020/5/28,35.41420305,60,2,9513,209,No,No,21335
Kansas,2020/5/29,35.41420305,313,0,9826,209,No,No,21335
Kansas,2020/5/30,35.41420305,21,0,9847,209,No,No,21335
Kansas,2020/5/31,35.41420305,31,2,9878,211,No,No,21335
Kansas,2020/6/1,35.41420305,225,6,10103,217,No,No,21335
Kansas,2020/6/2,35.41420305,40,10,10143,227,No,No,21335
Kansas,2020/6/3,35.41420305,138,0,10281,227,No,No,19949
Kansas,2020/6/4,35.41420305,51,3,10332,230,No,No,19949
Kansas,2020/6/5,35.41420305,161,3,10493,233,No,No,19949
Kansas,2020/6/6,35.41420305,24,1,10517,234,No,No,19949
Kansas,2020/6/7,35.41420305,32,0,10549,234,No,No,19949
Kansas,2020/6/8,35.41420305,175,3,10724,237,No,No,19949
Kansas,2020/6/9,35.41420305,62,1,10786,238,No,No,19949
Kansas,2020/6/10,35.41420305,145,3,10931,241,No,No,18367
Kansas,2020/6/11,35.41420305,53,1,10984,242,No,No,18367
Kansas,2020/6/12,35.41420305,168,1,11152,243,No,No,18367
Kansas,2020/6/13,35.41420305,43,1,11195,244,No,No,18367
Kansas,2020/6/14,35.41420305,52,0,11247,244,No,No,18367
Kansas,2020/6/15,35.41420305,269,2,11516,246,No,No,18367
Kansas,2020/6/16,35.41420305,53,0,11569,246,No,No,18367
Kansas,2020/6/17,35.41420305,232,2,11801,248,No,No,18671
Kansas,2020/6/18,35.41420305,85,4,11886,252,No,No,18671
Kansas,2020/6/19,35.41420305,282,2,12168,254,No,No,18671
Kansas,2020/6/20,35.41420305,50,3,12218,257,No,No,18671
Kansas,2020/6/21,35.41420305,40,1,12258,258,No,No,18671
Kansas,2020/6/22,35.41420305,318,2,12576,260,No,No,18671
Kansas,2020/6/23,35.41420305,83,1,12659,261,No,No,18671
Kansas,2020/6/24,35.41420305,451,1,13110,262,No,No,18338
Kansas,2020/6/25,35.41420305,97,1,13207,263,No,No,18338
Kansas,2020/6/26,35.41420305,522,3,13729,266,No,No,18338
Kansas,2020/6/27,35.41420305,38,3,13767,269,No,No,18338
Kansas,2020/6/28,35.41420305,249,3,14016,272,No,No,18338
Kansas,2020/6/29,35.41420305,552,4,14568,276,No,No,18338
Kansas,2020/6/30,35.41420305,61,0,14629,276,No,No,18338
Kansas,2020/7/1,35.41420305,513,4,15142,280,No,No,19056
Kansas,2020/7/2,35.41420305,84,2,15226,282,No,No,19056
Kansas,2020/7/3,35.41420305,789,1,16015,283,No,Yes,19056
Kansas,2020/7/4,35.41420305,150,1,16165,284,No,Yes,19056
Kansas,2020/7/5,35.41420305,124,3,16289,287,No,Yes,19056
Kansas,2020/7/6,35.41420305,793,1,17082,288,No,Yes,19056
Kansas,2020/7/7,35.41420305,75,2,17157,290,No,Yes,19056
Kansas,2020/7/8,35.41420305,650,1,17807,291,No,Yes,20563
Kansas,2020/7/9,35.41420305,224,3,18031,294,No,Yes,20563
Kansas,2020/7/10,35.41420305,768,0,18799,294,No,Yes,20563
Kansas,2020/7/11,35.41420305,184,0,18983,294,No,Yes,20563
Kansas,2020/7/12,35.41420305,312,6,19295,300,No,Yes,20563
Kansas,2020/7/13,35.41420305,970,1,20265,301,No,Yes,20563
Kansas,2020/7/14,35.41420305,82,2,20347,303,No,Yes,20563
Kansas,2020/7/15,35.41420305,810,5,21157,308,No,Yes,23676
Kansas,2020/7/16,35.41420305,116,1,21273,309,No,Yes,23676
Kansas,2020/7/17,35.41420305,926,1,22199,310,No,Yes,23676
Kansas,2020/7/18,35.41420305,39,2,22238,312,No,Yes,23676
Kansas,2020/7/19,35.41420305,221,1,22459,313,No,Yes,23676
Kansas,2020/7/20,35.41420305,1085,5,23544,318,No,Yes,23676
Kansas,2020/7/21,35.41420305,62,1,23606,319,No,Yes,23676
Kansas,2020/7/22,35.41420305,770,5,24376,324,No,Yes,17437
Kansas,2020/7/23,35.41420305,142,2,24518,326,No,Yes,17437
Kansas,2020/7/24,35.41420305,885,4,25403,330,No,Yes,17437
Kansas,2020/7/25,35.41420305,61,3,25464,333,No,Yes,17437
Kansas,2020/7/26,35.41420305,185,2,25649,335,No,Yes,17437
Kansas,2020/7/27,35.41420305,790,3,26439,338,No,Yes,17437
Kansas,2020/7/28,35.41420305,55,6,26494,344,No,Yes,17437
Kansas,2020/7/29,35.41420305,683,5,27177,349,No,Yes,11690
Kansas,2020/7/30,35.41420305,67,8,27244,357,No,Yes,11690
Kansas,2020/7/31,35.41420305,877,1,28121,358,No,Yes,11690
Kansas,2020/8/1,35.41420305,26,0,28147,358,No,Yes,11690
Kansas,2020/8/2,35.41420305,194,3,28341,361,No,Yes,11690
Kansas,2020/8/3,35.41420305,859,5,29200,366,No,Yes,11690
Kansas,2020/8/4,35.41420305,59,1,29259,367,No,Yes,11690
Kansas,2020/8/5,35.41420305,788,4,30047,371,No,Yes,9467
Kansas,2020/8/6,35.41420305,106,5,30153,376,No,Yes,9467
Kansas,2020/8/7,35.41420305,813,4,30966,380,No,Yes,9467
Kansas,2020/8/8,35.41420305,26,0,30992,380,No,Yes,9467
Kansas,2020/8/9,35.41420305,153,0,31145,380,No,Yes,9467
Kansas,2020/8/10,35.41420305,949,7,32094,387,No,Yes,9467
Kansas,2020/8/11,35.41420305,87,1,32181,388,No,Yes,9467
Kansas,2020/8/12,35.41420305,796,9,32977,397,No,Yes,11047
Kansas,2020/8/13,35.41420305,110,6,33087,403,No,Yes,11047
Kansas,2020/8/14,35.41420305,1159,1,34246,404,No,Yes,11047
Kansas,2020/8/15,35.41420305,48,2,34294,406,No,Yes,11047
Kansas,2020/8/16,35.41420305,201,0,34495,406,No,Yes,11047
Kansas,2020/8/17,35.41420305,1049,4,35544,410,No,Yes,11047
Kansas,2020/8/18,35.41420305,88,5,35632,415,No,Yes,11047
Kansas,2020/8/19,35.41420305,701,5,36333,420,No,Yes,8676
Kansas,2020/8/20,35.41420305,112,3,36445,423,No,Yes,8676
Kansas,2020/8/21,35.41420305,966,7,37411,430,No,Yes,8676
Kansas,2020/8/22,35.41420305,133,1,37544,431,No,Yes,8676
Kansas,2020/8/23,35.41420305,182,0,37726,431,No,Yes,8676
Kansas,2020/8/24,35.41420305,1282,1,39008,432,No,Yes,8676
Kansas,2020/8/25,35.41420305,81,1,39089,433,No,Yes,8676
Kansas,2020/8/26,35.41420305,1475,12,40564,445,No,Yes,8511
Kansas,2020/8/27,35.41420305,138,1,40702,446,No,Yes,8511
Kansas,2020/8/28,35.41420305,1106,2,41808,448,No,Yes,8511
Kansas,2020/8/29,35.41420305,101,1,41909,449,No,Yes,8511
Kansas,2020/8/30,35.41420305,102,1,42011,450,No,Yes,8511
Kansas,2020/8/31,35.41420305,1396,1,43407,451,No,Yes,8511
Kansas,2020/9/1,35.41420305,84,3,43491,454,No,Yes,8511
Kansas,2020/9/2,35.41420305,1038,4,44529,458,No,Yes,8901
Kansas,2020/9/3,35.41420305,226,17,44755,475,No,Yes,8901
Kansas,2020/9/4,35.41420305,1294,6,46049,481,No,Yes,8901
Kansas,2020/9/5,35.41420305,2,1,46051,482,No,Yes,8901
Kansas,2020/9/6,35.41420305,100,1,46151,483,No,Yes,8901
Kansas,2020/9/7,35.41420305,1258,2,47409,485,No,Yes,8901
Kansas,2020/9/8,35.41420305,469,1,47878,486,No,Yes,8901
Kansas,2020/9/9,35.41420305,511,11,48389,497,No,Yes,8848
Kansas,2020/9/10,35.41420305,54,2,48443,499,No,Yes,8848
Kansas,2020/9/11,35.41420305,950,21,49393,520,No,Yes,8848
Kansas,2020/9/12,35.41420305,5,13,49398,533,No,Yes,8848
Kansas,2020/9/13,35.41420305,10,3,49408,536,No,Yes,8848
Kansas,2020/9/14,35.41420305,1463,10,50871,546,No,Yes,8848
Kansas,2020/9/15,35.41420305,135,9,51006,555,No,Yes,8848
Kansas,2020/9/16,35.41420305,823,31,51829,586,No,Yes,8679
Kansas,2020/9/17,35.41420305,210,0,52039,586,No,Yes,8679
Kansas,2020/9/18,35.41420305,1364,10,53403,596,No,Yes,8679
Kansas,2020/9/19,35.41420305,17,0,53420,596,No,Yes,8679
Kansas,2020/9/20,35.41420305,13,1,53433,597,No,Yes,8679
Kansas,2020/9/21,35.41420305,1523,7,54956,604,No,Yes,8679
Kansas,2020/9/22,35.41420305,281,14,55237,618,No,Yes,8679
Kansas,2020/9/23,35.41420305,1118,11,56355,629,No,Yes,8805
Kansas,2020/9/24,35.41420305,106,4,56461,633,No,Yes,8805
Kansas,2020/9/25,35.41420305,1391,1,57852,634,No,Yes,8805
Kansas,2020/9/26,35.41420305,0,0,57852,634,No,Yes,8805
Kansas,2020/9/27,35.41420305,126,2,57978,636,No,Yes,8805
Kansas,2020/9/28,35.41420305,1815,5,59793,641,No,Yes,8805
Kansas,2020/9/29,35.41420305,158,9,59951,650,No,Yes,8805
Kansas,2020/9/30,35.41420305,1006,28,60957,678,No,Yes,7732
Kansas,2020/10/1,35.41420305,146,0,61103,678,No,Yes,7732
Kansas,2020/10/2,35.41420305,1321,21,62424,699,No,Yes,7732
Kansas,2020/10/3,35.41420305,22,-1,62446,698,No,Yes,7732
Kansas,2020/10/4,35.41420305,33,0,62479,698,No,Yes,7732
Kansas,2020/10/5,35.41420305,1338,8,63817,706,No,Yes,7732
Kansas,2020/10/6,35.41420305,260,0,64077,706,No,Yes,7732
Kansas,2020/10/7,35.41420305,1054,19,65131,725,No,Yes,8581
Kansas,2020/10/8,35.41420305,165,16,65296,741,No,Yes,8581
Kansas,2020/10/9,35.41420305,1790,24,67086,765,No,Yes,8581
Kansas,2020/10/10,35.41420305,107,3,67193,768,No,Yes,8581
Kansas,2020/10/11,35.41420305,38,1,67231,769,No,Yes,8581
Kansas,2020/10/12,35.41420305,1927,5,69158,774,No,Yes,8581
Kansas,2020/10/13,35.41420305,234,12,69392,786,No,Yes,8581
Kansas,2020/10/14,35.41420305,1273,52,70665,838,No,Yes,7964
Kansas,2020/10/15,35.41420305,150,0,70815,838,No,Yes,7964
Kansas,2020/10/16,35.41420305,1694,21,72509,859,No,Yes,7964
Kansas,2020/10/17,35.41420305,107,0,72616,859,No,Yes,7964
Kansas,2020/10/18,35.41420305,106,0,72722,859,No,Yes,7964
Kansas,2020/10/19,35.41420305,1894,13,74616,872,No,Yes,7964
Kansas,2020/10/20,35.41420305,267,30,74883,902,No,Yes,7964
Kansas,2020/10/21,35.41420305,1416,50,76299,952,No,Yes,7126
Kansas,2020/10/22,35.41420305,247,0,76546,952,No,Yes,7126
Kansas,2020/10/23,35.41420305,1576,23,78122,975,No,Yes,7126
Kansas,2020/10/24,35.41420305,55,0,78177,975,No,Yes,7126
Kansas,2020/10/25,35.41420305,64,0,78241,975,No,Yes,7126
Kansas,2020/10/26,35.41420305,2232,1,80473,976,No,Yes,7126
Kansas,2020/10/27,35.41420305,288,3,80761,979,No,Yes,7126
Kansas,2020/10/28,35.41420305,2724,28,83485,1007,No,Yes,7060
Kansas,2020/10/29,35.41420305,353,1,83838,1008,No,Yes,7060
Kansas,2020/10/30,35.41420305,2930,21,86768,1029,No,Yes,7060
Kansas,2020/10/31,35.41420305,3,0,86771,1029,No,Yes,7060
Kansas,2020/11/1,35.41420305,38,0,86809,1029,No,Yes,7060
Kansas,2020/11/2,35.41420305,3804,17,90613,1046,No,Yes,7060
Kansas,2020/11/3,35.41420305,459,5,91072,1051,No,Yes,7060
Kansas,2020/11/4,35.41420305,2895,36,93967,1087,No,Yes,8764
Kansas,2020/11/5,35.41420305,460,0,94427,1087,No,Yes,8764
Kansas,2020/11/6,35.41420305,5178,85,99605,1172,No,Yes,8764
Kansas,2020/11/7,35.41420305,66,-6,99671,1166,No,Yes,8764
Kansas,2020/11/8,35.41420305,134,0,99805,1166,No,Yes,8764
Kansas,2020/11/9,35.41420305,5493,15,105298,1181,No,Yes,8764
Kansas,2020/11/10,35.41420305,462,0,105760,1181,No,Yes,8764
Kansas,2020/11/11,35.41420305,5217,34,110977,1215,No,Yes,9262
Kansas,2020/11/12,35.41420305,526,0,111503,1215,No,Yes,9262
Kansas,2020/11/13,35.41420305,5779,41,117282,1256,No,Yes,9262
Kansas,2020/11/14,35.41420305,446,0,117728,1256,No,Yes,9262
Kansas,2020/11/15,35.41420305,123,0,117851,1256,No,Yes,9262
Kansas,2020/11/16,35.41420305,6846,10,124697,1266,No,Yes,9262
Kansas,2020/11/17,35.41420305,971,0,125668,1266,No,Yes,9262
Kansas,2020/11/18,35.41420305,5383,60,131051,1326,No,Yes,11813
Kansas,2020/11/19,35.41420305,357,0,131408,1326,No,Yes,11813
Kansas,2020/11/20,35.41420305,5816,84,137224,1410,No,Yes,11813
Kansas,2020/11/21,35.41420305,71,1,137295,1411,No,Yes,11813
Kansas,2020/11/22,35.41420305,235,-1,137530,1410,No,Yes,11813
Kansas,2020/11/23,35.41420305,7301,52,144831,1462,No,Yes,11813
Kansas,2020/11/24,35.41420305,441,-6,145272,1456,No,Yes,11813
Kansas,2020/11/25,35.41420305,5243,47,150515,1503,No,Yes,7061
Kansas,2020/11/26,35.41420305,7,0,150522,1503,No,Yes,7061
Kansas,2020/11/27,35.41420305,4723,26,155245,1529,No,Yes,7061
Kansas,2020/11/28,35.41420305,20,0,155265,1529,No,Yes,7061
Kansas,2020/11/29,35.41420305,112,0,155377,1529,No,Yes,7061
Kansas,2020/11/30,35.41420305,5051,31,160428,1560,No,Yes,7061
Kansas,2020/12/1,35.41420305,290,0,160718,1560,No,Yes,7061
Kansas,2020/12/2,35.41420305,4263,119,164981,1679,No,Yes,7656
Kansas,2020/12/3,35.41420305,632,0,165613,1679,No,Yes,7656
Kansas,2020/12/4,35.41420305,5900,107,171513,1786,No,Yes,7656
Kansas,2020/12/5,35.41420305,113,0,171626,1786,No,Yes,7656
Kansas,2020/12/6,35.41420305,9,0,171635,1786,No,Yes,7656
Kansas,2020/12/7,35.41420305,5754,70,177389,1856,No,Yes,7656
Kansas,2020/12/8,35.41420305,391,0,177780,1856,No,Yes,7656
Kansas,2020/12/9,35.41420305,5624,85,183404,1941,No,Yes,7568
Kansas,2020/12/10,35.41420305,346,0,183750,1941,No,Yes,7568
Kansas,2020/12/11,35.41420305,4860,131,188610,2072,No,Yes,7568
Kansas,2020/12/12,35.41420305,0,0,188610,2072,No,Yes,7568
Kansas,2020/12/13,35.41420305,50,0,188660,2072,No,Yes,7568
Kansas,2020/12/14,35.41420305,4449,37,193109,2109,No,Yes,7568
Kansas,2020/12/15,35.41420305,446,0,193555,2109,No,Yes,7568
Kansas,2020/12/16,35.41420305,4348,144,197903,2253,No,Yes,7543
Kansas,2020/12/17,35.41420305,286,0,198189,2253,No,Yes,7543
Kansas,2020/12/18,35.41420305,5457,88,203646,2341,No,Yes,7543
Kansas,2020/12/19,35.41420305,4,0,203650,2341,No,Yes,7543
Kansas,2020/12/20,35.41420305,24,0,203674,2341,No,Yes,7543
Kansas,2020/12/21,35.41420305,4259,107,207933,2448,No,Yes,7543
Kansas,2020/12/22,35.41420305,176,0,208109,2448,No,Yes,7543
Kansas,2020/12/23,35.41420305,4762,59,212871,2507,No,Yes,5506
Kansas,2020/12/24,35.41420305,91,0,212962,2507,No,Yes,5506
Kansas,2020/12/25,35.41420305,114,0,213076,2507,No,Yes,5506
Kansas,2020/12/26,35.41420305,15,0,213091,2507,No,Yes,5506
Kansas,2020/12/27,35.41420305,82,0,213173,2507,No,Yes,5506
Kansas,2020/12/28,35.41420305,5922,41,219095,2548,No,Yes,5506
Kansas,2020/12/29,35.41420305,320,0,219415,2548,No,Yes,5506
Kansas,2020/12/30,35.41420305,5946,193,225361,2741,No,Yes,10986
Kansas,2020/12/31,35.41420305,94,0,225455,2741,No,Yes,10986
Kansas,2021/1/1,35.41420305,4897,138,230352,2879,No,Yes,10986
Kansas,2021/1/2,35.41420305,0,0,230352,2879,No,Yes,10986
Kansas,2021/1/3,35.41420305,0,0,230352,2879,No,Yes,10986
Kansas,2021/1/4,35.41420305,4038,18,234390,2897,No,Yes,10986
Kansas,2021/1/5,35.41420305,310,0,234700,2897,No,Yes,10986
Kansas,2021/1/6,35.41420305,5288,130,239988,3027,No,Yes,14084
Kansas,2021/1/7,35.41420305,552,0,240540,3027,No,Yes,14084
Kansas,2021/1/8,35.41420305,4875,121,245415,3148,No,Yes,14084
Kansas,2021/1/9,35.41420305,106,0,245521,3148,No,Yes,14084
Kansas,2021/1/10,35.41420305,8,0,245529,3148,No,Yes,14084
Kansas,2021/1/11,35.41420305,4892,107,250421,3255,No,Yes,14084
Kansas,2021/1/12,35.41420305,225,0,250646,3255,No,Yes,14084
Kansas,2021/1/13,35.41420305,4554,100,255200,3355,No,Yes,11980
Kansas,2021/1/14,35.41420305,193,0,255393,3355,No,Yes,11980
Kansas,2021/1/15,35.41420305,3803,159,259196,3514,No,Yes,11980
Kansas,2021/1/16,35.41420305,30,-12,259226,3502,No,Yes,11980
Kansas,2021/1/17,35.41420305,0,0,259226,3502,No,Yes,11980
Kansas,2021/1/18,35.41420305,3293,23,262519,3525,No,Yes,11980
Kansas,2021/1/19,35.41420305,208,1,262727,3526,No,Yes,11980
Kansas,2021/1/20,35.41420305,3524,58,266251,3584,No,Yes,11615
Kansas,2021/1/21,35.41420305,311,-9,266562,3575,No,Yes,11615
Kansas,2021/1/22,35.41420305,3049,23,269611,3598,No,Yes,11615
Kansas,2021/1/23,35.41420305,0,0,269611,3598,No,Yes,11615
Kansas,2021/1/24,35.41420305,0,0,269611,3598,No,Yes,11615
Kansas,2021/1/25,35.41420305,2609,24,272220,3622,No,Yes,11615
Kansas,2021/1/26,35.41420305,83,3,272303,3625,No,Yes,11615
Kansas,2021/1/27,35.41420305,3165,93,275468,3718,No,Yes,12664
Kansas,2021/1/28,35.41420305,117,0,275585,3718,No,Yes,12664
Kansas,2021/1/29,35.41420305,2038,61,277623,3779,No,Yes,12664
Kansas,2021/1/30,35.41420305,0,0,277623,3779,No,Yes,12664
Kansas,2021/1/31,35.41420305,10,0,277633,3779,No,Yes,12664
Kansas,2021/2/1,35.41420305,1954,30,279587,3809,No,Yes,12664
Kansas,2021/2/2,35.41420305,147,0,279734,3809,No,Yes,12664
Kansas,2021/2/3,35.41420305,2132,86,281866,3895,No,Yes,13464
Kansas,2021/2/4,35.41420305,85,0,281951,3895,No,Yes,13464
Kansas,2021/2/5,35.41420305,2603,206,284554,4101,No,Yes,13464
Kansas,2021/2/6,35.41420305,0,0,284554,4101,No,Yes,13464
Kansas,2021/2/7,35.41420305,6,0,284560,4101,No,Yes,13464
Kansas,2021/2/8,35.41420305,1466,96,286026,4197,No,Yes,13464
Kansas,2021/2/9,35.41420305,40,0,286066,4197,No,Yes,13464
Kansas,2021/2/10,35.41420305,1848,106,287914,4303,No,Yes,12087
Kansas,2021/2/11,35.41420305,89,0,288003,4303,No,Yes,12087
Kansas,2021/2/12,35.41420305,1207,61,289210,4364,No,Yes,12087
Kansas,2021/2/13,35.41420305,0,0,289210,4364,No,Yes,12087
Kansas,2021/2/14,35.41420305,15,0,289225,4364,No,Yes,12087
Kansas,2021/2/15,35.41420305,1285,42,290510,4406,No,Yes,12087
Kansas,2021/2/16,35.41420305,46,0,290556,4406,No,Yes,12087
Kansas,2021/2/17,35.41420305,1312,115,291868,4521,No,Yes,11395
Kansas,2021/2/18,35.41420305,94,5,291962,4526,No,Yes,11395
Kansas,2021/2/19,35.41420305,1907,88,293869,4614,No,Yes,11395
Kansas,2021/2/20,35.41420305,141,0,294010,4614,No,Yes,11395
Kansas,2021/2/21,35.41420305,0,0,294010,4614,No,Yes,11395
Kansas,2021/2/22,35.41420305,863,29,294873,4643,No,Yes,11395
Kansas,2021/2/23,35.41420305,12,0,294885,4643,No,Yes,11395
Kansas,2021/2/24,35.41420305,1106,81,295991,4724,No,Yes,11395
Kansas,2021/2/25,35.41420305,56,0,296047,4724,No,Yes,11395
Kansas,2021/2/26,35.41420305,751,11,296798,4735,No,Yes,11395
Kansas,2021/2/27,35.41420305,0,0,296798,4735,No,Yes,11395
Kansas,2021/2/28,35.41420305,0,0,296798,4735,No,Yes,11395
Kansas,2021/3/1,35.41420305,638,8,297436,4743,No,Yes,11395
Kansas,2021/3/2,35.41420305,24,0,297460,4743,No,Yes,11395
Kansas,2021/3/3,35.41420305,718,73,298178,4816,No,Yes,11395
Kansas,2021/3/4,35.41420305,40,0,298218,4816,No,Yes,11395
Kentucky,2020/3/1,110.5996534,0,0,0,0,No,No,1575
Kentucky,2020/3/2,110.5996534,0,0,0,0,No,No,1575
Kentucky,2020/3/3,110.5996534,0,0,0,0,No,No,1575
Kentucky,2020/3/4,110.5996534,0,0,0,0,No,No,1663
Kentucky,2020/3/5,110.5996534,0,0,0,0,No,No,1663
Kentucky,2020/3/6,110.5996534,1,0,1,0,No,No,1663
Kentucky,2020/3/7,110.5996534,0,0,1,0,No,No,1663
Kentucky,2020/3/8,110.5996534,3,0,4,0,No,No,1663
Kentucky,2020/3/9,110.5996534,1,0,5,0,No,No,1663
Kentucky,2020/3/10,110.5996534,2,0,7,0,No,No,1663
Kentucky,2020/3/11,110.5996534,0,0,7,0,No,No,1819
Kentucky,2020/3/12,110.5996534,4,0,11,0,No,No,1819
Kentucky,2020/3/13,110.5996534,0,0,11,0,No,No,1819
Kentucky,2020/3/14,110.5996534,7,0,18,0,No,No,1819
Kentucky,2020/3/15,110.5996534,3,0,21,0,No,No,1819
Kentucky,2020/3/16,110.5996534,1,1,22,1,No,No,1819
Kentucky,2020/3/17,110.5996534,4,0,26,1,No,No,1819
Kentucky,2020/3/18,110.5996534,9,0,35,1,No,No,10892
Kentucky,2020/3/19,110.5996534,12,1,47,2,No,No,10892
Kentucky,2020/3/20,110.5996534,16,0,63,2,No,No,10892
Kentucky,2020/3/21,110.5996534,21,1,84,3,No,No,10892
Kentucky,2020/3/22,110.5996534,19,0,103,3,No,No,10892
Kentucky,2020/3/23,110.5996534,21,0,124,3,No,No,10892
Kentucky,2020/3/24,110.5996534,33,0,157,3,No,No,10892
Kentucky,2020/3/25,110.5996534,41,2,198,5,No,No,80984
Kentucky,2020/3/26,110.5996534,50,0,248,5,Yes,No,80984
Kentucky,2020/3/27,110.5996534,54,3,302,8,Yes,No,80984
Kentucky,2020/3/28,110.5996534,92,1,394,9,Yes,No,80984
Kentucky,2020/3/29,110.5996534,45,0,439,9,Yes,No,80984
Kentucky,2020/3/30,110.5996534,41,2,480,11,Yes,No,80984
Kentucky,2020/3/31,110.5996534,110,7,590,18,Yes,No,80984
Kentucky,2020/4/1,110.5996534,84,2,674,20,Yes,No,106739
Kentucky,2020/4/2,110.5996534,73,14,747,34,Yes,No,106739
Kentucky,2020/4/3,110.5996534,15,0,762,34,Yes,No,106739
Kentucky,2020/4/4,110.5996534,147,6,909,40,Yes,No,106739
Kentucky,2020/4/5,110.5996534,139,4,1048,44,Yes,No,106739
Kentucky,2020/4/6,110.5996534,9,8,1057,52,Yes,No,106739
Kentucky,2020/4/7,110.5996534,232,14,1289,66,Yes,No,106739
Kentucky,2020/4/8,110.5996534,104,7,1393,73,Yes,No,77515
Kentucky,2020/4/9,110.5996534,132,11,1525,84,Yes,No,77515
Kentucky,2020/4/10,110.5996534,177,6,1702,90,Yes,No,77515
Kentucky,2020/4/11,110.5996534,149,4,1851,94,Yes,No,77515
Kentucky,2020/4/12,110.5996534,112,4,1963,98,Yes,No,77515
Kentucky,2020/4/13,110.5996534,85,8,2048,106,Yes,No,77515
Kentucky,2020/4/14,110.5996534,162,9,2210,115,Yes,No,77515
Kentucky,2020/4/15,110.5996534,85,9,2295,124,Yes,No,66432
Kentucky,2020/4/16,110.5996534,134,7,2429,131,Yes,No,66432
Kentucky,2020/4/17,110.5996534,93,9,2522,140,Yes,No,66432
Kentucky,2020/4/18,110.5996534,185,5,2707,145,Yes,No,66432
Kentucky,2020/4/19,110.5996534,253,4,2960,149,Yes,No,66432
Kentucky,2020/4/20,110.5996534,90,6,3050,155,Yes,No,66432
Kentucky,2020/4/21,110.5996534,143,17,3193,172,Yes,No,66432
Kentucky,2020/4/22,110.5996534,180,13,3373,185,Yes,No,74966
Kentucky,2020/4/23,110.5996534,175,9,3548,194,Yes,No,74966
Kentucky,2020/4/24,110.5996534,231,9,3779,203,Yes,No,74966
Kentucky,2020/4/25,110.5996534,126,5,3905,208,Yes,No,74966
Kentucky,2020/4/26,110.5996534,169,3,4074,211,Yes,No,74966
Kentucky,2020/4/27,110.5996534,72,5,4146,216,Yes,No,74966
Kentucky,2020/4/28,110.5996534,229,15,4375,231,Yes,No,74966
Kentucky,2020/4/29,110.5996534,163,4,4538,235,Yes,No,28985
Kentucky,2020/4/30,110.5996534,170,5,4708,240,Yes,No,28985
Kentucky,2020/5/1,110.5996534,171,8,4879,248,Yes,No,28985
Kentucky,2020/5/2,110.5996534,2,4,4881,252,Yes,No,28985
Kentucky,2020/5/3,110.5996534,342,4,5223,256,Yes,No,28985
Kentucky,2020/5/4,110.5996534,147,11,5370,267,Yes,No,28985
Kentucky,2020/5/5,110.5996534,452,11,5822,278,Yes,No,28985
Kentucky,2020/5/6,110.5996534,124,8,5946,286,Yes,No,26666
Kentucky,2020/5/7,110.5996534,227,16,6173,302,Yes,No,26666
Kentucky,2020/5/8,110.5996534,125,2,6298,304,Yes,No,26666
Kentucky,2020/5/9,110.5996534,171,8,6469,312,Yes,No,26666
Kentucky,2020/5/10,110.5996534,17,0,6486,312,Yes,No,26666
Kentucky,2020/5/11,110.5996534,224,13,6710,325,Yes,No,26666
Kentucky,2020/5/12,110.5996534,293,8,7003,333,Yes,No,26666
Kentucky,2020/5/13,110.5996534,99,1,7102,334,Yes,No,25150
Kentucky,2020/5/14,110.5996534,295,7,7397,341,Yes,No,25150
Kentucky,2020/5/15,110.5996534,181,2,7578,343,Yes,No,25150
Kentucky,2020/5/16,110.5996534,195,3,7773,346,Yes,No,25150
Kentucky,2020/5/17,110.5996534,20,0,7793,346,Yes,No,25150
Kentucky,2020/5/18,110.5996534,248,8,8041,354,Yes,No,25150
Kentucky,2020/5/19,110.5996534,164,15,8205,369,Yes,No,25150
Kentucky,2020/5/20,110.5996534,131,12,8336,381,Yes,No,27919
Kentucky,2020/5/21,110.5996534,139,12,8475,393,Yes,No,27919
Kentucky,2020/5/22,110.5996534,213,5,8688,398,Yes,No,27919
Kentucky,2020/5/23,110.5996534,124,1,8812,399,Yes,No,27919
Kentucky,2020/5/24,110.5996534,30,0,8842,399,Yes,No,27919
Kentucky,2020/5/25,110.5996534,57,4,8899,403,Yes,No,27919
Kentucky,2020/5/26,110.5996534,276,4,9175,407,Yes,No,27919
Kentucky,2020/5/27,110.5996534,138,13,9313,420,Yes,No,21335
Kentucky,2020/5/28,110.5996534,197,4,9510,424,Yes,No,21335
Kentucky,2020/5/29,110.5996534,178,10,9688,434,Yes,No,21335
Kentucky,2020/5/30,110.5996534,199,7,9887,441,Yes,No,21335
Kentucky,2020/5/31,110.5996534,50,0,9937,441,Yes,No,21335
Kentucky,2020/6/1,110.5996534,213,4,10150,445,Yes,No,21335
Kentucky,2020/6/2,110.5996534,137,6,10287,451,Yes,No,21335
Kentucky,2020/6/3,110.5996534,198,7,10485,458,Yes,No,19949
Kentucky,2020/6/4,110.5996534,296,11,10781,469,Yes,No,19949
Kentucky,2020/6/5,110.5996534,270,7,11051,476,Yes,No,19949
Kentucky,2020/6/6,110.5996534,308,4,11359,480,Yes,No,19949
Kentucky,2020/6/7,110.5996534,34,1,11393,481,Yes,No,19949
Kentucky,2020/6/8,110.5996534,308,6,11701,487,Yes,No,19949
Kentucky,2020/6/9,110.5996534,190,7,11891,494,Yes,No,19949
Kentucky,2020/6/10,110.5996534,138,4,12029,498,Yes,No,18367
Kentucky,2020/6/11,110.5996534,99,15,12128,513,Yes,No,18367
Kentucky,2020/6/12,110.5996534,224,12,12352,525,Yes,No,18367
Kentucky,2020/6/13,110.5996534,253,2,12605,527,Yes,No,18367
Kentucky,2020/6/14,110.5996534,47,0,12652,527,Yes,No,18367
Kentucky,2020/6/15,110.5996534,211,-3,12863,524,Yes,No,18367
Kentucky,2020/6/16,110.5996534,36,6,12899,530,Yes,No,18367
Kentucky,2020/6/17,110.5996534,291,6,13190,536,Yes,No,18671
Kentucky,2020/6/18,110.5996534,201,4,13391,540,Yes,No,18671
Kentucky,2020/6/19,110.5996534,238,2,13629,542,Yes,No,18671
Kentucky,2020/6/20,110.5996534,171,0,13800,542,Yes,No,18671
Kentucky,2020/6/21,110.5996534,119,2,13919,544,Yes,No,18671
Kentucky,2020/6/22,110.5996534,154,5,14073,549,Yes,No,18671
Kentucky,2020/6/23,110.5996534,250,10,14323,559,Yes,No,18671
Kentucky,2020/6/24,110.5996534,199,2,14522,561,Yes,No,18338
Kentucky,2020/6/25,110.5996534,271,8,14793,569,Yes,No,18338
Kentucky,2020/6/26,110.5996534,240,6,15033,575,Yes,No,18338
Kentucky,2020/6/27,110.5996534,304,0,15337,575,Yes,No,18338
Kentucky,2020/6/28,110.5996534,143,2,15480,577,Yes,No,18338
Kentucky,2020/6/29,110.5996534,177,7,15657,584,Yes,No,18338
Kentucky,2020/6/30,110.5996534,259,4,15916,588,No,No,18338
Kentucky,2020/7/1,110.5996534,198,9,16114,597,No,No,19056
Kentucky,2020/7/2,110.5996534,256,8,16370,605,No,No,19056
Kentucky,2020/7/3,110.5996534,285,3,16655,608,No,No,19056
Kentucky,2020/7/4,110.5996534,54,0,16709,608,No,No,19056
Kentucky,2020/7/5,110.5996534,3,0,16712,608,No,No,19056
Kentucky,2020/7/6,110.5996534,752,13,17464,621,No,No,19056
Kentucky,2020/7/7,110.5996534,356,9,17820,630,No,No,19056
Kentucky,2020/7/8,110.5996534,384,4,18204,634,No,No,20563
Kentucky,2020/7/9,110.5996534,372,6,18576,640,No,No,20563
Kentucky,2020/7/10,110.5996534,500,7,19076,647,No,Yes,20563
Kentucky,2020/7/11,110.5996534,454,0,19530,647,No,Yes,20563
Kentucky,2020/7/12,110.5996534,232,2,19762,649,No,Yes,20563
Kentucky,2020/7/13,110.5996534,365,7,20127,656,No,Yes,20563
Kentucky,2020/7/14,110.5996534,575,9,20702,665,No,Yes,20563
Kentucky,2020/7/15,110.5996534,446,3,21148,668,No,Yes,23676
Kentucky,2020/7/16,110.5996534,469,7,21617,675,No,Yes,23676
Kentucky,2020/7/17,110.5996534,545,12,22162,687,No,Yes,23676
Kentucky,2020/7/18,110.5996534,588,1,22750,688,No,Yes,23676
Kentucky,2020/7/19,110.5996534,850,3,23600,691,No,Yes,23676
Kentucky,2020/7/20,110.5996534,378,3,23978,694,No,Yes,23676
Kentucky,2020/7/21,110.5996534,660,1,24638,695,No,Yes,23676
Kentucky,2020/7/22,110.5996534,531,5,25169,700,No,Yes,17437
Kentucky,2020/7/23,110.5996534,659,6,25828,706,No,Yes,17437
Kentucky,2020/7/24,110.5996534,800,9,26628,715,No,Yes,17437
Kentucky,2020/7/25,110.5996534,767,2,27395,717,No,Yes,17437
Kentucky,2020/7/26,110.5996534,287,1,27682,718,No,Yes,17437
Kentucky,2020/7/27,110.5996534,568,8,28250,726,No,Yes,17437
Kentucky,2020/7/28,110.5996534,626,9,28876,735,No,Yes,17437
Kentucky,2020/7/29,110.5996534,603,11,29479,746,No,Yes,11690
Kentucky,2020/7/30,110.5996534,653,2,30132,748,No,Yes,11690
Kentucky,2020/7/31,110.5996534,849,5,30981,753,No,Yes,11690
Kentucky,2020/8/1,110.5996534,631,5,31612,758,No,Yes,11690
Kentucky,2020/8/2,110.5996534,354,1,31966,759,No,Yes,11690
Kentucky,2020/8/3,110.5996534,534,3,32500,762,No,Yes,11690
Kentucky,2020/8/4,110.5996534,709,7,33209,769,No,Yes,11690
Kentucky,2020/8/5,110.5996534,614,2,33823,771,No,Yes,9467
Kentucky,2020/8/6,110.5996534,612,9,34435,780,No,Yes,9467
Kentucky,2020/8/7,110.5996534,712,5,35147,785,No,Yes,9467
Kentucky,2020/8/8,110.5996534,839,5,35986,790,No,Yes,9467
Kentucky,2020/8/9,110.5996534,330,0,36316,790,No,Yes,9467
Kentucky,2020/8/10,110.5996534,423,4,36739,794,No,No,9467
Kentucky,2020/8/11,110.5996534,698,9,37437,803,No,No,9467
Kentucky,2020/8/12,110.5996534,1109,6,38546,809,No,No,11047
Kentucky,2020/8/13,110.5996534,760,8,39306,817,No,No,11047
Kentucky,2020/8/14,110.5996534,706,5,40012,822,No,No,11047
Kentucky,2020/8/15,110.5996534,665,7,40677,829,No,No,11047
Kentucky,2020/8/16,110.5996534,206,3,40883,832,No,No,11047
Kentucky,2020/8/17,110.5996534,727,7,41610,839,No,No,11047
Kentucky,2020/8/18,110.5996534,660,19,42270,858,No,No,11047
Kentucky,2020/8/19,110.5996534,688,8,42958,866,No,No,8676
Kentucky,2020/8/20,110.5996534,742,15,43700,881,No,No,8676
Kentucky,2020/8/21,110.5996534,732,6,44432,887,No,No,8676
Kentucky,2020/8/22,110.5996534,793,12,45225,899,No,No,8676
Kentucky,2020/8/23,110.5996534,176,2,45401,901,No,No,8676
Kentucky,2020/8/24,110.5996534,656,8,46057,909,No,No,8676
Kentucky,2020/8/25,110.5996534,741,9,46798,918,No,No,8676
Kentucky,2020/8/26,110.5996534,744,9,47542,927,No,No,8511
Kentucky,2020/8/27,110.5996534,780,10,48322,937,No,No,8511
Kentucky,2020/8/28,110.5996534,615,8,48937,945,No,No,8511
Kentucky,2020/8/29,110.5996534,977,6,49914,951,No,No,8511
Kentucky,2020/8/30,110.5996534,256,4,50170,955,No,No,8511
Kentucky,2020/8/31,110.5996534,714,10,50884,965,No,No,8511
Kentucky,2020/9/1,110.5996534,878,18,51762,983,No,No,8511
Kentucky,2020/9/2,110.5996534,942,25,52704,1008,No,No,8901
Kentucky,2020/9/3,110.5996534,1363,13,54067,1021,No,No,8901
Kentucky,2020/9/4,110.5996534,1433,7,55500,1028,No,No,8901
Kentucky,2020/9/5,110.5996534,516,5,56016,1033,No,No,8901
Kentucky,2020/9/6,110.5996534,156,2,56172,1035,No,No,8901
Kentucky,2020/9/7,110.5996534,373,1,56545,1036,No,No,8901
Kentucky,2020/9/8,110.5996534,332,3,56877,1039,No,No,8901
Kentucky,2020/9/9,110.5996534,641,19,57518,1058,No,No,8848
Kentucky,2020/9/10,110.5996534,934,15,58452,1073,No,No,8848
Kentucky,2020/9/11,110.5996534,897,14,59349,1087,No,No,8848
Kentucky,2020/9/12,110.5996534,838,12,60187,1099,No,No,8848
Kentucky,2020/9/13,110.5996534,420,3,60607,1102,No,No,8848
Kentucky,2020/9/14,110.5996534,575,3,61182,1105,No,No,8848
Kentucky,2020/9/15,110.5996534,804,7,61986,1112,No,No,8848
Kentucky,2020/9/16,110.5996534,737,6,62723,1118,No,No,8679
Kentucky,2020/9/17,110.5996534,689,9,63412,1127,No,No,8679
Kentucky,2020/9/18,110.5996534,743,5,64155,1132,No,No,8679
Kentucky,2020/9/19,110.5996534,913,5,65068,1137,No,No,8679
Kentucky,2020/9/20,110.5996534,345,2,65413,1139,No,No,8679
Kentucky,2020/9/21,110.5996534,492,2,65905,1141,No,No,8679
Kentucky,2020/9/22,110.5996534,719,7,66624,1148,No,No,8679
Kentucky,2020/9/23,110.5996534,966,13,67590,1161,No,No,8805
Kentucky,2020/9/24,110.5996534,640,5,68230,1166,No,No,8805
Kentucky,2020/9/25,110.5996534,920,13,69150,1179,No,No,8805
Kentucky,2020/9/26,110.5996534,888,6,70038,1185,No,No,8805
Kentucky,2020/9/27,110.5996534,347,4,70385,1189,No,No,8805
Kentucky,2020/9/28,110.5996534,618,6,71003,1195,No,No,8805
Kentucky,2020/9/29,110.5996534,918,10,71921,1205,No,No,8805
Kentucky,2020/9/30,110.5996534,909,3,72830,1208,No,No,7732
Kentucky,2020/10/1,110.5996534,789,17,73619,1225,No,No,7732
Kentucky,2020/10/2,110.5996534,947,7,74566,1232,No,No,7732
Kentucky,2020/10/3,110.5996534,1010,7,75576,1239,No,No,7732
Kentucky,2020/10/4,110.5996534,510,3,76086,1242,No,No,7732
Kentucky,2020/10/5,110.5996534,701,6,76787,1248,No,No,7732
Kentucky,2020/10/6,110.5996534,954,7,77741,1255,No,No,7732
Kentucky,2020/10/7,110.5996534,928,6,78669,1261,No,No,8581
Kentucky,2020/10/8,110.5996534,881,11,79550,1272,No,No,8581
Kentucky,2020/10/9,110.5996534,1083,11,80633,1283,No,No,8581
Kentucky,2020/10/10,110.5996534,997,10,81630,1293,No,No,8581
Kentucky,2020/10/11,110.5996534,728,2,82358,1295,No,No,8581
Kentucky,2020/10/12,110.5996534,716,5,83074,1300,No,No,8581
Kentucky,2020/10/13,110.5996534,893,18,83967,1318,No,No,8581
Kentucky,2020/10/14,110.5996534,1311,7,85278,1325,No,No,7964
Kentucky,2020/10/15,110.5996534,1132,16,86410,1341,No,No,7964
Kentucky,2020/10/16,110.5996534,1354,8,87764,1349,No,No,7964
Kentucky,2020/10/17,110.5996534,1059,14,88823,1363,No,No,7964
Kentucky,2020/10/18,110.5996534,715,9,89538,1372,No,No,7964
Kentucky,2020/10/19,110.5996534,905,9,90443,1381,No,No,7964
Kentucky,2020/10/20,110.5996534,1288,22,91731,1403,No,No,7964
Kentucky,2020/10/21,110.5996534,1379,21,93110,1424,No,No,7126
Kentucky,2020/10/22,110.5996534,1472,15,94582,1439,No,No,7126
Kentucky,2020/10/23,110.5996534,1461,23,96043,1462,No,No,7126
Kentucky,2020/10/24,110.5996534,1458,7,97501,1469,No,No,7126
Kentucky,2020/10/25,110.5996534,1229,3,98730,1472,No,No,7126
Kentucky,2020/10/26,110.5996534,1235,8,99965,1480,No,No,7126
Kentucky,2020/10/27,110.5996534,1735,13,101700,1493,No,No,7126
Kentucky,2020/10/28,110.5996534,1985,16,103685,1509,No,No,7060
Kentucky,2020/10/29,110.5996534,1832,15,105517,1524,No,No,7060
Kentucky,2020/10/30,110.5996534,2103,19,107620,1543,No,No,7060
Kentucky,2020/10/31,110.5996534,1624,8,109244,1551,No,No,7060
Kentucky,2020/11/1,110.5996534,1356,3,110600,1554,No,No,7060
Kentucky,2020/11/2,110.5996534,1216,11,111816,1565,No,No,7060
Kentucky,2020/11/3,110.5996534,1641,13,113457,1578,No,No,7060
Kentucky,2020/11/4,110.5996534,1969,15,115426,1593,No,No,8764
Kentucky,2020/11/5,110.5996534,2228,18,117654,1611,No,No,8764
Kentucky,2020/11/6,110.5996534,2298,10,119952,1621,No,No,8764
Kentucky,2020/11/7,110.5996534,2069,19,122021,1640,No,No,8764
Kentucky,2020/11/8,110.5996534,1174,1,123195,1641,No,No,8764
Kentucky,2020/11/9,110.5996534,2137,14,125332,1655,No,No,8764
Kentucky,2020/11/10,110.5996534,2140,19,127472,1674,No,No,8764
Kentucky,2020/11/11,110.5996534,2836,15,130308,1689,No,No,9262
Kentucky,2020/11/12,110.5996534,2378,13,132686,1702,No,No,9262
Kentucky,2020/11/13,110.5996534,3169,27,135855,1729,No,No,9262
Kentucky,2020/11/14,110.5996534,2999,10,138854,1739,No,No,9262
Kentucky,2020/11/15,110.5996534,1413,3,140267,1742,No,No,9262
Kentucky,2020/11/16,110.5996534,2010,8,142277,1750,No,No,9262
Kentucky,2020/11/17,110.5996534,2943,37,145220,1787,No,No,9262
Kentucky,2020/11/18,110.5996534,2849,29,148069,1816,No,No,11813
Kentucky,2020/11/19,110.5996534,3637,27,151706,1843,No,No,11813
Kentucky,2020/11/20,110.5996534,3919,19,155625,1862,No,No,11813
Kentucky,2020/11/21,110.5996534,3410,24,159035,1886,No,No,11813
Kentucky,2020/11/22,110.5996534,2187,1,161222,1887,No,No,11813
Kentucky,2020/11/23,110.5996534,2545,19,163767,1906,No,No,11813
Kentucky,2020/11/24,110.5996534,2711,32,166478,1938,No,No,11813
Kentucky,2020/11/25,110.5996534,3344,37,169822,1975,No,No,7061
Kentucky,2020/11/26,110.5996534,259,8,170081,1983,No,No,7061
Kentucky,2020/11/27,110.5996534,4603,26,174684,2009,No,No,7061
Kentucky,2020/11/28,110.5996534,2769,19,177453,2028,No,No,7061
Kentucky,2020/11/29,110.5996534,2711,11,180164,2039,No,No,7061
Kentucky,2020/11/30,110.5996534,3091,26,183255,2065,No,No,7061
Kentucky,2020/12/1,110.5996534,4030,32,187285,2097,No,No,7061
Kentucky,2020/12/2,110.5996534,3782,27,191067,2124,No,No,7656
Kentucky,2020/12/3,110.5996534,3784,61,194851,2185,No,No,7656
Kentucky,2020/12/4,110.5996534,3655,31,198506,2216,No,No,7656
Kentucky,2020/12/5,110.5996534,3629,25,202135,2241,No,No,7656
Kentucky,2020/12/6,110.5996534,2637,9,204772,2250,No,No,7656
Kentucky,2020/12/7,110.5996534,2271,26,207043,2276,No,No,7656
Kentucky,2020/12/8,110.5996534,3189,52,210232,2328,No,No,7656
Kentucky,2020/12/9,110.5996534,2765,31,212997,2359,No,No,7568
Kentucky,2020/12/10,110.5996534,4115,28,217112,2387,No,No,7568
Kentucky,2020/12/11,110.5996534,3786,29,220898,2416,No,No,7568
Kentucky,2020/12/12,110.5996534,3257,30,224155,2446,No,No,7568
Kentucky,2020/12/13,110.5996534,2449,7,226604,2453,No,No,7568
Kentucky,2020/12/14,110.5996534,2064,19,228668,2472,No,No,7568
Kentucky,2020/12/15,110.5996534,2619,27,231287,2499,No,No,7568
Kentucky,2020/12/16,110.5996534,2920,30,234207,2529,No,No,7543
Kentucky,2020/12/17,110.5996534,2953,46,237160,2575,No,No,7543
Kentucky,2020/12/18,110.5996534,3185,43,240345,2618,No,No,7543
Kentucky,2020/12/19,110.5996534,2702,19,243047,2637,No,No,7543
Kentucky,2020/12/20,110.5996534,1737,28,244784,2665,No,No,7543
Kentucky,2020/12/21,110.5996534,2459,36,247243,2701,No,No,7543
Kentucky,2020/12/22,110.5996534,2846,38,250089,2739,No,No,7543
Kentucky,2020/12/23,110.5996534,2889,35,252978,2774,No,No,5506
Kentucky,2020/12/24,110.5996534,459,6,253437,2780,No,No,5506
Kentucky,2020/12/25,110.5996534,387,2,253824,2782,No,No,5506
Kentucky,2020/12/26,110.5996534,3629,39,257453,2821,No,No,5506
Kentucky,2020/12/27,110.5996534,1367,24,258820,2845,No,No,5506
Kentucky,2020/12/28,110.5996534,2189,26,261009,2871,No,No,5506
Kentucky,2020/12/29,110.5996534,3141,32,264150,2903,No,No,5506
Kentucky,2020/12/30,110.5996534,3840,40,267990,2943,No,No,10986
Kentucky,2020/12/31,110.5996534,838,13,268828,2956,No,No,10986
Kentucky,2021/1/1,110.5996534,642,0,269470,2956,No,No,10986
Kentucky,2021/1/2,110.5996534,6333,43,275803,2999,No,No,10986
Kentucky,2021/1/3,110.5996534,2675,14,278478,3013,No,No,10986
Kentucky,2021/1/4,110.5996534,3619,54,282097,3067,No,No,10986
Kentucky,2021/1/5,110.5996534,2448,26,284545,3093,No,No,10986
Kentucky,2021/1/6,110.5996534,5447,42,289992,3135,No,No,14084
Kentucky,2021/1/7,110.5996534,4959,26,294951,3161,No,No,14084
Kentucky,2021/1/8,110.5996534,4525,33,299476,3194,No,No,14084
Kentucky,2021/1/9,110.5996534,4293,20,303769,3214,No,No,14084
Kentucky,2021/1/10,110.5996534,3054,10,306823,3224,No,No,14084
Kentucky,2021/1/11,110.5996534,2591,23,309414,3247,No,No,14084
Kentucky,2021/1/12,110.5996534,2902,37,312316,3284,No,No,14084
Kentucky,2021/1/13,110.5996534,4357,40,316673,3324,No,No,11980
Kentucky,2021/1/14,110.5996534,3793,49,320466,3373,No,No,11980
Kentucky,2021/1/15,110.5996534,4039,22,324505,3395,No,No,11980
Kentucky,2021/1/16,110.5996534,3033,25,327538,3420,No,No,11980
Kentucky,2021/1/17,110.5996534,2278,8,329816,3428,No,No,11980
Kentucky,2021/1/18,110.5996534,2166,34,331982,3462,No,No,11980
Kentucky,2021/1/19,110.5996534,2365,27,334347,3489,No,No,11980
Kentucky,2021/1/20,110.5996534,3441,51,337788,3540,No,No,11615
Kentucky,2021/1/21,110.5996534,3555,44,341343,3584,No,No,11615
Kentucky,2021/1/22,110.5996534,3222,42,344565,3626,No,No,11615
Kentucky,2021/1/23,110.5996534,3475,31,348040,3657,No,No,11615
Kentucky,2021/1/24,110.5996534,1154,30,349194,3687,No,No,11615
Kentucky,2021/1/25,110.5996534,2268,43,351462,3730,No,No,11615
Kentucky,2021/1/26,110.5996534,2729,39,354191,3769,No,No,11615
Kentucky,2021/1/27,110.5996534,2646,36,356837,3805,No,No,12664
Kentucky,2021/1/28,110.5996534,3141,58,359978,3863,No,No,12664
Kentucky,2021/1/29,110.5996534,2145,47,362123,3910,No,No,12664
Kentucky,2021/1/30,110.5996534,2893,57,365016,3967,No,No,12664
Kentucky,2021/1/31,110.5996534,1841,10,366857,3977,No,No,12664
Kentucky,2021/2/1,110.5996534,1766,18,368623,3995,No,No,12664
Kentucky,2021/2/2,110.5996534,2320,33,370943,4028,No,No,12664
Kentucky,2021/2/3,110.5996534,1831,39,372774,4067,No,No,13464
Kentucky,2021/2/4,110.5996534,3077,50,375851,4117,No,No,13464
Kentucky,2021/2/5,110.5996534,2425,32,378276,4149,No,No,13464
Kentucky,2021/2/6,110.5996534,1890,53,380166,4202,No,No,13464
Kentucky,2021/2/7,110.5996534,1105,22,381271,4224,No,No,13464
Kentucky,2021/2/8,110.5996534,1472,52,382743,4276,No,No,13464
Kentucky,2021/2/9,110.5996534,2215,28,384958,4304,No,No,13464
Kentucky,2021/2/10,110.5996534,2085,35,387043,4339,No,No,12087
Kentucky,2021/2/11,110.5996534,1824,36,388867,4375,No,No,12087
Kentucky,2021/2/12,110.5996534,1767,45,390634,4420,No,No,12087
Kentucky,2021/2/13,110.5996534,815,21,391449,4441,No,No,12087
Kentucky,2021/2/14,110.5996534,1541,6,392990,4447,No,No,12087
Kentucky,2021/2/15,110.5996534,785,17,393775,4464,No,No,12087
Kentucky,2021/2/16,110.5996534,1054,27,394829,4491,No,No,12087
Kentucky,2021/2/17,110.5996534,937,20,395766,4511,No,No,11395
Kentucky,2021/2/18,110.5996534,1034,28,396800,4539,No,No,11395
Kentucky,2021/2/19,110.5996534,1865,23,398665,4562,No,No,11395
Kentucky,2021/2/20,110.5996534,1346,23,400011,4585,No,No,11395
Kentucky,2021/2/21,110.5996534,941,19,400952,4604,No,No,11395
Kentucky,2021/2/22,110.5996534,627,15,401579,4619,No,No,11395
Kentucky,2021/2/23,110.5996534,1364,17,402943,4636,No,No,11395
Kentucky,2021/2/24,110.5996534,1299,50,404242,4686,No,No,11395
Kentucky,2021/2/25,110.5996534,1395,36,405637,4722,No,No,11395
Kentucky,2021/2/26,110.5996534,1158,24,406795,4746,No,No,11395
Kentucky,2021/2/27,110.5996534,950,30,407745,4776,No,No,11395
Kentucky,2021/2/28,110.5996534,647,10,408392,4786,No,No,11395
Kentucky,2021/3/1,110.5996534,462,16,408854,4802,No,No,11395
Kentucky,2021/3/2,110.5996534,989,20,409843,4822,No,No,11395
Kentucky,2021/3/3,110.5996534,1031,31,410874,4853,No,No,11395
Kentucky,2021/3/4,110.5996534,1054,33,411928,4886,No,No,11395
Louisiana,2020/3/1,95.80598891,0,0,0,0,No,No,1575
Louisiana,2020/3/2,95.80598891,0,0,0,0,No,No,1575
Louisiana,2020/3/3,95.80598891,0,0,0,0,No,No,1575
Louisiana,2020/3/4,95.80598891,0,0,0,0,No,No,1663
Louisiana,2020/3/5,95.80598891,0,0,0,0,No,No,1663
Louisiana,2020/3/6,95.80598891,0,0,0,0,No,No,1663
Louisiana,2020/3/7,95.80598891,0,0,0,0,No,No,1663
Louisiana,2020/3/8,95.80598891,0,0,0,0,No,No,1663
Louisiana,2020/3/9,95.80598891,1,0,1,0,No,No,1663
Louisiana,2020/3/10,95.80598891,5,0,6,0,No,No,1663
Louisiana,2020/3/11,95.80598891,7,0,13,0,No,No,1819
Louisiana,2020/3/12,95.80598891,1,0,14,0,No,No,1819
Louisiana,2020/3/13,95.80598891,22,0,36,0,No,No,1819
Louisiana,2020/3/14,95.80598891,41,1,77,1,No,No,1819
Louisiana,2020/3/15,95.80598891,26,1,103,2,No,No,1819
Louisiana,2020/3/16,95.80598891,34,1,137,3,No,No,1819
Louisiana,2020/3/17,95.80598891,59,2,196,5,No,No,1819
Louisiana,2020/3/18,95.80598891,84,2,280,7,No,No,10892
Louisiana,2020/3/19,95.80598891,112,3,392,10,No,No,10892
Louisiana,2020/3/20,95.80598891,145,0,537,10,No,No,10892
Louisiana,2020/3/21,95.80598891,226,6,763,16,No,No,10892
Louisiana,2020/3/22,95.80598891,74,4,837,20,No,No,10892
Louisiana,2020/3/23,95.80598891,335,14,1172,34,Yes,No,10892
Louisiana,2020/3/24,95.80598891,216,12,1388,46,Yes,No,10892
Louisiana,2020/3/25,95.80598891,407,19,1795,65,Yes,No,80984
Louisiana,2020/3/26,95.80598891,510,18,2305,83,Yes,No,80984
Louisiana,2020/3/27,95.80598891,441,36,2746,119,Yes,No,80984
Louisiana,2020/3/28,95.80598891,569,18,3315,137,Yes,No,80984
Louisiana,2020/3/29,95.80598891,224,16,3539,153,Yes,No,80984
Louisiana,2020/3/30,95.80598891,485,33,4024,186,Yes,No,80984
Louisiana,2020/3/31,95.80598891,1213,54,5237,240,Yes,No,80984
Louisiana,2020/4/1,95.80598891,1187,35,6424,275,Yes,No,106739
Louisiana,2020/4/2,95.80598891,2728,35,9152,310,Yes,No,106739
Louisiana,2020/4/3,95.80598891,1147,60,10299,370,Yes,No,106739
Louisiana,2020/4/4,95.80598891,2201,42,12500,412,Yes,No,106739
Louisiana,2020/4/5,95.80598891,514,65,13014,477,Yes,No,106739
Louisiana,2020/4/6,95.80598891,1853,35,14867,512,Yes,No,106739
Louisiana,2020/4/7,95.80598891,1417,70,16284,582,Yes,No,106739
Louisiana,2020/4/8,95.80598891,746,70,17030,652,Yes,No,77515
Louisiana,2020/4/9,95.80598891,1253,50,18283,702,Yes,No,77515
Louisiana,2020/4/10,95.80598891,970,53,19253,755,Yes,No,77515
Louisiana,2020/4/11,95.80598891,761,51,20014,806,Yes,No,77515
Louisiana,2020/4/12,95.80598891,581,34,20595,840,Yes,No,77515
Louisiana,2020/4/13,95.80598891,421,44,21016,884,Yes,No,77515
Louisiana,2020/4/14,95.80598891,502,129,21518,1013,Yes,No,77515
Louisiana,2020/4/15,95.80598891,433,90,21951,1103,Yes,No,66432
Louisiana,2020/4/16,95.80598891,581,53,22532,1156,Yes,No,66432
Louisiana,2020/4/17,95.80598891,586,57,23118,1213,Yes,No,66432
Louisiana,2020/4/18,95.80598891,462,54,23580,1267,Yes,No,66432
Louisiana,2020/4/19,95.80598891,348,29,23928,1296,Yes,No,66432
Louisiana,2020/4/20,95.80598891,595,32,24523,1328,Yes,No,66432
Louisiana,2020/4/21,95.80598891,331,77,24854,1405,Yes,No,66432
Louisiana,2020/4/22,95.80598891,463,127,25317,1532,Yes,No,74966
Louisiana,2020/4/23,95.80598891,481,67,25798,1599,Yes,No,74966
Louisiana,2020/4/24,95.80598891,401,61,26199,1660,Yes,No,74966
Louisiana,2020/4/25,95.80598891,372,43,26571,1703,Yes,No,74966
Louisiana,2020/4/26,95.80598891,261,26,26832,1729,Yes,No,74966
Louisiana,2020/4/27,95.80598891,279,11,27111,1740,Yes,No,74966
Louisiana,2020/4/28,95.80598891,218,61,27329,1801,Yes,No,74966
Louisiana,2020/4/29,95.80598891,374,44,27703,1845,Yes,No,28985
Louisiana,2020/4/30,95.80598891,341,60,28044,1905,Yes,No,28985
Louisiana,2020/5/1,95.80598891,710,65,28754,1970,Yes,No,28985
Louisiana,2020/5/2,95.80598891,429,23,29183,1993,Yes,No,28985
Louisiana,2020/5/3,95.80598891,200,19,29383,2012,Yes,No,28985
Louisiana,2020/5/4,95.80598891,363,52,29746,2064,Yes,No,28985
Louisiana,2020/5/5,95.80598891,323,51,30069,2115,Yes,No,28985
Louisiana,2020/5/6,95.80598891,403,52,30472,2167,Yes,No,26666
Louisiana,2020/5/7,95.80598891,253,41,30725,2208,Yes,No,26666
Louisiana,2020/5/8,95.80598891,203,19,30928,2227,Yes,No,26666
Louisiana,2020/5/9,95.80598891,562,40,31490,2267,Yes,No,26666
Louisiana,2020/5/10,95.80598891,183,19,31673,2286,Yes,No,26666
Louisiana,2020/5/11,95.80598891,208,22,31881,2308,Yes,No,26666
Louisiana,2020/5/12,95.80598891,235,39,32116,2347,Yes,No,26666
Louisiana,2020/5/13,95.80598891,612,34,32728,2381,Yes,No,25150
Louisiana,2020/5/14,95.80598891,827,36,33555,2417,Yes,No,25150
Louisiana,2020/5/15,95.80598891,348,31,33903,2448,Yes,No,25150
Louisiana,2020/5/16,95.80598891,280,31,34183,2479,No,No,25150
Louisiana,2020/5/17,95.80598891,315,12,34498,2491,No,No,25150
Louisiana,2020/5/18,95.80598891,334,72,34832,2563,No,No,25150
Louisiana,2020/5/19,95.80598891,329,18,35161,2581,No,No,25150
Louisiana,2020/5/20,95.80598891,278,27,35439,2608,No,No,27919
Louisiana,2020/5/21,95.80598891,1188,21,36627,2629,No,No,27919
Louisiana,2020/5/22,95.80598891,421,40,37048,2669,No,No,27919
Louisiana,2020/5/23,95.80598891,117,14,37165,2683,No,No,27919
Louisiana,2020/5/24,95.80598891,128,7,37293,2690,No,No,27919
Louisiana,2020/5/25,95.80598891,623,0,37916,2690,No,No,27919
Louisiana,2020/5/26,95.80598891,336,11,38252,2701,No,No,27919
Louisiana,2020/5/27,95.80598891,442,21,38694,2722,No,No,21335
Louisiana,2020/5/28,95.80598891,213,18,38907,2740,No,No,21335
Louisiana,2020/5/29,95.80598891,0,26,38907,2766,No,No,21335
Louisiana,2020/5/30,95.80598891,775,19,39682,2785,No,No,21335
Louisiana,2020/5/31,95.80598891,339,6,40021,2791,No,No,21335
Louisiana,2020/6/1,95.80598891,431,10,40452,2801,No,No,21335
Louisiana,2020/6/2,95.80598891,405,34,40857,2835,No,No,21335
Louisiana,2020/6/3,95.80598891,387,35,41244,2870,No,No,19949
Louisiana,2020/6/4,95.80598891,429,13,41673,2883,No,No,19949
Louisiana,2020/6/5,95.80598891,427,29,42100,2912,No,No,19949
Louisiana,2020/6/6,95.80598891,497,13,42597,2925,No,No,19949
Louisiana,2020/6/7,95.80598891,330,11,42927,2936,No,No,19949
Louisiana,2020/6/8,95.80598891,236,8,43163,2944,No,No,19949
Louisiana,2020/6/9,95.80598891,562,13,43725,2957,No,No,19949
Louisiana,2020/6/10,95.80598891,418,11,44143,2968,No,No,18367
Louisiana,2020/6/11,95.80598891,442,19,44585,2987,No,No,18367
Louisiana,2020/6/12,95.80598891,523,9,45108,2996,No,No,18367
Louisiana,2020/6/13,95.80598891,1288,8,46396,3004,No,No,18367
Louisiana,2020/6/14,95.80598891,336,10,46732,3014,No,No,18367
Louisiana,2020/6/15,95.80598891,552,4,47284,3018,No,No,18367
Louisiana,2020/6/16,95.80598891,534,24,47818,3042,No,No,18367
Louisiana,2020/6/17,95.80598891,928,20,48746,3062,No,No,18671
Louisiana,2020/6/18,95.80598891,760,7,49506,3069,No,No,18671
Louisiana,2020/6/19,95.80598891,-879,15,48627,3084,No,No,18671
Louisiana,2020/6/20,95.80598891,870,20,49497,3104,No,No,18671
Louisiana,2020/6/21,95.80598891,393,1,49890,3105,No,No,18671
Louisiana,2020/6/22,95.80598891,462,12,50352,3117,No,No,18671
Louisiana,2020/6/23,95.80598891,1356,17,51708,3134,No,No,18671
Louisiana,2020/6/24,95.80598891,882,18,52590,3152,No,No,18338
Louisiana,2020/6/25,95.80598891,938,12,53528,3164,No,No,18338
Louisiana,2020/6/26,95.80598891,1354,26,54882,3190,No,No,18338
Louisiana,2020/6/27,95.80598891,0,0,54882,3190,No,No,18338
Louisiana,2020/6/28,95.80598891,1467,9,56349,3199,No,No,18338
Louisiana,2020/6/29,95.80598891,840,0,57189,3199,No,No,18338
Louisiana,2020/6/30,95.80598891,1014,22,58203,3221,No,No,18338
Louisiana,2020/7/1,95.80598891,2083,17,60286,3238,No,No,19056
Louisiana,2020/7/2,95.80598891,1383,17,61669,3255,No,No,19056
Louisiana,2020/7/3,95.80598891,1728,23,63397,3278,No,No,19056
Louisiana,2020/7/4,95.80598891,0,0,63397,3278,No,No,19056
Louisiana,2020/7/5,95.80598891,1937,10,65334,3288,No,No,19056
Louisiana,2020/7/6,95.80598891,1101,8,66435,3296,No,No,19056
Louisiana,2020/7/7,95.80598891,1936,23,68371,3319,No,No,19056
Louisiana,2020/7/8,95.80598891,1888,20,70259,3339,No,No,20563
Louisiana,2020/7/9,95.80598891,1843,16,72102,3355,No,No,20563
Louisiana,2020/7/10,95.80598891,2642,25,74744,3380,No,No,20563
Louisiana,2020/7/11,95.80598891,2167,23,76911,3403,No,No,20563
Louisiana,2020/7/12,95.80598891,1319,13,78230,3416,No,No,20563
Louisiana,2020/7/13,95.80598891,1705,7,79935,3423,No,Yes,20563
Louisiana,2020/7/14,95.80598891,2215,22,82150,3445,No,Yes,20563
Louisiana,2020/7/15,95.80598891,2091,16,84241,3461,No,Yes,23676
Louisiana,2020/7/16,95.80598891,2280,24,86521,3485,No,Yes,23676
Louisiana,2020/7/17,95.80598891,2179,24,88700,3509,No,Yes,23676
Louisiana,2020/7/18,95.80598891,0,0,88700,3509,No,Yes,23676
Louisiana,2020/7/19,95.80598891,3116,34,91816,3543,No,Yes,23676
Louisiana,2020/7/20,95.80598891,3186,29,95002,3572,No,Yes,23676
Louisiana,2020/7/21,95.80598891,1691,36,96693,3608,No,Yes,23676
Louisiana,2020/7/22,95.80598891,2773,62,99466,3670,No,Yes,17437
Louisiana,2020/7/23,95.80598891,2296,16,101762,3686,No,Yes,17437
Louisiana,2020/7/24,95.80598891,2084,29,103846,3715,No,Yes,17437
Louisiana,2020/7/25,95.80598891,0,0,103846,3715,No,Yes,17437
Louisiana,2020/7/26,95.80598891,3840,48,107686,3763,No,Yes,17437
Louisiana,2020/7/27,95.80598891,2343,23,110029,3786,No,Yes,17437
Louisiana,2020/7/28,95.80598891,1121,26,111150,3812,No,Yes,17437
Louisiana,2020/7/29,95.80598891,1737,71,112887,3883,No,Yes,11690
Louisiana,2020/7/30,95.80598891,1708,42,114595,3925,No,Yes,11690
Louisiana,2020/7/31,95.80598891,1799,24,116394,3949,No,Yes,11690
Louisiana,2020/8/1,95.80598891,0,0,116394,3949,No,Yes,11690
Louisiana,2020/8/2,95.80598891,3467,58,119861,4007,No,Yes,11690
Louisiana,2020/8/3,95.80598891,1099,17,120960,4024,No,Yes,11690
Louisiana,2020/8/4,95.80598891,3615,27,124575,4051,No,Yes,11690
Louisiana,2020/8/5,95.80598891,1486,45,126061,4096,No,Yes,9467
Louisiana,2020/8/6,95.80598891,1303,50,127364,4146,No,Yes,9467
Louisiana,2020/8/7,95.80598891,1500,61,128864,4207,No,Yes,9467
Louisiana,2020/8/8,95.80598891,0,0,128864,4207,No,Yes,9467
Louisiana,2020/8/9,95.80598891,2653,56,131517,4263,No,Yes,9467
Louisiana,2020/8/10,95.80598891,562,24,132079,4287,No,Yes,9467
Louisiana,2020/8/11,95.80598891,1164,26,133243,4313,No,Yes,9467
Louisiana,2020/8/12,95.80598891,1184,48,134427,4361,No,Yes,11047
Louisiana,2020/8/13,95.80598891,1135,41,135562,4402,No,Yes,11047
Louisiana,2020/8/14,95.80598891,1298,28,136860,4430,No,Yes,11047
Louisiana,2020/8/15,95.80598891,0,0,136860,4430,No,Yes,11047
Louisiana,2020/8/16,95.80598891,1181,77,138041,4507,No,Yes,11047
Louisiana,2020/8/17,95.80598891,567,19,138608,4526,No,Yes,11047
Louisiana,2020/8/18,95.80598891,640,28,139248,4554,No,Yes,11047
Louisiana,2020/8/19,95.80598891,796,55,140044,4609,No,Yes,8676
Louisiana,2020/8/20,95.80598891,918,28,140962,4637,No,Yes,8676
Louisiana,2020/8/21,95.80598891,899,50,141861,4687,No,Yes,8676
Louisiana,2020/8/22,95.80598891,0,0,141861,4687,No,Yes,8676
Louisiana,2020/8/23,95.80598891,1223,59,143084,4746,No,Yes,8676
Louisiana,2020/8/24,95.80598891,623,18,143707,4764,No,Yes,8676
Louisiana,2020/8/25,95.80598891,550,33,144257,4797,No,Yes,8676
Louisiana,2020/8/26,95.80598891,1404,54,145661,4851,No,Yes,8511
Louisiana,2020/8/27,95.80598891,677,23,146338,4874,No,Yes,8511
Louisiana,2020/8/28,95.80598891,606,30,146944,4904,No,Yes,8511
Louisiana,2020/8/29,95.80598891,0,0,146944,4904,No,Yes,8511
Louisiana,2020/8/30,95.80598891,1624,27,148568,4931,No,Yes,8511
Louisiana,2020/8/31,95.80598891,326,19,148894,4950,No,Yes,8511
Louisiana,2020/9/1,95.80598891,689,34,149583,4984,No,Yes,8511
Louisiana,2020/9/2,95.80598891,1151,20,150734,5004,No,Yes,8901
Louisiana,2020/9/3,95.80598891,813,17,151547,5021,No,Yes,8901
Louisiana,2020/9/4,95.80598891,822,14,152369,5035,No,Yes,8901
Louisiana,2020/9/5,95.80598891,0,0,152369,5035,No,Yes,8901
Louisiana,2020/9/6,95.80598891,1395,58,153764,5093,No,Yes,8901
Louisiana,2020/9/7,95.80598891,309,12,154073,5105,No,Yes,8901
Louisiana,2020/9/8,95.80598891,256,13,154329,5118,No,Yes,8901
Louisiana,2020/9/9,95.80598891,1561,22,155890,5140,No,Yes,8848
Louisiana,2020/9/10,95.80598891,464,21,156354,5161,No,Yes,8848
Louisiana,2020/9/11,95.80598891,755,41,157109,5202,No,Yes,8848
Louisiana,2020/9/12,95.80598891,0,0,157109,5202,No,No,8848
Louisiana,2020/9/13,95.80598891,1281,33,158390,5235,No,No,8848
Louisiana,2020/9/14,95.80598891,492,17,158882,5252,No,No,8848
Louisiana,2020/9/15,95.80598891,371,26,159253,5278,No,No,8848
Louisiana,2020/9/16,95.80598891,612,16,159865,5294,No,No,8679
Louisiana,2020/9/17,95.80598891,478,17,160343,5311,No,No,8679
Louisiana,2020/9/18,95.80598891,979,29,161322,5340,No,No,8679
Louisiana,2020/9/19,95.80598891,0,0,161322,5340,No,No,8679
Louisiana,2020/9/20,95.80598891,936,26,162258,5366,No,No,8679
Louisiana,2020/9/21,95.80598891,243,9,162501,5375,No,No,8679
Louisiana,2020/9/22,95.80598891,752,11,163253,5386,No,No,8679
Louisiana,2020/9/23,95.80598891,616,21,163869,5407,No,No,8805
Louisiana,2020/9/24,95.80598891,577,16,164446,5423,No,No,8805
Louisiana,2020/9/25,95.80598891,706,21,165152,5444,No,No,8805
Louisiana,2020/9/26,95.80598891,0,0,165152,5444,No,No,8805
Louisiana,2020/9/27,95.80598891,923,21,166075,5465,No,No,8805
Louisiana,2020/9/28,95.80598891,240,15,166315,5480,No,No,8805
Louisiana,2020/9/29,95.80598891,533,10,166848,5490,No,No,8805
Louisiana,2020/9/30,95.80598891,610,21,167458,5511,No,No,7732
Louisiana,2020/10/1,95.80598891,551,8,168009,5519,No,No,7732
Louisiana,2020/10/2,95.80598891,817,26,168826,5545,No,No,7732
Louisiana,2020/10/3,95.80598891,0,0,168826,5545,No,No,7732
Louisiana,2020/10/4,95.80598891,893,32,169719,5577,No,No,7732
Louisiana,2020/10/5,95.80598891,218,9,169937,5586,No,No,7732
Louisiana,2020/10/6,95.80598891,532,6,170469,5592,No,No,7732
Louisiana,2020/10/7,95.80598891,2156,12,172625,5604,No,No,8581
Louisiana,2020/10/8,95.80598891,524,5,173149,5609,No,No,8581
Louisiana,2020/10/9,95.80598891,257,26,173406,5635,No,No,8581
Louisiana,2020/10/10,95.80598891,0,0,173406,5635,No,No,8581
Louisiana,2020/10/11,95.80598891,1181,20,174587,5655,No,No,8581
Louisiana,2020/10/12,95.80598891,60,14,174647,5669,No,No,8581
Louisiana,2020/10/13,95.80598891,682,10,175329,5679,No,No,8581
Louisiana,2020/10/14,95.80598891,880,16,176209,5695,No,No,7964
Louisiana,2020/10/15,95.80598891,743,12,176952,5707,No,No,7964
Louisiana,2020/10/16,95.80598891,774,20,177726,5727,No,No,7964
Louisiana,2020/10/17,95.80598891,0,0,177726,5727,No,No,7964
Louisiana,2020/10/18,95.80598891,1143,23,178869,5750,No,No,7964
Louisiana,2020/10/19,95.80598891,201,16,179070,5766,No,No,7964
Louisiana,2020/10/20,95.80598891,699,6,179769,5772,No,No,7964
Louisiana,2020/10/21,95.80598891,1363,18,181132,5790,No,No,7126
Louisiana,2020/10/22,95.80598891,772,9,181904,5799,No,No,7126
Louisiana,2020/10/23,95.80598891,699,21,182603,5820,No,No,7126
Louisiana,2020/10/24,95.80598891,0,0,182603,5820,No,No,7126
Louisiana,2020/10/25,95.80598891,972,17,183575,5837,No,No,7126
Louisiana,2020/10/26,95.80598891,227,17,183802,5854,No,No,7126
Louisiana,2020/10/27,95.80598891,922,18,184724,5872,No,No,7126
Louisiana,2020/10/28,95.80598891,1098,18,185822,5890,No,No,7060
Louisiana,2020/10/29,95.80598891,394,18,186216,5908,No,No,7060
Louisiana,2020/10/30,95.80598891,433,11,186649,5919,No,No,7060
Louisiana,2020/10/31,95.80598891,0,0,186649,5919,No,No,7060
Louisiana,2020/11/1,95.80598891,1071,7,187720,5926,No,No,7060
Louisiana,2020/11/2,95.80598891,275,8,187995,5934,No,No,7060
Louisiana,2020/11/3,95.80598891,1153,17,189148,5951,No,No,7060
Louisiana,2020/11/4,95.80598891,1016,24,190164,5975,No,No,8764
Louisiana,2020/11/5,95.80598891,681,20,190845,5995,No,No,8764
Louisiana,2020/11/6,95.80598891,870,21,191715,6016,No,No,8764
Louisiana,2020/11/7,95.80598891,0,0,191715,6016,No,No,8764
Louisiana,2020/11/8,95.80598891,1266,20,192981,6036,No,No,8764
Louisiana,2020/11/9,95.80598891,391,12,193372,6048,No,No,8764
Louisiana,2020/11/10,95.80598891,1330,10,194702,6058,No,No,8764
Louisiana,2020/11/11,95.80598891,0,0,194702,6058,No,No,9262
Louisiana,2020/11/12,95.80598891,3829,39,198531,6097,No,No,9262
Louisiana,2020/11/13,95.80598891,3450,24,201981,6121,No,No,9262
Louisiana,2020/11/14,95.80598891,0,0,201981,6121,No,No,9262
Louisiana,2020/11/15,95.80598891,2532,11,204513,6132,No,No,9262
Louisiana,2020/11/16,95.80598891,546,7,205059,6139,No,No,9262
Louisiana,2020/11/17,95.80598891,2626,17,207685,6156,No,No,9262
Louisiana,2020/11/18,95.80598891,2229,28,209914,6184,No,No,11813
Louisiana,2020/11/19,95.80598891,2052,15,211966,6199,No,No,11813
Louisiana,2020/11/20,95.80598891,4743,34,216709,6233,No,No,11813
Louisiana,2020/11/21,95.80598891,0,0,216709,6233,No,No,11813
Louisiana,2020/11/22,95.80598891,3483,27,220192,6260,No,No,11813
Louisiana,2020/11/23,95.80598891,968,24,221160,6284,No,No,11813
Louisiana,2020/11/24,95.80598891,3243,39,224403,6323,No,No,11813
Louisiana,2020/11/25,95.80598891,1235,27,225638,6350,No,No,7061
Louisiana,2020/11/26,95.80598891,0,0,225638,6350,No,No,7061
Louisiana,2020/11/27,95.80598891,4964,41,230602,6391,No,No,7061
Louisiana,2020/11/28,95.80598891,0,0,230602,6391,No,No,7061
Louisiana,2020/11/29,95.80598891,1643,16,232245,6407,No,No,7061
Louisiana,2020/11/30,95.80598891,169,13,232414,6420,No,No,7061
Louisiana,2020/12/1,95.80598891,5326,35,237740,6455,No,No,7061
Louisiana,2020/12/2,95.80598891,3595,46,241335,6501,No,No,7656
Louisiana,2020/12/3,95.80598891,2743,23,244078,6524,No,No,7656
Louisiana,2020/12/4,95.80598891,3099,24,247177,6548,No,No,7656
Louisiana,2020/12/5,95.80598891,0,0,247177,6548,No,No,7656
Louisiana,2020/12/6,95.80598891,3946,36,251123,6584,No,No,7656
Louisiana,2020/12/7,95.80598891,1013,23,252136,6607,No,No,7656
Louisiana,2020/12/8,95.80598891,2426,45,254562,6652,No,No,7656
Louisiana,2020/12/9,95.80598891,4352,32,258914,6684,No,No,7568
Louisiana,2020/12/10,95.80598891,2415,40,261329,6724,No,No,7568
Louisiana,2020/12/11,95.80598891,2862,43,264191,6767,No,No,7568
Louisiana,2020/12/12,95.80598891,0,0,264191,6767,No,No,7568
Louisiana,2020/12/13,95.80598891,4422,51,268613,6818,No,No,7568
Louisiana,2020/12/14,95.80598891,1030,27,269643,6845,No,No,7568
Louisiana,2020/12/15,95.80598891,2633,50,272276,6895,No,No,7568
Louisiana,2020/12/16,95.80598891,3269,38,275545,6933,No,No,7543
Louisiana,2020/12/17,95.80598891,3776,31,279321,6964,No,No,7543
Louisiana,2020/12/18,95.80598891,3113,30,282434,6994,No,No,7543
Louisiana,2020/12/19,95.80598891,0,0,282434,6994,No,No,7543
Louisiana,2020/12/20,95.80598891,3711,48,286145,7042,No,No,7543
Louisiana,2020/12/21,95.80598891,1116,65,287261,7107,No,No,7543
Louisiana,2020/12/22,95.80598891,3699,51,290960,7158,No,No,7543
Louisiana,2020/12/23,95.80598891,2974,68,293934,7226,No,No,5506
Louisiana,2020/12/24,95.80598891,2565,46,296499,7272,No,No,5506
Louisiana,2020/12/25,95.80598891,0,0,296499,7272,No,No,5506
Louisiana,2020/12/26,95.80598891,0,0,296499,7272,No,No,5506
Louisiana,2020/12/27,95.80598891,3223,19,299722,7291,No,No,5506
Louisiana,2020/12/28,95.80598891,817,45,300539,7336,No,No,5506
Louisiana,2020/12/29,95.80598891,3946,61,304485,7397,No,No,5506
Louisiana,2020/12/30,95.80598891,6744,51,311229,7448,No,No,10986
Louisiana,2020/12/31,95.80598891,4046,40,315275,7488,No,No,10986
Louisiana,2021/1/1,95.80598891,0,0,315275,7488,No,No,10986
Louisiana,2021/1/2,95.80598891,0,0,315275,7488,No,No,10986
Louisiana,2021/1/3,95.80598891,5783,49,321058,7537,No,No,10986
Louisiana,2021/1/4,95.80598891,1123,48,322181,7585,No,No,10986
Louisiana,2021/1/5,95.80598891,4467,50,326648,7635,No,No,10986
Louisiana,2021/1/6,95.80598891,6876,46,333524,7681,No,No,14084
Louisiana,2021/1/7,95.80598891,4530,47,338054,7728,No,No,14084
Louisiana,2021/1/8,95.80598891,3377,105,341431,7833,No,No,14084
Louisiana,2021/1/9,95.80598891,0,0,341431,7833,No,No,14084
Louisiana,2021/1/10,95.80598891,5398,40,346829,7873,No,No,14084
Louisiana,2021/1/11,95.80598891,1405,45,348234,7918,No,No,14084
Louisiana,2021/1/12,95.80598891,4705,53,352939,7971,No,No,14084
Louisiana,2021/1/13,95.80598891,2896,51,355835,8022,No,No,11980
Louisiana,2021/1/14,95.80598891,5313,58,361148,8080,No,No,11980
Louisiana,2021/1/15,95.80598891,3705,0,364853,8080,No,No,11980
Louisiana,2021/1/16,95.80598891,0,0,364853,8080,No,No,11980
Louisiana,2021/1/17,95.80598891,4127,123,368980,8203,No,No,11980
Louisiana,2021/1/18,95.80598891,971,50,369951,8253,No,No,11980
Louisiana,2021/1/19,95.80598891,2138,71,372089,8324,No,No,11980
Louisiana,2021/1/20,95.80598891,2493,59,374582,8383,No,No,11615
Louisiana,2021/1/21,95.80598891,3736,59,378318,8442,No,No,11615
Louisiana,2021/1/22,95.80598891,1937,41,380255,8483,No,No,11615
Louisiana,2021/1/23,95.80598891,0,0,380255,8483,No,No,11615
Louisiana,2021/1/24,95.80598891,3607,82,383862,8565,No,No,11615
Louisiana,2021/1/25,95.80598891,2080,25,385942,8590,No,No,11615
Louisiana,2021/1/26,95.80598891,2620,31,388562,8621,No,No,11615
Louisiana,2021/1/27,95.80598891,3854,67,392416,8688,No,No,12664
Louisiana,2021/1/28,95.80598891,2493,55,394909,8743,No,No,12664
Louisiana,2021/1/29,95.80598891,2367,58,397276,8801,No,No,12664
Louisiana,2021/1/30,95.80598891,0,0,397276,8801,No,No,12664
Louisiana,2021/1/31,95.80598891,3350,58,400626,8859,No,No,12664
Louisiana,2021/2/1,95.80598891,965,53,401591,8912,No,No,12664
Louisiana,2021/2/2,95.80598891,2603,41,404194,8953,No,No,12664
Louisiana,2021/2/3,95.80598891,2041,53,406235,9006,No,No,13464
Louisiana,2021/2/4,95.80598891,2760,38,408995,9044,No,No,13464
Louisiana,2021/2/5,95.80598891,866,32,409861,9076,No,No,13464
Louisiana,2021/2/6,95.80598891,0,0,409861,9076,No,No,13464
Louisiana,2021/2/7,95.80598891,1951,43,411812,9119,No,No,13464
Louisiana,2021/2/8,95.80598891,1177,23,412989,9142,No,No,13464
Louisiana,2021/2/9,95.80598891,1365,20,414354,9162,No,No,13464
Louisiana,2021/2/10,95.80598891,333,50,414687,9212,No,No,12087
Louisiana,2021/2/11,95.80598891,2728,27,417415,9239,No,No,12087
Louisiana,2021/2/12,95.80598891,1170,37,418585,9276,No,No,12087
Louisiana,2021/2/13,95.80598891,0,0,418585,9276,No,No,12087
Louisiana,2021/2/14,95.80598891,1306,16,419891,9292,No,No,12087
Louisiana,2021/2/15,95.80598891,503,33,420394,9325,No,No,12087
Louisiana,2021/2/16,95.80598891,0,0,420394,9325,No,No,12087
Louisiana,2021/2/17,95.80598891,624,66,421018,9391,No,No,11395
Louisiana,2021/2/18,95.80598891,828,15,421846,9406,No,No,11395
Louisiana,2021/2/19,95.80598891,441,34,422287,9440,No,No,11395
Louisiana,2021/2/20,95.80598891,0,0,422287,9440,No,No,11395
Louisiana,2021/2/21,95.80598891,1889,26,424176,9466,No,No,11395
Louisiana,2021/2/22,95.80598891,468,11,424644,9477,No,No,11395
Louisiana,2021/2/23,95.80598891,1404,26,426048,9503,No,No,11395
Louisiana,2021/2/24,95.80598891,877,25,426925,9528,No,No,11395
Louisiana,2021/2/25,95.80598891,764,33,427689,9561,No,No,11395
Louisiana,2021/2/26,95.80598891,903,26,428592,9587,No,No,11395
Louisiana,2021/2/27,95.80598891,0,0,428592,9587,No,No,11395
Louisiana,2021/2/28,95.80598891,1508,21,430100,9608,No,No,11395
Louisiana,2021/3/1,95.80598891,404,20,430504,9628,No,No,11395
Louisiana,2021/3/2,95.80598891,767,19,431271,9647,No,No,11395
Louisiana,2021/3/3,95.80598891,500,21,431771,9668,No,No,11395
Louisiana,2021/3/4,95.80598891,756,18,432527,9686,No,No,11395
Maine,2020/3/1,40.4700286,0,0,0,0,No,No,1575
Maine,2020/3/2,40.4700286,0,0,0,0,No,No,1575
Maine,2020/3/3,40.4700286,0,0,0,0,No,No,1575
Maine,2020/3/4,40.4700286,0,0,0,0,No,No,1663
Maine,2020/3/5,40.4700286,0,0,0,0,No,No,1663
Maine,2020/3/6,40.4700286,0,0,0,0,No,No,1663
Maine,2020/3/7,40.4700286,0,0,0,0,No,No,1663
Maine,2020/3/8,40.4700286,0,0,0,0,No,No,1663
Maine,2020/3/9,40.4700286,0,0,0,0,No,No,1663
Maine,2020/3/10,40.4700286,0,0,0,0,No,No,1663
Maine,2020/3/11,40.4700286,0,0,0,0,No,No,1819
Maine,2020/3/12,40.4700286,1,0,1,0,No,No,1819
Maine,2020/3/13,40.4700286,1,0,2,0,No,No,1819
Maine,2020/3/14,40.4700286,1,0,3,0,No,No,1819
Maine,2020/3/15,40.4700286,9,0,12,0,No,No,1819
Maine,2020/3/16,40.4700286,5,0,17,0,No,No,1819
Maine,2020/3/17,40.4700286,15,0,32,0,No,No,1819
Maine,2020/3/18,40.4700286,11,0,43,0,No,No,10892
Maine,2020/3/19,40.4700286,9,0,52,0,No,No,10892
Maine,2020/3/20,40.4700286,5,0,57,0,No,No,10892
Maine,2020/3/21,40.4700286,13,0,70,0,No,No,10892
Maine,2020/3/22,40.4700286,19,0,89,0,No,No,10892
Maine,2020/3/23,40.4700286,18,0,107,0,No,No,10892
Maine,2020/3/24,40.4700286,11,0,118,0,No,No,10892
Maine,2020/3/25,40.4700286,24,0,142,0,No,No,80984
Maine,2020/3/26,40.4700286,13,0,155,0,No,No,80984
Maine,2020/3/27,40.4700286,13,1,168,1,No,No,80984
Maine,2020/3/28,40.4700286,43,0,211,1,No,No,80984
Maine,2020/3/29,40.4700286,42,2,253,3,No,No,80984
Maine,2020/3/30,40.4700286,22,0,275,3,No,No,80984
Maine,2020/3/31,40.4700286,28,2,303,5,No,No,80984
Maine,2020/4/1,40.4700286,41,2,344,7,No,No,106739
Maine,2020/4/2,40.4700286,32,0,376,7,Yes,No,106739
Maine,2020/4/3,40.4700286,56,2,432,9,Yes,No,106739
Maine,2020/4/4,40.4700286,24,1,456,10,Yes,No,106739
Maine,2020/4/5,40.4700286,14,0,470,10,Yes,No,106739
Maine,2020/4/6,40.4700286,29,0,499,10,Yes,No,106739
Maine,2020/4/7,40.4700286,20,2,519,12,Yes,No,106739
Maine,2020/4/8,40.4700286,18,2,537,14,Yes,No,77515
Maine,2020/4/9,40.4700286,23,2,560,16,Yes,No,77515
Maine,2020/4/10,40.4700286,26,1,586,17,Yes,No,77515
Maine,2020/4/11,40.4700286,30,2,616,19,Yes,No,77515
Maine,2020/4/12,40.4700286,17,0,633,19,Yes,No,77515
Maine,2020/4/13,40.4700286,65,0,698,19,Yes,No,77515
Maine,2020/4/14,40.4700286,36,1,734,20,Yes,No,77515
Maine,2020/4/15,40.4700286,36,4,770,24,Yes,No,66432
Maine,2020/4/16,40.4700286,26,3,796,27,Yes,No,66432
Maine,2020/4/17,40.4700286,31,2,827,29,Yes,No,66432
Maine,2020/4/18,40.4700286,20,3,847,32,Yes,No,66432
Maine,2020/4/19,40.4700286,20,2,867,34,Yes,No,66432
Maine,2020/4/20,40.4700286,8,1,875,35,Yes,No,66432
Maine,2020/4/21,40.4700286,13,1,888,36,Yes,No,66432
Maine,2020/4/22,40.4700286,19,3,907,39,Yes,No,74966
Maine,2020/4/23,40.4700286,30,5,937,44,Yes,No,74966
Maine,2020/4/24,40.4700286,28,3,965,47,Yes,No,74966
Maine,2020/4/25,40.4700286,25,3,990,50,Yes,No,74966
Maine,2020/4/26,40.4700286,25,0,1015,50,Yes,No,74966
Maine,2020/4/27,40.4700286,8,1,1023,51,Yes,No,74966
Maine,2020/4/28,40.4700286,17,0,1040,51,Yes,No,74966
Maine,2020/4/29,40.4700286,16,1,1056,52,Yes,No,28985
Maine,2020/4/30,40.4700286,39,1,1095,53,Yes,No,28985
Maine,2020/5/1,40.4700286,28,2,1123,55,Yes,No,28985
Maine,2020/5/2,40.4700286,29,1,1152,56,Yes,No,28985
Maine,2020/5/3,40.4700286,33,1,1185,57,Yes,No,28985
Maine,2020/5/4,40.4700286,20,0,1205,57,Yes,No,28985
Maine,2020/5/5,40.4700286,21,4,1226,61,Yes,No,28985
Maine,2020/5/6,40.4700286,28,1,1254,62,Yes,No,26666
Maine,2020/5/7,40.4700286,76,0,1330,62,Yes,No,26666
Maine,2020/5/8,40.4700286,44,1,1374,63,Yes,No,26666
Maine,2020/5/9,40.4700286,34,1,1408,64,Yes,No,26666
Maine,2020/5/10,40.4700286,28,0,1436,64,Yes,No,26666
Maine,2020/5/11,40.4700286,26,1,1462,65,Yes,No,26666
Maine,2020/5/12,40.4700286,15,0,1477,65,Yes,No,26666
Maine,2020/5/13,40.4700286,38,1,1515,66,Yes,No,25150
Maine,2020/5/14,40.4700286,50,3,1565,69,Yes,No,25150
Maine,2020/5/15,40.4700286,38,0,1603,69,Yes,No,25150
Maine,2020/5/16,40.4700286,45,1,1648,70,Yes,No,25150
Maine,2020/5/17,40.4700286,39,0,1687,70,Yes,No,25150
Maine,2020/5/18,40.4700286,26,1,1713,71,Yes,No,25150
Maine,2020/5/19,40.4700286,28,2,1741,73,Yes,No,25150
Maine,2020/5/20,40.4700286,78,0,1819,73,Yes,No,27919
Maine,2020/5/21,40.4700286,58,0,1877,73,Yes,No,27919
Maine,2020/5/22,40.4700286,71,2,1948,75,Yes,No,27919
Maine,2020/5/23,40.4700286,65,2,2013,77,Yes,No,27919
Maine,2020/5/24,40.4700286,42,1,2055,78,Yes,No,27919
Maine,2020/5/25,40.4700286,19,0,2074,78,Yes,No,27919
Maine,2020/5/26,40.4700286,35,1,2109,79,Yes,No,27919
Maine,2020/5/27,40.4700286,28,2,2137,81,Yes,No,21335
Maine,2020/5/28,40.4700286,52,3,2189,84,Yes,No,21335
Maine,2020/5/29,40.4700286,37,1,2226,85,Yes,No,21335
Maine,2020/5/30,40.4700286,56,4,2282,89,Yes,No,21335
Maine,2020/5/31,40.4700286,43,0,2325,89,Yes,No,21335
Maine,2020/6/1,40.4700286,24,0,2349,89,No,No,21335
Maine,2020/6/2,40.4700286,28,5,2377,94,No,No,21335
Maine,2020/6/3,40.4700286,41,1,2418,95,No,No,19949
Maine,2020/6/4,40.4700286,28,0,2446,95,No,No,19949
Maine,2020/6/5,40.4700286,36,3,2482,98,No,No,19949
Maine,2020/6/6,40.4700286,42,0,2524,98,No,No,19949
Maine,2020/6/7,40.4700286,46,1,2570,99,No,No,19949
Maine,2020/6/8,40.4700286,18,0,2588,99,No,No,19949
Maine,2020/6/9,40.4700286,18,1,2606,100,No,No,19949
Maine,2020/6/10,40.4700286,31,0,2637,100,No,No,18367
Maine,2020/6/11,40.4700286,30,0,2667,100,No,No,18367
Maine,2020/6/12,40.4700286,54,0,2721,100,No,No,18367
Maine,2020/6/13,40.4700286,36,0,2757,100,No,No,18367
Maine,2020/6/14,40.4700286,36,0,2793,100,No,No,18367
Maine,2020/6/15,40.4700286,17,1,2810,101,No,No,18367
Maine,2020/6/16,40.4700286,9,0,2819,101,No,No,18367
Maine,2020/6/17,40.4700286,17,1,2836,102,No,No,18671
Maine,2020/6/18,40.4700286,42,0,2878,102,No,No,18671
Maine,2020/6/19,40.4700286,35,0,2913,102,No,No,18671
Maine,2020/6/20,40.4700286,25,0,2938,102,No,No,18671
Maine,2020/6/21,40.4700286,19,0,2957,102,No,No,18671
Maine,2020/6/22,40.4700286,14,0,2971,102,No,No,18671
Maine,2020/6/23,40.4700286,23,0,2994,102,No,No,18671
Maine,2020/6/24,40.4700286,23,1,3017,103,No,No,18338
Maine,2020/6/25,40.4700286,53,0,3070,103,No,No,18338
Maine,2020/6/26,40.4700286,32,0,3102,103,No,No,18338
Maine,2020/6/27,40.4700286,52,1,3154,104,No,No,18338
Maine,2020/6/28,40.4700286,37,0,3191,104,No,No,18338
Maine,2020/6/29,40.4700286,28,1,3219,105,No,No,18338
Maine,2020/6/30,40.4700286,34,0,3253,105,No,No,18338
Maine,2020/7/1,40.4700286,41,0,3294,105,No,No,19056
Maine,2020/7/2,40.4700286,34,0,3328,105,No,No,19056
Maine,2020/7/3,40.4700286,45,0,3373,105,No,No,19056
Maine,2020/7/4,40.4700286,24,2,3397,107,No,No,19056
Maine,2020/7/5,40.4700286,18,2,3415,109,No,No,19056
Maine,2020/7/6,40.4700286,8,0,3423,109,No,No,19056
Maine,2020/7/7,40.4700286,17,1,3440,110,No,No,19056
Maine,2020/7/8,40.4700286,20,0,3460,110,No,No,20563
Maine,2020/7/9,40.4700286,26,1,3486,111,No,No,20563
Maine,2020/7/10,40.4700286,13,0,3499,111,No,No,20563
Maine,2020/7/11,40.4700286,21,1,3520,112,No,No,20563
Maine,2020/7/12,40.4700286,19,2,3539,114,No,No,20563
Maine,2020/7/13,40.4700286,19,0,3558,114,No,No,20563
Maine,2020/7/14,40.4700286,8,0,3566,114,No,No,20563
Maine,2020/7/15,40.4700286,12,0,3578,114,No,No,23676
Maine,2020/7/16,40.4700286,20,0,3598,114,No,No,23676
Maine,2020/7/17,40.4700286,38,1,3636,115,No,No,23676
Maine,2020/7/18,40.4700286,10,2,3646,117,No,No,23676
Maine,2020/7/19,40.4700286,41,0,3687,117,No,No,23676
Maine,2020/7/20,40.4700286,24,0,3711,117,No,No,23676
Maine,2020/7/21,40.4700286,12,1,3723,118,No,No,23676
Maine,2020/7/22,40.4700286,0,0,3723,118,No,No,17437
Maine,2020/7/23,40.4700286,14,0,3737,118,No,No,17437
Maine,2020/7/24,40.4700286,20,0,3757,118,No,No,17437
Maine,2020/7/25,40.4700286,33,1,3790,119,No,No,17437
Maine,2020/7/26,40.4700286,24,0,3814,119,No,No,17437
Maine,2020/7/27,40.4700286,18,0,3832,119,No,No,17437
Maine,2020/7/28,40.4700286,6,2,3838,121,No,No,17437
Maine,2020/7/29,40.4700286,28,0,3866,121,No,No,11690
Maine,2020/7/30,40.4700286,22,1,3888,122,No,No,11690
Maine,2020/7/31,40.4700286,24,1,3912,123,No,No,11690
Maine,2020/8/1,40.4700286,25,0,3937,123,No,Yes,11690
Maine,2020/8/2,40.4700286,21,0,3958,123,No,Yes,11690
Maine,2020/8/3,40.4700286,12,1,3970,124,No,Yes,11690
Maine,2020/8/4,40.4700286,5,-1,3975,123,No,Yes,11690
Maine,2020/8/5,40.4700286,17,1,3992,124,No,Yes,9467
Maine,2020/8/6,40.4700286,5,0,3997,124,No,Yes,9467
Maine,2020/8/7,40.4700286,17,0,4014,124,No,Yes,9467
Maine,2020/8/8,40.4700286,12,1,4026,125,No,Yes,9467
Maine,2020/8/9,40.4700286,16,0,4042,125,No,Yes,9467
Maine,2020/8/10,40.4700286,7,0,4049,125,No,Yes,9467
Maine,2020/8/11,40.4700286,1,1,4050,126,No,Yes,9467
Maine,2020/8/12,40.4700286,20,0,4070,126,No,Yes,11047
Maine,2020/8/13,40.4700286,19,0,4089,126,No,Yes,11047
Maine,2020/8/14,40.4700286,26,0,4115,126,No,Yes,11047
Maine,2020/8/15,40.4700286,29,1,4144,127,No,Yes,11047
Maine,2020/8/16,40.4700286,24,0,4168,127,No,Yes,11047
Maine,2020/8/17,40.4700286,29,0,4197,127,No,Yes,11047
Maine,2020/8/18,40.4700286,16,0,4213,127,No,Yes,11047
Maine,2020/8/19,40.4700286,21,0,4234,127,No,Yes,8676
Maine,2020/8/20,40.4700286,18,1,4252,128,No,Yes,8676
Maine,2020/8/21,40.4700286,33,1,4285,129,No,Yes,8676
Maine,2020/8/22,40.4700286,32,1,4317,130,No,Yes,8676
Maine,2020/8/23,40.4700286,18,1,4335,131,No,Yes,8676
Maine,2020/8/24,40.4700286,21,0,4356,131,No,Yes,8676
Maine,2020/8/25,40.4700286,12,0,4368,131,No,Yes,8676
Maine,2020/8/26,40.4700286,21,1,4389,132,No,Yes,8511
Maine,2020/8/27,40.4700286,25,0,4414,132,No,Yes,8511
Maine,2020/8/28,40.4700286,22,0,4436,132,No,Yes,8511
Maine,2020/8/29,40.4700286,53,0,4489,132,No,Yes,8511
Maine,2020/8/30,40.4700286,23,0,4512,132,No,Yes,8511
Maine,2020/8/31,40.4700286,14,0,4526,132,No,Yes,8511
Maine,2020/9/1,40.4700286,22,0,4548,132,No,Yes,8511
Maine,2020/9/2,40.4700286,19,1,4567,133,No,Yes,8901
Maine,2020/9/3,40.4700286,50,0,4617,133,No,Yes,8901
Maine,2020/9/4,40.4700286,15,1,4632,134,No,Yes,8901
Maine,2020/9/5,40.4700286,35,0,4667,134,No,Yes,8901
Maine,2020/9/6,40.4700286,15,0,4682,134,No,Yes,8901
Maine,2020/9/7,40.4700286,19,0,4701,134,No,Yes,8901
Maine,2020/9/8,40.4700286,12,0,4713,134,No,Yes,8901
Maine,2020/9/9,40.4700286,21,0,4734,134,No,Yes,8848
Maine,2020/9/10,40.4700286,26,0,4760,134,No,Yes,8848
Maine,2020/9/11,40.4700286,32,0,4792,134,No,Yes,8848
Maine,2020/9/12,40.4700286,42,1,4834,135,No,Yes,8848
Maine,2020/9/13,40.4700286,29,1,4863,136,No,Yes,8848
Maine,2020/9/14,40.4700286,40,0,4903,136,No,Yes,8848
Maine,2020/9/15,40.4700286,15,1,4918,137,No,Yes,8848
Maine,2020/9/16,40.4700286,23,1,4941,138,No,Yes,8679
Maine,2020/9/17,40.4700286,21,0,4962,138,No,Yes,8679
Maine,2020/9/18,40.4700286,43,0,5005,138,No,Yes,8679
Maine,2020/9/19,40.4700286,30,1,5035,139,No,Yes,8679
Maine,2020/9/20,40.4700286,44,0,5079,139,No,Yes,8679
Maine,2020/9/21,40.4700286,27,1,5106,140,No,Yes,8679
Maine,2020/9/22,40.4700286,40,0,5146,140,No,Yes,8679
Maine,2020/9/23,40.4700286,25,0,5171,140,No,Yes,8805
Maine,2020/9/24,40.4700286,44,0,5215,140,No,Yes,8805
Maine,2020/9/25,40.4700286,20,0,5235,140,No,Yes,8805
Maine,2020/9/26,40.4700286,25,0,5260,140,No,Yes,8805
Maine,2020/9/27,40.4700286,28,0,5288,140,No,Yes,8805
Maine,2020/9/28,40.4700286,12,0,5300,140,No,Yes,8805
Maine,2020/9/29,40.4700286,37,1,5337,141,No,Yes,8805
Maine,2020/9/30,40.4700286,54,0,5391,141,No,Yes,7732
Maine,2020/10/1,40.4700286,40,1,5431,142,No,Yes,7732
Maine,2020/10/2,40.4700286,37,0,5468,142,No,Yes,7732
Maine,2020/10/3,40.4700286,18,0,5486,142,No,Yes,7732
Maine,2020/10/4,40.4700286,33,0,5519,142,No,Yes,7732
Maine,2020/10/5,40.4700286,26,0,5545,142,No,Yes,7732
Maine,2020/10/6,40.4700286,20,0,5565,142,No,Yes,7732
Maine,2020/10/7,40.4700286,39,0,5604,142,No,Yes,8581
Maine,2020/10/8,40.4700286,35,0,5639,142,No,Yes,8581
Maine,2020/10/9,40.4700286,27,1,5666,143,No,Yes,8581
Maine,2020/10/10,40.4700286,30,0,5696,143,No,Yes,8581
Maine,2020/10/11,40.4700286,27,0,5723,143,No,Yes,8581
Maine,2020/10/12,40.4700286,29,0,5752,143,No,Yes,8581
Maine,2020/10/13,40.4700286,28,0,5780,143,No,Yes,8581
Maine,2020/10/14,40.4700286,36,0,5816,143,No,Yes,7964
Maine,2020/10/15,40.4700286,20,1,5836,144,No,Yes,7964
Maine,2020/10/16,40.4700286,29,1,5865,145,No,Yes,7964
Maine,2020/10/17,40.4700286,48,1,5913,146,No,Yes,7964
Maine,2020/10/18,40.4700286,26,0,5939,146,No,Yes,7964
Maine,2020/10/19,40.4700286,23,0,5962,146,No,Yes,7964
Maine,2020/10/20,40.4700286,27,0,5989,146,No,Yes,7964
Maine,2020/10/21,40.4700286,38,0,6027,146,No,Yes,7126
Maine,2020/10/22,40.4700286,37,0,6064,146,No,Yes,7126
Maine,2020/10/23,40.4700286,31,0,6095,146,No,Yes,7126
Maine,2020/10/24,40.4700286,42,0,6137,146,No,Yes,7126
Maine,2020/10/25,40.4700286,64,0,6201,146,No,Yes,7126
Maine,2020/10/26,40.4700286,53,0,6254,146,No,Yes,7126
Maine,2020/10/27,40.4700286,57,0,6311,146,No,Yes,7126
Maine,2020/10/28,40.4700286,76,0,6387,146,No,Yes,7060
Maine,2020/10/29,40.4700286,80,0,6467,146,No,Yes,7060
Maine,2020/10/30,40.4700286,103,0,6570,146,No,Yes,7060
Maine,2020/10/31,40.4700286,98,1,6668,147,No,Yes,7060
Maine,2020/11/1,40.4700286,47,0,6715,147,No,Yes,7060
Maine,2020/11/2,40.4700286,84,1,6799,148,No,Yes,7060
Maine,2020/11/3,40.4700286,127,0,6926,148,No,Yes,7060
Maine,2020/11/4,40.4700286,151,2,7077,150,No,Yes,8764
Maine,2020/11/5,40.4700286,183,0,7260,150,No,Yes,8764
Maine,2020/11/6,40.4700286,184,0,7444,150,No,Yes,8764
Maine,2020/11/7,40.4700286,159,2,7603,152,No,Yes,8764
Maine,2020/11/8,40.4700286,90,0,7693,152,No,Yes,8764
Maine,2020/11/9,40.4700286,195,1,7888,153,No,Yes,8764
Maine,2020/11/10,40.4700286,172,3,8060,156,No,Yes,8764
Maine,2020/11/11,40.4700286,142,2,8202,158,No,Yes,9262
Maine,2020/11/12,40.4700286,193,1,8395,159,No,Yes,9262
Maine,2020/11/13,40.4700286,244,3,8639,162,No,Yes,9262
Maine,2020/11/14,40.4700286,152,1,8791,163,No,Yes,9262
Maine,2020/11/15,40.4700286,153,2,8944,165,No,Yes,9262
Maine,2020/11/16,40.4700286,173,0,9117,165,No,Yes,9262
Maine,2020/11/17,40.4700286,246,1,9363,166,No,Yes,9262
Maine,2020/11/18,40.4700286,156,4,9519,170,No,Yes,11813
Maine,2020/11/19,40.4700286,215,1,9734,171,No,Yes,11813
Maine,2020/11/20,40.4700286,224,2,9958,173,No,Yes,11813
Maine,2020/11/21,40.4700286,165,1,10123,174,No,Yes,11813
Maine,2020/11/22,40.4700286,236,2,10359,176,No,Yes,11813
Maine,2020/11/23,40.4700286,185,1,10544,177,No,Yes,11813
Maine,2020/11/24,40.4700286,255,12,10799,189,No,Yes,11813
Maine,2020/11/25,40.4700286,228,1,11027,190,No,Yes,7061
Maine,2020/11/26,40.4700286,238,0,11265,190,No,Yes,7061
Maine,2020/11/27,40.4700286,0,0,11265,190,No,Yes,7061
Maine,2020/11/28,40.4700286,23,1,11288,191,No,Yes,7061
Maine,2020/11/29,40.4700286,220,0,11508,191,No,Yes,7061
Maine,2020/11/30,40.4700286,249,3,11757,194,No,Yes,7061
Maine,2020/12/1,40.4700286,219,20,11976,214,No,Yes,7061
Maine,2020/12/2,40.4700286,232,4,12208,218,No,Yes,7656
Maine,2020/12/3,40.4700286,346,2,12554,220,No,Yes,7656
Maine,2020/12/4,40.4700286,290,4,12844,224,No,Yes,7656
Maine,2020/12/5,40.4700286,283,3,13127,227,No,Yes,7656
Maine,2020/12/6,40.4700286,221,0,13348,227,No,Yes,7656
Maine,2020/12/7,40.4700286,427,0,13775,227,No,Yes,7656
Maine,2020/12/8,40.4700286,274,12,14049,239,No,Yes,7656
Maine,2020/12/9,40.4700286,405,7,14454,246,No,Yes,7568
Maine,2020/12/10,40.4700286,407,0,14861,246,No,Yes,7568
Maine,2020/12/11,40.4700286,345,4,15206,250,No,Yes,7568
Maine,2020/12/12,40.4700286,414,7,15620,257,No,Yes,7568
Maine,2020/12/13,40.4700286,303,0,15923,257,No,Yes,7568
Maine,2020/12/14,40.4700286,426,2,16349,259,No,Yes,7568
Maine,2020/12/15,40.4700286,411,6,16760,265,No,Yes,7568
Maine,2020/12/16,40.4700286,551,2,17311,267,No,Yes,7543
Maine,2020/12/17,40.4700286,590,9,17901,276,No,Yes,7543
Maine,2020/12/18,40.4700286,436,5,18337,281,No,Yes,7543
Maine,2020/12/19,40.4700286,402,11,18739,292,No,Yes,7543
Maine,2020/12/20,40.4700286,207,0,18946,292,No,Yes,7543
Maine,2020/12/21,40.4700286,339,1,19285,293,No,Yes,7543
Maine,2020/12/22,40.4700286,458,10,19743,303,No,Yes,7543
Maine,2020/12/23,40.4700286,748,8,20491,311,No,Yes,5506
Maine,2020/12/24,40.4700286,735,6,21226,317,No,Yes,5506
Maine,2020/12/25,40.4700286,321,2,21547,319,No,Yes,5506
Maine,2020/12/26,40.4700286,0,0,21547,319,No,Yes,5506
Maine,2020/12/27,40.4700286,333,4,21880,323,No,Yes,5506
Maine,2020/12/28,40.4700286,439,3,22319,326,No,Yes,5506
Maine,2020/12/29,40.4700286,590,7,22909,333,No,Yes,5506
Maine,2020/12/30,40.4700286,590,1,23499,334,No,Yes,10986
Maine,2020/12/31,40.4700286,702,13,24201,347,No,Yes,10986
Maine,2021/1/1,40.4700286,0,0,24201,347,No,Yes,10986
Maine,2021/1/2,40.4700286,1044,11,25245,358,No,Yes,10986
Maine,2021/1/3,40.4700286,347,1,25592,359,No,Yes,10986
Maine,2021/1/4,40.4700286,376,1,25968,360,No,Yes,10986
Maine,2021/1/5,40.4700286,597,9,26565,369,No,Yes,10986
Maine,2021/1/6,40.4700286,525,3,27090,372,No,Yes,14084
Maine,2021/1/7,40.4700286,535,13,27625,385,No,Yes,14084
Maine,2021/1/8,40.4700286,782,41,28407,426,No,Yes,14084
Maine,2021/1/9,40.4700286,612,6,29019,432,No,Yes,14084
Maine,2021/1/10,40.4700286,279,0,29298,432,No,Yes,14084
Maine,2021/1/11,40.4700286,313,6,29611,438,No,Yes,14084
Maine,2021/1/12,40.4700286,715,11,30326,449,No,Yes,14084
Maine,2021/1/13,40.4700286,824,4,31150,453,No,Yes,11980
Maine,2021/1/14,40.4700286,808,8,31958,461,No,Yes,11980
Maine,2021/1/15,40.4700286,823,16,32781,477,No,Yes,11980
Maine,2021/1/16,40.4700286,438,30,33219,507,No,Yes,11980
Maine,2021/1/17,40.4700286,340,4,33559,511,No,Yes,11980
Maine,2021/1/18,40.4700286,317,3,33876,514,No,Yes,11980
Maine,2021/1/19,40.4700286,386,5,34262,519,No,Yes,11980
Maine,2021/1/20,40.4700286,701,11,34963,530,No,Yes,11615
Maine,2021/1/21,40.4700286,675,6,35638,536,No,Yes,11615
Maine,2021/1/22,40.4700286,636,4,36274,540,No,Yes,11615
Maine,2021/1/23,40.4700286,324,4,36598,544,No,Yes,11615
Maine,2021/1/24,40.4700286,0,0,36598,544,No,Yes,11615
Maine,2021/1/25,40.4700286,448,3,37046,547,No,Yes,11615
Maine,2021/1/26,40.4700286,662,11,37708,558,No,Yes,11615
Maine,2021/1/27,40.4700286,462,4,38170,562,No,Yes,12664
Maine,2021/1/28,40.4700286,284,5,38454,567,No,Yes,12664
Maine,2021/1/29,40.4700286,359,3,38813,570,No,Yes,12664
Maine,2021/1/30,40.4700286,355,20,39168,590,No,Yes,12664
Maine,2021/1/31,40.4700286,156,0,39324,590,No,Yes,12664
Maine,2021/2/1,40.4700286,219,5,39543,595,No,Yes,12664
Maine,2021/2/2,40.4700286,417,23,39960,618,No,Yes,12664
Maine,2021/2/3,40.4700286,273,9,40233,627,No,Yes,13464
Maine,2021/2/4,40.4700286,301,3,40534,630,No,Yes,13464
Maine,2021/2/5,40.4700286,265,2,40799,632,No,Yes,13464
Maine,2021/2/6,40.4700286,265,2,41064,634,No,Yes,13464
Maine,2021/2/7,40.4700286,154,1,41218,635,No,Yes,13464
Maine,2021/2/8,40.4700286,201,1,41419,636,No,Yes,13464
Maine,2021/2/9,40.4700286,211,3,41630,639,No,Yes,13464
Maine,2021/2/10,40.4700286,253,2,41883,641,No,Yes,12087
Maine,2021/2/11,40.4700286,175,0,42058,641,No,Yes,12087
Maine,2021/2/12,40.4700286,201,2,42259,643,No,Yes,12087
Maine,2021/2/13,40.4700286,160,4,42419,647,No,Yes,12087
Maine,2021/2/14,40.4700286,110,2,42529,649,No,Yes,12087
Maine,2021/2/15,40.4700286,148,0,42677,649,No,Yes,12087
Maine,2021/2/16,40.4700286,91,2,42768,651,No,Yes,12087
Maine,2021/2/17,40.4700286,104,3,42872,654,No,Yes,11395
Maine,2021/2/18,40.4700286,218,1,43090,655,No,Yes,11395
Maine,2021/2/19,40.4700286,134,1,43224,656,No,Yes,11395
Maine,2021/2/20,40.4700286,143,2,43367,658,No,Yes,11395
Maine,2021/2/21,40.4700286,130,0,43497,658,No,Yes,11395
Maine,2021/2/22,40.4700286,97,0,43594,658,No,Yes,11395
Maine,2021/2/23,40.4700286,142,2,43736,660,No,Yes,11395
Maine,2021/2/24,40.4700286,164,17,43900,677,No,Yes,11395
Maine,2021/2/25,40.4700286,217,24,44117,701,No,Yes,11395
Maine,2021/2/26,40.4700286,178,0,44295,701,No,Yes,11395
Maine,2021/2/27,40.4700286,197,1,44492,702,No,Yes,11395
Maine,2021/2/28,40.4700286,142,1,44634,703,No,Yes,11395
Maine,2021/3/1,40.4700286,128,0,44762,703,No,Yes,11395
Maine,2021/3/2,40.4700286,182,0,44944,703,No,Yes,11395
Maine,2021/3/3,40.4700286,147,2,45091,705,No,Yes,11395
Maine,2021/3/4,40.4700286,136,0,45227,705,No,Yes,11395
Maryland,2020/3/1,571.5874066,0,0,0,0,No,No,1575
Maryland,2020/3/2,571.5874066,0,0,0,0,No,No,1575
Maryland,2020/3/3,571.5874066,0,0,0,0,No,No,1575
Maryland,2020/3/4,571.5874066,0,0,0,0,No,No,1663
Maryland,2020/3/5,571.5874066,3,0,3,0,No,No,1663
Maryland,2020/3/6,571.5874066,0,0,3,0,No,No,1663
Maryland,2020/3/7,571.5874066,0,0,3,0,No,No,1663
Maryland,2020/3/8,571.5874066,2,0,5,0,No,No,1663
Maryland,2020/3/9,571.5874066,1,0,6,0,No,No,1663
Maryland,2020/3/10,571.5874066,3,0,9,0,No,No,1663
Maryland,2020/3/11,571.5874066,4,0,13,0,No,No,1819
Maryland,2020/3/12,571.5874066,0,0,13,0,No,No,1819
Maryland,2020/3/13,571.5874066,5,0,18,0,No,No,1819
Maryland,2020/3/14,571.5874066,9,0,27,0,No,No,1819
Maryland,2020/3/15,571.5874066,5,0,32,0,No,No,1819
Maryland,2020/3/16,571.5874066,7,0,39,0,No,No,1819
Maryland,2020/3/17,571.5874066,18,0,57,0,No,No,1819
Maryland,2020/3/18,571.5874066,28,1,85,1,No,No,10892
Maryland,2020/3/19,571.5874066,23,0,108,1,No,No,10892
Maryland,2020/3/20,571.5874066,42,1,150,2,No,No,10892
Maryland,2020/3/21,571.5874066,45,1,195,3,No,No,10892
Maryland,2020/3/22,571.5874066,50,0,245,3,No,No,10892
Maryland,2020/3/23,571.5874066,45,0,290,3,No,No,10892
Maryland,2020/3/24,571.5874066,59,1,349,4,No,No,10892
Maryland,2020/3/25,571.5874066,74,0,423,4,No,No,80984
Maryland,2020/3/26,571.5874066,158,0,581,4,No,No,80984
Maryland,2020/3/27,571.5874066,209,1,790,5,No,No,80984
Maryland,2020/3/28,571.5874066,276,5,1066,10,No,No,80984
Maryland,2020/3/29,571.5874066,178,1,1244,11,No,No,80984
Maryland,2020/3/30,571.5874066,171,4,1415,15,Yes,No,80984
Maryland,2020/3/31,571.5874066,247,3,1662,18,Yes,No,80984
Maryland,2020/4/1,571.5874066,323,15,1985,33,Yes,No,106739
Maryland,2020/4/2,571.5874066,346,3,2331,36,Yes,No,106739
Maryland,2020/4/3,571.5874066,427,6,2758,42,Yes,No,106739
Maryland,2020/4/4,571.5874066,367,12,3125,54,Yes,No,106739
Maryland,2020/4/5,571.5874066,484,14,3609,68,Yes,No,106739
Maryland,2020/4/6,571.5874066,436,24,4045,92,Yes,No,106739
Maryland,2020/4/7,571.5874066,326,12,4371,104,Yes,No,106739
Maryland,2020/4/8,571.5874066,1158,20,5529,124,Yes,No,77515
Maryland,2020/4/9,571.5874066,656,15,6185,139,Yes,No,77515
Maryland,2020/4/10,571.5874066,783,33,6968,172,Yes,No,77515
Maryland,2020/4/11,571.5874066,726,35,7694,207,Yes,No,77515
Maryland,2020/4/12,571.5874066,531,29,8225,236,Yes,No,77515
Maryland,2020/4/13,571.5874066,711,26,8936,262,Yes,No,77515
Maryland,2020/4/14,571.5874066,536,40,9472,302,Yes,No,77515
Maryland,2020/4/15,571.5874066,624,111,10096,413,Yes,No,66432
Maryland,2020/4/16,571.5874066,755,46,10851,459,Yes,No,66432
Maryland,2020/4/17,571.5874066,790,35,11641,494,Yes,No,66432
Maryland,2020/4/18,571.5874066,738,40,12379,534,Yes,No,66432
Maryland,2020/4/19,571.5874066,513,14,12892,548,Yes,No,66432
Maryland,2020/4/20,571.5874066,858,34,13750,582,Yes,No,66432
Maryland,2020/4/21,571.5874066,511,70,14261,652,Yes,No,66432
Maryland,2020/4/22,571.5874066,581,46,14842,698,Yes,No,74966
Maryland,2020/4/23,571.5874066,963,50,15805,748,Yes,No,74966
Maryland,2020/4/24,571.5874066,888,50,16693,798,Yes,No,74966
Maryland,2020/4/25,571.5874066,1151,77,17844,875,Yes,No,74966
Maryland,2020/4/26,571.5874066,820,35,18664,910,Yes,No,74966
Maryland,2020/4/27,571.5874066,910,35,19574,945,Yes,No,74966
Maryland,2020/4/28,571.5874066,626,71,20200,1016,Yes,No,74966
Maryland,2020/4/29,571.5874066,742,62,20942,1078,Yes,No,28985
Maryland,2020/4/30,571.5874066,883,61,21825,1139,Yes,No,28985
Maryland,2020/5/1,571.5874066,1741,53,23566,1192,Yes,No,28985
Maryland,2020/5/2,571.5874066,1002,59,24568,1251,Yes,No,28985
Maryland,2020/5/3,571.5874066,993,30,25561,1281,Yes,No,28985
Maryland,2020/5/4,571.5874066,948,36,26509,1317,Yes,No,28985
Maryland,2020/5/5,571.5874066,708,73,27217,1390,Yes,No,28985
Maryland,2020/5/6,571.5874066,1046,53,28263,1443,Yes,No,26666
Maryland,2020/5/7,571.5874066,1213,60,29476,1503,Yes,No,26666
Maryland,2020/5/8,571.5874066,1116,57,30592,1560,Yes,No,26666
Maryland,2020/5/9,571.5874066,1046,54,31638,1614,Yes,No,26666
Maryland,2020/5/10,571.5874066,1055,30,32693,1644,Yes,No,26666
Maryland,2020/5/11,571.5874066,790,39,33483,1683,Yes,No,26666
Maryland,2020/5/12,571.5874066,691,73,34174,1756,Yes,No,26666
Maryland,2020/5/13,571.5874066,753,53,34927,1809,Yes,No,25150
Maryland,2020/5/14,571.5874066,1094,57,36021,1866,Yes,No,25150
Maryland,2020/5/15,571.5874066,1084,45,37105,1911,Yes,No,25150
Maryland,2020/5/16,571.5874066,978,46,38083,1957,No,No,25150
Maryland,2020/5/17,571.5874066,837,35,38920,1992,No,No,25150
Maryland,2020/5/18,571.5874066,962,31,39882,2023,No,No,25150
Maryland,2020/5/19,571.5874066,1782,58,41664,2081,No,No,25150
Maryland,2020/5/20,571.5874066,778,42,42442,2123,No,No,27919
Maryland,2020/5/21,571.5874066,1203,36,43645,2159,No,No,27919
Maryland,2020/5/22,571.5874066,894,48,44539,2207,No,No,27919
Maryland,2020/5/23,571.5874066,1069,36,45608,2243,No,No,27919
Maryland,2020/5/24,571.5874066,1311,34,46919,2277,No,No,27919
Maryland,2020/5/25,571.5874066,835,25,47754,2302,No,No,27919
Maryland,2020/5/26,571.5874066,536,31,48290,2333,No,No,27919
Maryland,2020/5/27,571.5874066,752,59,49042,2392,No,No,21335
Maryland,2020/5/28,571.5874066,1292,36,50334,2428,No,No,21335
Maryland,2020/5/29,571.5874066,1297,38,51631,2466,No,No,21335
Maryland,2020/5/30,571.5874066,1031,43,52662,2509,No,No,21335
Maryland,2020/5/31,571.5874066,794,23,53456,2532,No,No,21335
Maryland,2020/6/1,571.5874066,579,20,54035,2552,No,No,21335
Maryland,2020/6/2,571.5874066,796,45,54831,2597,No,No,21335
Maryland,2020/6/3,571.5874066,786,44,55617,2641,No,No,19949
Maryland,2020/6/4,571.5874066,873,27,56490,2668,No,No,19949
Maryland,2020/6/5,571.5874066,917,34,57407,2702,No,No,19949
Maryland,2020/6/6,571.5874066,692,38,58099,2740,No,No,19949
Maryland,2020/6/7,571.5874066,494,9,58593,2749,No,No,19949
Maryland,2020/6/8,571.5874066,431,27,59024,2776,No,No,19949
Maryland,2020/6/9,571.5874066,519,35,59543,2811,No,No,19949
Maryland,2020/6/10,571.5874066,571,33,60114,2844,No,No,18367
Maryland,2020/6/11,571.5874066,709,31,60823,2875,No,No,18367
Maryland,2020/6/12,571.5874066,439,25,61262,2900,No,No,18367
Maryland,2020/6/13,571.5874066,673,26,61935,2926,No,No,18367
Maryland,2020/6/14,571.5874066,393,13,62328,2939,No,No,18367
Maryland,2020/6/15,571.5874066,325,8,62653,2947,No,No,18367
Maryland,2020/6/16,571.5874066,351,35,63004,2982,No,No,18367
Maryland,2020/6/17,571.5874066,561,14,63565,2996,No,No,18671
Maryland,2020/6/18,571.5874066,274,20,63839,3016,No,No,18671
Maryland,2020/6/19,571.5874066,311,14,64150,3030,No,No,18671
Maryland,2020/6/20,571.5874066,415,22,64565,3052,No,No,18671
Maryland,2020/6/21,571.5874066,338,14,64903,3066,No,No,18671
Maryland,2020/6/22,571.5874066,299,8,65202,3074,No,No,18671
Maryland,2020/6/23,571.5874066,400,18,65602,3092,No,No,18671
Maryland,2020/6/24,571.5874066,332,16,65934,3108,No,No,18338
Maryland,2020/6/25,571.5874066,463,21,66397,3129,No,No,18338
Maryland,2020/6/26,571.5874066,307,13,66704,3142,No,No,18338
Maryland,2020/6/27,571.5874066,328,15,67032,3157,No,No,18338
Maryland,2020/6/28,571.5874066,328,11,67360,3168,No,No,18338
Maryland,2020/6/29,571.5874066,477,7,67837,3175,No,No,18338
Maryland,2020/6/30,571.5874066,315,15,68152,3190,No,No,18338
Maryland,2020/7/1,571.5874066,350,15,68502,3205,No,No,19056
Maryland,2020/7/2,571.5874066,513,7,69015,3212,No,No,19056
Maryland,2020/7/3,571.5874066,407,11,69422,3223,No,No,19056
Maryland,2020/7/4,571.5874066,302,13,69724,3236,No,No,19056
Maryland,2020/7/5,571.5874066,233,7,69957,3243,No,No,19056
Maryland,2020/7/6,571.5874066,540,3,70497,3246,No,No,19056
Maryland,2020/7/7,571.5874066,489,20,70986,3266,No,No,19056
Maryland,2020/7/8,571.5874066,469,9,71455,3275,No,No,20563
Maryland,2020/7/9,571.5874066,582,13,72037,3288,No,No,20563
Maryland,2020/7/10,571.5874066,466,15,72503,3303,No,No,20563
Maryland,2020/7/11,571.5874066,557,7,73060,3310,No,No,20563
Maryland,2020/7/12,571.5874066,645,9,73705,3319,No,No,20563
Maryland,2020/7/13,571.5874066,419,6,74124,3325,No,No,20563
Maryland,2020/7/14,571.5874066,712,9,74836,3334,No,No,20563
Maryland,2020/7/15,571.5874066,740,7,75576,3341,No,No,23676
Maryland,2020/7/16,571.5874066,661,6,76237,3347,No,No,23676
Maryland,2020/7/17,571.5874066,704,12,76941,3359,No,No,23676
Maryland,2020/7/18,571.5874066,832,9,77773,3368,No,No,23676
Maryland,2020/7/19,571.5874066,925,9,78698,3377,No,No,23676
Maryland,2020/7/20,571.5874066,553,5,79251,3382,No,No,23676
Maryland,2020/7/21,571.5874066,860,20,80111,3402,No,No,23676
Maryland,2020/7/22,571.5874066,627,3,80738,3405,No,No,17437
Maryland,2020/7/23,571.5874066,658,4,81396,3409,No,No,17437
Maryland,2020/7/24,571.5874066,930,13,82326,3422,No,No,17437
Maryland,2020/7/25,571.5874066,1291,11,83617,3433,No,No,17437
Maryland,2020/7/26,571.5874066,689,7,84306,3440,No,No,17437
Maryland,2020/7/27,571.5874066,1130,7,85436,3447,No,No,17437
Maryland,2020/7/28,571.5874066,655,11,86091,3458,No,No,17437
Maryland,2020/7/29,571.5874066,755,20,86846,3478,No,No,11690
Maryland,2020/7/30,571.5874066,894,10,87740,3488,No,No,11690
Maryland,2020/7/31,571.5874066,1167,5,88907,3493,No,No,11690
Maryland,2020/8/1,571.5874066,1018,13,89925,3506,No,No,11690
Maryland,2020/8/2,571.5874066,910,9,90835,3515,No,No,11690
Maryland,2020/8/3,571.5874066,870,8,91705,3523,No,No,11690
Maryland,2020/8/4,571.5874066,711,7,92416,3530,No,No,11690
Maryland,2020/8/5,571.5874066,584,6,93000,3536,No,No,9467
Maryland,2020/8/6,571.5874066,598,15,93598,3551,No,No,9467
Maryland,2020/8/7,571.5874066,797,14,94395,3565,No,No,9467
Maryland,2020/8/8,571.5874066,762,12,95157,3577,No,No,9467
Maryland,2020/8/9,571.5874066,908,8,96065,3585,No,No,9467
Maryland,2020/8/10,571.5874066,756,6,96821,3591,No,No,9467
Maryland,2020/8/11,571.5874066,582,13,97403,3604,No,No,9467
Maryland,2020/8/12,571.5874066,556,8,97959,3612,No,No,11047
Maryland,2020/8/13,571.5874066,769,8,98728,3620,No,No,11047
Maryland,2020/8/14,571.5874066,702,11,99430,3631,No,No,11047
Maryland,2020/8/15,571.5874066,807,5,100237,3636,No,No,11047
Maryland,2020/8/16,571.5874066,535,3,100772,3639,No,No,11047
Maryland,2020/8/17,571.5874066,504,2,101276,3641,No,No,11047
Maryland,2020/8/18,571.5874066,504,9,101780,3650,No,No,11047
Maryland,2020/8/19,571.5874066,435,11,102215,3661,No,No,8676
Maryland,2020/8/20,571.5874066,568,8,102783,3669,No,No,8676
Maryland,2020/8/21,571.5874066,678,5,103461,3674,No,No,8676
Maryland,2020/8/22,571.5874066,579,11,104040,3685,No,No,8676
Maryland,2020/8/23,571.5874066,578,6,104618,3691,No,No,8676
Maryland,2020/8/24,571.5874066,550,3,105168,3694,No,No,8676
Maryland,2020/8/25,571.5874066,386,13,105554,3707,No,No,8676
Maryland,2020/8/26,571.5874066,442,10,105996,3717,No,No,8511
Maryland,2020/8/27,571.5874066,562,5,106558,3722,No,No,8511
Maryland,2020/8/28,571.5874066,588,14,107146,3736,No,No,8511
Maryland,2020/8/29,571.5874066,644,10,107790,3746,No,No,8511
Maryland,2020/8/30,571.5874066,496,6,108286,3752,No,No,8511
Maryland,2020/8/31,571.5874066,456,3,108742,3755,No,No,8511
Maryland,2020/9/1,571.5874066,611,6,109353,3761,No,No,8511
Maryland,2020/9/2,571.5874066,455,5,109808,3766,No,No,8901
Maryland,2020/9/3,571.5874066,696,12,110504,3778,No,No,8901
Maryland,2020/9/4,571.5874066,828,11,111332,3789,No,No,8901
Maryland,2020/9/5,571.5874066,772,7,112104,3796,No,No,8901
Maryland,2020/9/6,571.5874066,453,3,112557,3799,No,No,8901
Maryland,2020/9/7,571.5874066,821,5,113378,3804,No,No,8901
Maryland,2020/9/8,571.5874066,356,3,113734,3807,No,No,8901
Maryland,2020/9/9,571.5874066,336,9,114070,3816,No,No,8848
Maryland,2020/9/10,571.5874066,504,8,114574,3824,No,No,8848
Maryland,2020/9/11,571.5874066,643,4,115217,3828,No,No,8848
Maryland,2020/9/12,571.5874066,659,8,115876,3836,No,No,8848
Maryland,2020/9/13,571.5874066,724,2,116600,3838,No,No,8848
Maryland,2020/9/14,571.5874066,547,1,117147,3839,No,No,8848
Maryland,2020/9/15,571.5874066,598,10,117745,3849,No,No,8848
Maryland,2020/9/16,571.5874066,642,6,118387,3855,No,No,8679
Maryland,2020/9/17,571.5874066,630,6,119017,3861,No,No,8679
Maryland,2020/9/18,571.5874066,542,8,119559,3869,No,No,8679
Maryland,2020/9/19,571.5874066,548,7,120107,3876,No,No,8679
Maryland,2020/9/20,571.5874066,549,3,120656,3879,No,No,8679
Maryland,2020/9/21,571.5874066,412,4,121068,3883,No,No,8679
Maryland,2020/9/22,571.5874066,341,12,121409,3895,No,No,8679
Maryland,2020/9/23,571.5874066,384,7,121793,3902,No,No,8805
Maryland,2020/9/24,571.5874066,500,7,122293,3909,No,No,8805
Maryland,2020/9/25,571.5874066,557,8,122850,3917,No,No,8805
Maryland,2020/9/26,571.5874066,478,8,123328,3925,No,No,8805
Maryland,2020/9/27,571.5874066,567,10,123895,3935,No,No,8805
Maryland,2020/9/28,571.5874066,476,3,124371,3938,No,No,8805
Maryland,2020/9/29,571.5874066,434,8,124805,3946,No,No,8805
Maryland,2020/9/30,571.5874066,412,3,125217,3949,No,No,7732
Maryland,2020/10/1,571.5874066,780,0,125997,3949,No,No,7732
Maryland,2020/10/2,571.5874066,714,1,126711,3950,No,No,7732
Maryland,2020/10/3,571.5874066,483,7,127194,3957,No,No,7732
Maryland,2020/10/4,571.5874066,591,1,127785,3958,No,No,7732
Maryland,2020/10/5,571.5874066,492,3,128277,3961,No,No,7732
Maryland,2020/10/6,571.5874066,414,6,128691,3967,No,No,7732
Maryland,2020/10/7,571.5874066,467,6,129158,3973,No,No,8581
Maryland,2020/10/8,571.5874066,761,6,129919,3979,No,No,8581
Maryland,2020/10/9,571.5874066,733,11,130652,3990,No,No,8581
Maryland,2020/10/10,571.5874066,517,5,131169,3995,No,No,8581
Maryland,2020/10/11,571.5874066,684,4,131853,3999,No,No,8581
Maryland,2020/10/12,571.5874066,504,4,132357,4003,No,No,8581
Maryland,2020/10/13,571.5874066,482,9,132839,4012,No,No,8581
Maryland,2020/10/14,571.5874066,574,10,133413,4022,No,No,7964
Maryland,2020/10/15,571.5874066,629,6,134042,4028,No,No,7964
Maryland,2020/10/16,571.5874066,780,4,134822,4032,No,No,7964
Maryland,2020/10/17,571.5874066,641,4,135463,4036,No,No,7964
Maryland,2020/10/18,571.5874066,686,1,136149,4037,No,No,7964
Maryland,2020/10/19,571.5874066,494,4,136643,4041,No,No,7964
Maryland,2020/10/20,571.5874066,586,9,137229,4050,No,No,7964
Maryland,2020/10/21,571.5874066,491,8,137720,4058,No,No,7126
Maryland,2020/10/22,571.5874066,753,12,138473,4070,No,No,7126
Maryland,2020/10/23,571.5874066,712,8,139185,4078,No,No,7126
Maryland,2020/10/24,571.5874066,674,13,139859,4091,No,No,7126
Maryland,2020/10/25,571.5874066,911,5,140770,4096,No,No,7126
Maryland,2020/10/26,571.5874066,564,3,141334,4099,No,No,7126
Maryland,2020/10/27,571.5874066,903,9,142237,4108,No,No,7126
Maryland,2020/10/28,571.5874066,681,7,142918,4115,No,No,7060
Maryland,2020/10/29,571.5874066,957,12,143875,4127,No,No,7060
Maryland,2020/10/30,571.5874066,925,10,144800,4137,No,No,7060
Maryland,2020/10/31,571.5874066,793,10,145593,4147,No,No,7060
Maryland,2020/11/1,571.5874066,1034,5,146627,4152,No,No,7060
Maryland,2020/11/2,571.5874066,850,3,147477,4155,No,No,7060
Maryland,2020/11/3,571.5874066,772,7,148249,4162,No,No,7060
Maryland,2020/11/4,571.5874066,983,10,149232,4172,No,No,8764
Maryland,2020/11/5,571.5874066,1192,10,150424,4182,No,No,8764
Maryland,2020/11/6,571.5874066,1540,12,151964,4194,No,No,8764
Maryland,2020/11/7,571.5874066,1234,7,153198,4201,No,No,8764
Maryland,2020/11/8,571.5874066,1253,11,154451,4212,No,No,8764
Maryland,2020/11/9,571.5874066,1373,9,155824,4221,No,No,8764
Maryland,2020/11/10,571.5874066,1325,12,157149,4233,No,No,8764
Maryland,2020/11/11,571.5874066,1687,16,158836,4249,No,No,9262
Maryland,2020/11/12,571.5874066,1475,12,160311,4261,No,No,9262
Maryland,2020/11/13,571.5874066,1870,12,162181,4273,No,No,9262
Maryland,2020/11/14,571.5874066,2058,20,164239,4293,No,No,9262
Maryland,2020/11/15,571.5874066,2078,9,166317,4302,No,No,9262
Maryland,2020/11/16,571.5874066,1724,7,168041,4309,No,No,9262
Maryland,2020/11/17,571.5874066,2152,26,170193,4335,No,No,9262
Maryland,2020/11/18,571.5874066,2011,16,172204,4351,No,No,11813
Maryland,2020/11/19,571.5874066,2888,21,175092,4372,No,No,11813
Maryland,2020/11/20,571.5874066,2147,26,177239,4398,No,No,11813
Maryland,2020/11/21,571.5874066,2886,17,180125,4415,No,No,11813
Maryland,2020/11/22,571.5874066,2357,19,182482,4434,No,No,11813
Maryland,2020/11/23,571.5874066,1658,14,184140,4448,No,No,11813
Maryland,2020/11/24,571.5874066,1672,33,185812,4481,No,No,11813
Maryland,2020/11/25,571.5874066,2697,37,188509,4518,No,No,7061
Maryland,2020/11/26,571.5874066,2126,29,190635,4547,No,No,7061
Maryland,2020/11/27,571.5874066,2570,22,193205,4569,No,No,7061
Maryland,2020/11/28,571.5874066,1398,33,194603,4602,No,No,7061
Maryland,2020/11/29,571.5874066,2124,23,196727,4625,No,No,7061
Maryland,2020/11/30,571.5874066,1983,16,198710,4641,No,No,7061
Maryland,2020/12/1,571.5874066,2769,32,201479,4673,No,No,7061
Maryland,2020/12/2,571.5874066,2193,42,203672,4715,No,No,7656
Maryland,2020/12/3,571.5874066,2044,49,205716,4764,No,No,7656
Maryland,2020/12/4,571.5874066,3796,26,209512,4790,No,No,7656
Maryland,2020/12/5,571.5874066,3033,30,212545,4820,No,No,7656
Maryland,2020/12/6,571.5874066,2803,26,215348,4846,No,No,7656
Maryland,2020/12/7,571.5874066,2299,19,217647,4865,No,No,7656
Maryland,2020/12/8,571.5874066,2632,51,220279,4916,No,No,7656
Maryland,2020/12/9,571.5874066,2692,46,222971,4962,No,No,7568
Maryland,2020/12/10,571.5874066,3202,50,226173,5012,No,No,7568
Maryland,2020/12/11,571.5874066,2619,52,228792,5064,No,No,7568
Maryland,2020/12/12,571.5874066,3380,36,232172,5100,No,No,7568
Maryland,2020/12/13,571.5874066,2803,17,234975,5117,No,No,7568
Maryland,2020/12/14,571.5874066,2240,25,237215,5142,No,No,7568
Maryland,2020/12/15,571.5874066,2479,64,239694,5206,No,No,7568
Maryland,2020/12/16,571.5874066,2363,64,242057,5270,No,No,7543
Maryland,2020/12/17,571.5874066,2190,49,244247,5319,No,No,7543
Maryland,2020/12/18,571.5874066,2569,39,246816,5358,No,No,7543
Maryland,2020/12/19,571.5874066,2108,54,248924,5412,No,No,7543
Maryland,2020/12/20,571.5874066,2145,36,251069,5448,No,No,7543
Maryland,2020/12/21,571.5874066,2276,23,253345,5471,No,No,7543
Maryland,2020/12/22,571.5874066,2321,48,255666,5519,No,No,7543
Maryland,2020/12/23,571.5874066,2463,49,258129,5568,No,No,5506
Maryland,2020/12/24,571.5874066,2865,59,260994,5627,No,No,5506
Maryland,2020/12/25,571.5874066,2332,32,263326,5659,No,No,5506
Maryland,2020/12/26,571.5874066,2280,21,265606,5680,No,No,5506
Maryland,2020/12/27,571.5874066,1849,32,267455,5712,No,No,5506
Maryland,2020/12/28,571.5874066,1987,28,269442,5740,No,No,5506
Maryland,2020/12/29,571.5874066,1825,63,271267,5803,No,No,5506
Maryland,2020/12/30,571.5874066,2614,45,273881,5848,No,No,10986
Maryland,2020/12/31,571.5874066,2953,47,276834,5895,No,No,10986
Maryland,2021/1/1,571.5874066,3553,47,280387,5942,No,No,10986
Maryland,2021/1/2,571.5874066,2952,25,283339,5967,No,No,10986
Maryland,2021/1/3,571.5874066,2148,27,285487,5994,No,No,10986
Maryland,2021/1/4,571.5874066,2483,33,287970,6027,No,No,10986
Maryland,2021/1/5,571.5874066,1957,55,289927,6082,No,No,10986
Maryland,2021/1/6,571.5874066,3152,50,293079,6132,No,No,14084
Maryland,2021/1/7,571.5874066,2970,41,296049,6173,No,No,14084
Maryland,2021/1/8,571.5874066,3732,43,299781,6216,No,No,14084
Maryland,2021/1/9,571.5874066,3754,30,303535,6246,No,No,14084
Maryland,2021/1/10,571.5874066,3318,26,306853,6272,No,No,14084
Maryland,2021/1/11,571.5874066,3021,29,309874,6301,No,No,14084
Maryland,2021/1/12,571.5874066,2660,66,312534,6367,No,No,14084
Maryland,2021/1/13,571.5874066,2521,37,315055,6404,No,No,11980
Maryland,2021/1/14,571.5874066,2947,45,318002,6449,No,No,11980
Maryland,2021/1/15,571.5874066,2921,45,320923,6494,No,No,11980
Maryland,2021/1/16,571.5874066,3280,47,324203,6541,No,No,11980
Maryland,2021/1/17,571.5874066,2445,26,326648,6567,No,No,11980
Maryland,2021/1/18,571.5874066,1769,29,328417,6596,No,No,11980
Maryland,2021/1/19,571.5874066,1973,54,330390,6650,No,No,11980
Maryland,2021/1/20,571.5874066,2168,39,332558,6689,No,No,11615
Maryland,2021/1/21,571.5874066,2167,46,334725,6735,No,No,11615
Maryland,2021/1/22,571.5874066,2404,57,337129,6792,No,No,11615
Maryland,2021/1/23,571.5874066,2353,45,339482,6837,No,No,11615
Maryland,2021/1/24,571.5874066,2184,28,341666,6865,No,No,11615
Maryland,2021/1/25,571.5874066,1687,35,343353,6900,No,No,11615
Maryland,2021/1/26,571.5874066,1486,63,344839,6963,No,No,11615
Maryland,2021/1/27,571.5874066,1895,33,346734,6996,No,No,12664
Maryland,2021/1/28,571.5874066,2191,41,348925,7037,No,No,12664
Maryland,2021/1/29,571.5874066,1880,39,350805,7076,No,No,12664
Maryland,2021/1/30,571.5874066,2097,31,352902,7107,No,No,12664
Maryland,2021/1/31,571.5874066,1747,20,354649,7127,No,No,12664
Maryland,2021/2/1,571.5874066,1163,27,355812,7154,No,No,12664
Maryland,2021/2/2,571.5874066,905,34,356717,7188,No,No,12664
Maryland,2021/2/3,571.5874066,943,32,357660,7220,No,No,13464
Maryland,2021/2/4,571.5874066,1554,31,359214,7251,No,No,13464
Maryland,2021/2/5,571.5874066,1548,36,360762,7287,No,No,13464
Maryland,2021/2/6,571.5874066,1501,42,362263,7329,No,No,13464
Maryland,2021/2/7,571.5874066,1566,20,363829,7349,No,No,13464
Maryland,2021/2/8,571.5874066,903,23,364732,7372,No,No,13464
Maryland,2021/2/9,571.5874066,976,41,365708,7413,No,No,13464
Maryland,2021/2/10,571.5874066,1137,33,366845,7446,No,No,12087
Maryland,2021/2/11,571.5874066,1199,21,368044,7467,No,No,12087
Maryland,2021/2/12,571.5874066,1112,36,369156,7503,No,No,12087
Maryland,2021/2/13,571.5874066,1160,33,370316,7536,No,No,12087
Maryland,2021/2/14,571.5874066,847,18,371163,7554,No,No,12087
Maryland,2021/2/15,571.5874066,722,26,371885,7580,No,No,12087
Maryland,2021/2/16,571.5874066,518,32,372403,7612,No,No,12087
Maryland,2021/2/17,571.5874066,758,18,373161,7630,No,No,11395
Maryland,2021/2/18,571.5874066,987,31,374148,7661,No,No,11395
Maryland,2021/2/19,571.5874066,1008,16,375156,7677,No,No,11395
Maryland,2021/2/20,571.5874066,763,20,375919,7697,No,No,11395
Maryland,2021/2/21,571.5874066,618,18,376537,7715,No,No,11395
Maryland,2021/2/22,571.5874066,611,17,377148,7732,No,No,11395
Maryland,2021/2/23,571.5874066,662,30,377810,7762,No,No,11395
Maryland,2021/2/24,571.5874066,862,27,378672,7789,No,No,11395
Maryland,2021/2/25,571.5874066,976,16,379648,7805,No,No,11395
Maryland,2021/2/26,571.5874066,970,33,380618,7838,No,No,11395
Maryland,2021/2/27,571.5874066,836,18,381454,7856,No,No,11395
Maryland,2021/2/28,571.5874066,827,13,382281,7869,No,No,11395
Maryland,2021/3/1,571.5874066,603,10,382884,7879,No,No,11395
Maryland,2021/3/2,571.5874066,468,26,383352,7905,No,No,11395
Maryland,2021/3/3,571.5874066,786,14,384138,7919,No,No,11395
Maryland,2021/3/4,571.5874066,809,3,384947,7922,No,No,11395
Massachusetts,2020/3/1,834.7466392,1,0,1,0,No,No,1575
Massachusetts,2020/3/2,834.7466392,1,0,2,0,No,No,1575
Massachusetts,2020/3/3,834.7466392,0,0,2,0,No,No,1575
Massachusetts,2020/3/4,834.7466392,0,0,2,0,No,No,1663
Massachusetts,2020/3/5,834.7466392,1,0,3,0,No,No,1663
Massachusetts,2020/3/6,834.7466392,5,0,8,0,No,No,1663
Massachusetts,2020/3/7,834.7466392,5,0,13,0,No,No,1663
Massachusetts,2020/3/8,834.7466392,15,0,28,0,No,No,1663
Massachusetts,2020/3/9,834.7466392,13,0,41,0,No,No,1663
Massachusetts,2020/3/10,834.7466392,51,0,92,0,No,No,1663
Massachusetts,2020/3/11,834.7466392,3,0,95,0,No,No,1819
Massachusetts,2020/3/12,834.7466392,13,0,108,0,No,No,1819
Massachusetts,2020/3/13,834.7466392,15,0,123,0,No,No,1819
Massachusetts,2020/3/14,834.7466392,15,0,138,0,No,No,1819
Massachusetts,2020/3/15,834.7466392,26,0,164,0,No,No,1819
Massachusetts,2020/3/16,834.7466392,33,0,197,0,No,No,1819
Massachusetts,2020/3/17,834.7466392,21,0,218,0,No,No,1819
Massachusetts,2020/3/18,834.7466392,38,0,256,0,No,No,10892
Massachusetts,2020/3/19,834.7466392,72,0,328,0,No,No,10892
Massachusetts,2020/3/20,834.7466392,85,1,413,1,No,No,10892
Massachusetts,2020/3/21,834.7466392,112,1,525,2,No,No,10892
Massachusetts,2020/3/22,834.7466392,121,3,646,5,No,No,10892
Massachusetts,2020/3/23,834.7466392,131,4,777,9,No,No,10892
Massachusetts,2020/3/24,834.7466392,382,2,1159,11,Yes,No,10892
Massachusetts,2020/3/25,834.7466392,679,4,1838,15,Yes,No,80984
Massachusetts,2020/3/26,834.7466392,579,10,2417,25,Yes,No,80984
Massachusetts,2020/3/27,834.7466392,823,10,3240,35,Yes,No,80984
Massachusetts,2020/3/28,834.7466392,1017,9,4257,44,Yes,No,80984
Massachusetts,2020/3/29,834.7466392,698,4,4955,48,Yes,No,80984
Massachusetts,2020/3/30,834.7466392,797,8,5752,56,Yes,No,80984
Massachusetts,2020/3/31,834.7466392,868,33,6620,89,Yes,No,80984
Massachusetts,2020/4/1,834.7466392,1118,33,7738,122,Yes,No,106739
Massachusetts,2020/4/2,834.7466392,1228,32,8966,154,Yes,No,106739
Massachusetts,2020/4/3,834.7466392,1436,38,10402,192,Yes,No,106739
Massachusetts,2020/4/4,834.7466392,1334,24,11736,216,Yes,No,106739
Massachusetts,2020/4/5,834.7466392,764,15,12500,231,Yes,No,106739
Massachusetts,2020/4/6,834.7466392,1337,29,13837,260,Yes,No,106739
Massachusetts,2020/4/7,834.7466392,1365,96,15202,356,Yes,No,106739
Massachusetts,2020/4/8,834.7466392,1588,77,16790,433,Yes,No,77515
Massachusetts,2020/4/9,834.7466392,2151,70,18941,503,Yes,No,77515
Massachusetts,2020/4/10,834.7466392,2033,96,20974,599,Yes,No,77515
Massachusetts,2020/4/11,834.7466392,1886,87,22860,686,Yes,No,77515
Massachusetts,2020/4/12,834.7466392,2615,70,25475,756,Yes,No,77515
Massachusetts,2020/4/13,834.7466392,1392,88,26867,844,Yes,No,77515
Massachusetts,2020/4/14,834.7466392,1296,113,28163,957,Yes,No,77515
Massachusetts,2020/4/15,834.7466392,1755,151,29918,1108,Yes,No,66432
Massachusetts,2020/4/16,834.7466392,2263,137,32181,1245,Yes,No,66432
Massachusetts,2020/4/17,834.7466392,2221,159,34402,1404,Yes,No,66432
Massachusetts,2020/4/18,834.7466392,1970,156,36372,1560,Yes,No,66432
Massachusetts,2020/4/19,834.7466392,1705,146,38077,1706,Yes,No,66432
Massachusetts,2020/4/20,834.7466392,1566,103,39643,1809,Yes,No,66432
Massachusetts,2020/4/21,834.7466392,1556,152,41199,1961,Yes,No,66432
Massachusetts,2020/4/22,834.7466392,1745,221,42944,2182,Yes,No,74966
Massachusetts,2020/4/23,834.7466392,3079,178,46023,2360,Yes,No,74966
Massachusetts,2020/4/24,834.7466392,4946,196,50969,2556,Yes,No,74966
Massachusetts,2020/4/25,834.7466392,2379,174,53348,2730,Yes,No,74966
Massachusetts,2020/4/26,834.7466392,1590,169,54938,2899,Yes,No,74966
Massachusetts,2020/4/27,834.7466392,1524,104,56462,3003,Yes,No,74966
Massachusetts,2020/4/28,834.7466392,1840,150,58302,3153,Yes,No,74966
Massachusetts,2020/4/29,834.7466392,1963,252,60265,3405,Yes,No,28985
Massachusetts,2020/4/30,834.7466392,1940,157,62205,3562,Yes,No,28985
Massachusetts,2020/5/1,834.7466392,2106,154,64311,3716,Yes,No,28985
Massachusetts,2020/5/2,834.7466392,1952,130,66263,3846,Yes,No,28985
Massachusetts,2020/5/3,834.7466392,1824,158,68087,4004,Yes,No,28985
Massachusetts,2020/5/4,834.7466392,1000,86,69087,4090,Yes,No,28985
Massachusetts,2020/5/5,834.7466392,1184,122,70271,4212,Yes,No,28985
Massachusetts,2020/5/6,834.7466392,1754,208,72025,4420,Yes,Yes,26666
Massachusetts,2020/5/7,834.7466392,1696,132,73721,4552,Yes,Yes,26666
Massachusetts,2020/5/8,834.7466392,1612,150,75333,4702,Yes,Yes,26666
Massachusetts,2020/5/9,834.7466392,1410,138,76743,4840,Yes,Yes,26666
Massachusetts,2020/5/10,834.7466392,1050,139,77793,4979,Yes,Yes,26666
Massachusetts,2020/5/11,834.7466392,669,129,78462,5108,Yes,Yes,26666
Massachusetts,2020/5/12,834.7466392,870,33,79332,5141,Yes,Yes,26666
Massachusetts,2020/5/13,834.7466392,1165,174,80497,5315,Yes,Yes,25150
Massachusetts,2020/5/14,834.7466392,1685,167,82182,5482,Yes,Yes,25150
Massachusetts,2020/5/15,834.7466392,1239,110,83421,5592,Yes,Yes,25150
Massachusetts,2020/5/16,834.7466392,1512,113,84933,5705,Yes,Yes,25150
Massachusetts,2020/5/17,834.7466392,1077,92,86010,5797,Yes,Yes,25150
Massachusetts,2020/5/18,834.7466392,1042,65,87052,5862,Yes,Yes,25150
Massachusetts,2020/5/19,834.7466392,873,76,87925,5938,No,Yes,25150
Massachusetts,2020/5/20,834.7466392,1045,128,88970,6066,No,Yes,27919
Massachusetts,2020/5/21,834.7466392,1114,82,90084,6148,No,Yes,27919
Massachusetts,2020/5/22,834.7466392,805,80,90889,6228,No,Yes,27919
Massachusetts,2020/5/23,834.7466392,773,76,91662,6304,No,Yes,27919
Massachusetts,2020/5/24,834.7466392,1013,68,92675,6372,No,Yes,27919
Massachusetts,2020/5/25,834.7466392,596,44,93271,6416,No,Yes,27919
Massachusetts,2020/5/26,834.7466392,422,57,93693,6473,No,Yes,27919
Massachusetts,2020/5/27,834.7466392,527,74,94220,6547,No,Yes,21335
Massachusetts,2020/5/28,834.7466392,675,93,94895,6640,No,Yes,21335
Massachusetts,2020/5/29,834.7466392,617,78,95512,6718,No,Yes,21335
Massachusetts,2020/5/30,834.7466392,789,50,96301,6768,No,Yes,21335
Massachusetts,2020/5/31,834.7466392,664,78,96965,6846,No,Yes,21335
Massachusetts,2020/6/1,834.7466392,3840,189,100805,7035,No,Yes,21335
Massachusetts,2020/6/2,834.7466392,358,50,101163,7085,No,Yes,21335
Massachusetts,2020/6/3,834.7466392,429,67,101592,7152,No,Yes,19949
Massachusetts,2020/6/4,834.7466392,471,49,102063,7201,No,Yes,19949
Massachusetts,2020/6/5,834.7466392,494,34,102557,7235,No,Yes,19949
Massachusetts,2020/6/6,834.7466392,575,54,103132,7289,No,Yes,19949
Massachusetts,2020/6/7,834.7466392,304,27,103436,7316,No,Yes,19949
Massachusetts,2020/6/8,834.7466392,190,37,103626,7353,No,Yes,19949
Massachusetts,2020/6/9,834.7466392,263,55,103889,7408,No,Yes,19949
Massachusetts,2020/6/10,834.7466392,267,46,104156,7454,No,Yes,18367
Massachusetts,2020/6/11,834.7466392,511,38,104667,7492,No,Yes,18367
Massachusetts,2020/6/12,834.7466392,392,46,105059,7538,No,Yes,18367
Massachusetts,2020/6/13,834.7466392,336,38,105395,7576,No,Yes,18367
Massachusetts,2020/6/14,834.7466392,208,48,105603,7624,No,Yes,18367
Massachusetts,2020/6/15,834.7466392,87,22,105690,7646,No,Yes,18367
Massachusetts,2020/6/16,834.7466392,195,18,105885,7664,No,Yes,18367
Massachusetts,2020/6/17,834.7466392,266,69,106151,7733,No,Yes,18671
Massachusetts,2020/6/18,834.7466392,271,36,106422,7769,No,Yes,18671
Massachusetts,2020/6/19,834.7466392,228,30,106650,7799,No,Yes,18671
Massachusetts,2020/6/20,834.7466392,286,28,106936,7827,No,Yes,18671
Massachusetts,2020/6/21,834.7466392,125,30,107061,7857,No,Yes,18671
Massachusetts,2020/6/22,834.7466392,149,16,107210,7873,No,Yes,18671
Massachusetts,2020/6/23,834.7466392,229,16,107439,7889,No,Yes,18671
Massachusetts,2020/6/24,834.7466392,172,48,107611,7937,No,Yes,18338
Massachusetts,2020/6/25,834.7466392,226,25,107837,7962,No,Yes,18338
Massachusetts,2020/6/26,834.7466392,233,50,108070,8012,No,Yes,18338
Massachusetts,2020/6/27,834.7466392,373,28,108443,8040,No,Yes,18338
Massachusetts,2020/6/28,834.7466392,224,20,108667,8060,No,Yes,18338
Massachusetts,2020/6/29,834.7466392,101,35,108768,8095,No,Yes,18338
Massachusetts,2020/6/30,834.7466392,114,-41,108882,8054,No,Yes,18338
Massachusetts,2020/7/1,834.7466392,261,27,109143,8081,No,Yes,19056
Massachusetts,2020/7/2,834.7466392,195,51,109338,8132,No,Yes,19056
Massachusetts,2020/7/3,834.7466392,290,17,109628,8149,No,Yes,19056
Massachusetts,2020/7/4,834.7466392,210,23,109838,8172,No,Yes,19056
Massachusetts,2020/7/5,834.7466392,136,11,109974,8183,No,Yes,19056
Massachusetts,2020/7/6,834.7466392,163,15,110137,8198,No,Yes,19056
Massachusetts,2020/7/7,834.7466392,201,15,110338,8213,No,Yes,19056
Massachusetts,2020/7/8,834.7466392,264,30,110602,8243,No,Yes,20563
Massachusetts,2020/7/9,834.7466392,295,25,110897,8268,No,Yes,20563
Massachusetts,2020/7/10,834.7466392,213,28,111110,8296,No,Yes,20563
Massachusetts,2020/7/11,834.7466392,288,14,111398,8310,No,Yes,20563
Massachusetts,2020/7/12,834.7466392,199,15,111597,8325,No,Yes,20563
Massachusetts,2020/7/13,834.7466392,230,5,111827,8330,No,Yes,20563
Massachusetts,2020/7/14,834.7466392,303,10,112130,8340,No,Yes,20563
Massachusetts,2020/7/15,834.7466392,217,28,112347,8368,No,Yes,23676
Massachusetts,2020/7/16,834.7466392,234,12,112581,8380,No,Yes,23676
Massachusetts,2020/7/17,834.7466392,298,22,112879,8402,No,Yes,23676
Massachusetts,2020/7/18,834.7466392,359,17,113238,8419,No,Yes,23676
Massachusetts,2020/7/19,834.7466392,296,12,113534,8431,No,Yes,23676
Massachusetts,2020/7/20,834.7466392,255,2,113789,8433,No,Yes,23676
Massachusetts,2020/7/21,834.7466392,244,17,114033,8450,No,Yes,23676
Massachusetts,2020/7/22,834.7466392,287,18,114320,8468,No,Yes,17437
Massachusetts,2020/7/23,834.7466392,327,16,114647,8484,No,Yes,17437
Massachusetts,2020/7/24,834.7466392,338,14,114985,8498,No,Yes,17437
Massachusetts,2020/7/25,834.7466392,283,12,115268,8510,No,Yes,17437
Massachusetts,2020/7/26,834.7466392,369,19,115637,8529,No,Yes,17437
Massachusetts,2020/7/27,834.7466392,289,7,115926,8536,No,Yes,17437
Massachusetts,2020/7/28,834.7466392,256,15,116182,8551,No,Yes,17437
Massachusetts,2020/7/29,834.7466392,502,29,116684,8580,No,Yes,11690
Massachusetts,2020/7/30,834.7466392,414,15,117098,8595,No,Yes,11690
Massachusetts,2020/7/31,834.7466392,514,14,117612,8609,No,Yes,11690
Massachusetts,2020/8/1,834.7466392,428,17,118040,8626,No,Yes,11690
Massachusetts,2020/8/2,834.7466392,418,12,118458,8638,No,Yes,11690
Massachusetts,2020/8/3,834.7466392,199,10,118657,8648,No,Yes,11690
Massachusetts,2020/8/4,834.7466392,546,9,119203,8657,No,Yes,11690
Massachusetts,2020/8/5,834.7466392,440,2,119643,8659,No,Yes,9467
Massachusetts,2020/8/6,834.7466392,231,32,119874,8691,No,Yes,9467
Massachusetts,2020/8/7,834.7466392,417,18,120291,8709,No,Yes,9467
Massachusetts,2020/8/8,834.7466392,420,12,120711,8721,No,Yes,9467
Massachusetts,2020/8/9,834.7466392,329,14,121040,8735,No,Yes,9467
Massachusetts,2020/8/10,834.7466392,275,6,121315,8741,No,Yes,9467
Massachusetts,2020/8/11,834.7466392,392,10,121707,8751,No,Yes,9467
Massachusetts,2020/8/12,834.7466392,293,18,122000,8769,No,Yes,11047
Massachusetts,2020/8/13,834.7466392,423,21,122423,8790,No,Yes,11047
Massachusetts,2020/8/14,834.7466392,305,20,122728,8810,No,Yes,11047
Massachusetts,2020/8/15,834.7466392,471,16,123199,8826,No,Yes,11047
Massachusetts,2020/8/16,834.7466392,394,12,123593,8838,No,Yes,11047
Massachusetts,2020/8/17,834.7466392,248,4,123841,8842,No,Yes,11047
Massachusetts,2020/8/18,834.7466392,222,6,124063,8848,No,Yes,11047
Massachusetts,2020/8/19,834.7466392,352,28,124415,8876,No,Yes,8676
Massachusetts,2020/8/20,834.7466392,313,12,124728,8888,No,Yes,8676
Massachusetts,2020/8/21,834.7466392,488,13,125216,8901,No,Yes,8676
Massachusetts,2020/8/22,834.7466392,144,20,125360,8921,No,Yes,8676
Massachusetts,2020/8/23,834.7466392,0,0,125360,8921,No,Yes,8676
Massachusetts,2020/8/24,834.7466392,662,28,126022,8949,No,Yes,8676
Massachusetts,2020/8/25,834.7466392,398,12,126420,8961,No,Yes,8676
Massachusetts,2020/8/26,834.7466392,336,26,126756,8987,No,Yes,8511
Massachusetts,2020/8/27,834.7466392,368,21,127124,9008,No,Yes,8511
Massachusetts,2020/8/28,834.7466392,460,16,127584,9024,No,Yes,8511
Massachusetts,2020/8/29,834.7466392,446,12,128030,9036,No,Yes,8511
Massachusetts,2020/8/30,834.7466392,199,13,128229,9049,No,Yes,8511
Massachusetts,2020/8/31,834.7466392,304,11,128533,9060,No,Yes,8511
Massachusetts,2020/9/1,834.7466392,355,4,128888,9064,No,Yes,8511
Massachusetts,2020/9/2,834.7466392,-7757,-4,121131,9060,No,Yes,8901
Massachusetts,2020/9/3,834.7466392,415,17,121546,9077,No,Yes,8901
Massachusetts,2020/9/4,834.7466392,212,23,121758,9100,No,Yes,8901
Massachusetts,2020/9/5,834.7466392,438,16,122196,9116,No,Yes,8901
Massachusetts,2020/9/6,834.7466392,366,9,122562,9125,No,Yes,8901
Massachusetts,2020/9/7,834.7466392,229,8,122791,9133,No,Yes,8901
Massachusetts,2020/9/8,834.7466392,171,8,122962,9141,No,Yes,8901
Massachusetts,2020/9/9,834.7466392,181,5,123143,9146,No,Yes,8848
Massachusetts,2020/9/10,834.7466392,403,20,123546,9166,No,Yes,8848
Massachusetts,2020/9/11,834.7466392,440,14,123986,9180,No,Yes,8848
Massachusetts,2020/9/12,834.7466392,554,16,124540,9196,No,Yes,8848
Massachusetts,2020/9/13,834.7466392,286,14,124826,9210,No,Yes,8848
Massachusetts,2020/9/14,834.7466392,254,9,125080,9219,No,Yes,8848
Massachusetts,2020/9/15,834.7466392,313,6,125393,9225,No,Yes,8848
Massachusetts,2020/9/16,834.7466392,306,20,125699,9245,No,Yes,8679
Massachusetts,2020/9/17,834.7466392,429,15,126128,9260,No,Yes,8679
Massachusetts,2020/9/18,834.7466392,454,9,126582,9269,No,Yes,8679
Massachusetts,2020/9/19,834.7466392,599,26,127181,9295,No,Yes,8679
Massachusetts,2020/9/20,834.7466392,359,15,127540,9310,No,Yes,8679
Massachusetts,2020/9/21,834.7466392,256,7,127796,9317,No,Yes,8679
Massachusetts,2020/9/22,834.7466392,173,11,127969,9328,No,Yes,8679
Massachusetts,2020/9/23,834.7466392,543,19,128512,9347,No,Yes,8805
Massachusetts,2020/9/24,834.7466392,481,15,128993,9362,No,Yes,8805
Massachusetts,2020/9/25,834.7466392,488,11,129481,9373,No,Yes,8805
Massachusetts,2020/9/26,834.7466392,569,18,130050,9391,No,Yes,8805
Massachusetts,2020/9/27,834.7466392,592,13,130642,9404,No,Yes,8805
Massachusetts,2020/9/28,834.7466392,430,11,131072,9415,No,Yes,8805
Massachusetts,2020/9/29,834.7466392,512,8,131584,9423,No,Yes,8805
Massachusetts,2020/9/30,834.7466392,532,33,132116,9456,No,Yes,7732
Massachusetts,2020/10/1,834.7466392,754,24,132870,9480,No,Yes,7732
Massachusetts,2020/10/2,834.7466392,761,10,133631,9490,No,Yes,7732
Massachusetts,2020/10/3,834.7466392,672,17,134303,9507,No,Yes,7732
Massachusetts,2020/10/4,834.7466392,644,3,134947,9510,No,Yes,7732
Massachusetts,2020/10/5,834.7466392,515,20,135462,9530,No,Yes,7732
Massachusetts,2020/10/6,834.7466392,495,8,135957,9538,No,Yes,7732
Massachusetts,2020/10/7,834.7466392,535,19,136492,9557,No,Yes,8581
Massachusetts,2020/10/8,834.7466392,444,8,136936,9565,No,Yes,8581
Massachusetts,2020/10/9,834.7466392,765,12,137701,9577,No,Yes,8581
Massachusetts,2020/10/10,834.7466392,639,10,138340,9587,No,Yes,8581
Massachusetts,2020/10/11,834.7466392,563,17,138903,9604,No,Yes,8581
Massachusetts,2020/10/12,834.7466392,760,13,139663,9617,No,Yes,8581
Massachusetts,2020/10/13,834.7466392,749,13,140412,9630,No,Yes,8581
Massachusetts,2020/10/14,834.7466392,580,17,140992,9647,No,Yes,7964
Massachusetts,2020/10/15,834.7466392,587,25,141579,9672,No,Yes,7964
Massachusetts,2020/10/16,834.7466392,767,30,142346,9702,No,Yes,7964
Massachusetts,2020/10/17,834.7466392,584,21,142930,9723,No,Yes,7964
Massachusetts,2020/10/18,834.7466392,730,14,143660,9737,No,Yes,7964
Massachusetts,2020/10/19,834.7466392,828,16,144488,9753,No,Yes,7964
Massachusetts,2020/10/20,834.7466392,976,5,145464,9758,No,Yes,7964
Massachusetts,2020/10/21,834.7466392,702,22,146166,9780,No,Yes,7126
Massachusetts,2020/10/22,834.7466392,1049,30,147215,9810,No,Yes,7126
Massachusetts,2020/10/23,834.7466392,1070,20,148285,9830,No,Yes,7126
Massachusetts,2020/10/24,834.7466392,1203,9,149488,9839,No,Yes,7126
Massachusetts,2020/10/25,834.7466392,1077,25,150565,9864,No,Yes,7126
Massachusetts,2020/10/26,834.7466392,1212,17,151777,9881,No,Yes,7126
Massachusetts,2020/10/27,834.7466392,1260,7,153037,9888,No,Yes,7126
Massachusetts,2020/10/28,834.7466392,1181,36,154218,9924,No,Yes,7060
Massachusetts,2020/10/29,834.7466392,1346,27,155564,9951,No,Yes,7060
Massachusetts,2020/10/30,834.7466392,1582,24,157146,9975,No,Yes,7060
Massachusetts,2020/10/31,834.7466392,1430,16,158576,9991,No,Yes,7060
Massachusetts,2020/11/1,834.7466392,1131,22,159707,10013,No,Yes,7060
Massachusetts,2020/11/2,834.7466392,842,10,160549,10023,No,Yes,7060
Massachusetts,2020/11/3,834.7466392,1036,12,161585,10035,No,Yes,7060
Massachusetts,2020/11/4,834.7466392,1714,27,163299,10062,No,Yes,8764
Massachusetts,2020/11/5,834.7466392,1862,23,165161,10085,No,Yes,8764
Massachusetts,2020/11/6,834.7466392,2113,38,167274,10123,No,Yes,8764
Massachusetts,2020/11/7,834.7466392,2302,23,169576,10146,No,Yes,8764
Massachusetts,2020/11/8,834.7466392,1823,20,171399,10166,No,Yes,8764
Massachusetts,2020/11/9,834.7466392,1328,14,172727,10180,No,Yes,8764
Massachusetts,2020/11/10,834.7466392,2154,21,174881,10201,No,Yes,8764
Massachusetts,2020/11/11,834.7466392,2660,21,177541,10222,No,Yes,9262
Massachusetts,2020/11/12,834.7466392,2648,20,180189,10242,No,Yes,9262
Massachusetts,2020/11/13,834.7466392,2906,23,183095,10265,No,Yes,9262
Massachusetts,2020/11/14,834.7466392,3047,28,186142,10293,No,Yes,9262
Massachusetts,2020/11/15,834.7466392,2133,36,188275,10329,No,Yes,9262
Massachusetts,2020/11/16,834.7466392,2164,11,190439,10340,No,Yes,9262
Massachusetts,2020/11/17,834.7466392,2525,20,192964,10360,No,Yes,9262
Massachusetts,2020/11/18,834.7466392,2904,47,195868,10407,No,Yes,11813
Massachusetts,2020/11/19,834.7466392,2682,28,198550,10435,No,Yes,11813
Massachusetts,2020/11/20,834.7466392,2399,34,200949,10469,No,Yes,11813
Massachusetts,2020/11/21,834.7466392,3206,19,204155,10488,No,Yes,11813
Massachusetts,2020/11/22,834.7466392,2695,24,206850,10512,No,Yes,11813
Massachusetts,2020/11/23,834.7466392,1773,19,208623,10531,No,Yes,11813
Massachusetts,2020/11/24,834.7466392,2576,20,211199,10551,No,Yes,11813
Massachusetts,2020/11/25,834.7466392,3395,53,214594,10604,No,Yes,7061
Massachusetts,2020/11/26,834.7466392,0,0,214594,10604,No,Yes,7061
Massachusetts,2020/11/27,834.7466392,4658,31,219252,10635,No,Yes,7061
Massachusetts,2020/11/28,834.7466392,3217,41,222469,10676,No,Yes,7061
Massachusetts,2020/11/29,834.7466392,2495,46,224964,10722,No,Yes,7061
Massachusetts,2020/11/30,834.7466392,1168,26,226132,10748,No,Yes,7061
Massachusetts,2020/12/1,834.7466392,3073,30,229205,10778,No,Yes,7061
Massachusetts,2020/12/2,834.7466392,5027,46,234232,10824,No,Yes,7656
Massachusetts,2020/12/3,834.7466392,6675,50,240907,10874,No,Yes,7656
Massachusetts,2020/12/4,834.7466392,5491,36,246398,10910,No,Yes,7656
Massachusetts,2020/12/5,834.7466392,5619,43,252017,10953,No,Yes,7656
Massachusetts,2020/12/6,834.7466392,4827,51,256844,11004,No,Yes,7656
Massachusetts,2020/12/7,834.7466392,2481,31,259325,11035,No,Yes,7656
Massachusetts,2020/12/8,834.7466392,4122,41,263447,11076,No,Yes,7656
Massachusetts,2020/12/9,834.7466392,5965,90,269412,11166,No,Yes,7568
Massachusetts,2020/12/10,834.7466392,5369,43,274781,11209,No,Yes,7568
Massachusetts,2020/12/11,834.7466392,5655,48,280436,11257,No,Yes,7568
Massachusetts,2020/12/12,834.7466392,5289,50,285725,11307,No,Yes,7568
Massachusetts,2020/12/13,834.7466392,4853,42,290578,11349,No,Yes,7568
Massachusetts,2020/12/14,834.7466392,3653,39,294231,11388,No,Yes,7568
Massachusetts,2020/12/15,834.7466392,3929,55,298160,11443,No,Yes,7568
Massachusetts,2020/12/16,834.7466392,5952,70,304112,11513,No,Yes,7543
Massachusetts,2020/12/17,834.7466392,5135,45,309247,11558,No,Yes,7543
Massachusetts,2020/12/18,834.7466392,5679,52,314926,11610,No,Yes,7543
Massachusetts,2020/12/19,834.7466392,4344,47,319270,11657,No,Yes,7543
Massachusetts,2020/12/20,834.7466392,4261,60,323531,11717,No,Yes,7543
Massachusetts,2020/12/21,834.7466392,3843,42,327374,11759,No,Yes,7543
Massachusetts,2020/12/22,834.7466392,3800,45,331174,11804,No,Yes,7543
Massachusetts,2020/12/23,834.7466392,4814,83,335988,11887,No,Yes,5506
Massachusetts,2020/12/24,834.7466392,5937,76,341925,11963,No,Yes,5506
Massachusetts,2020/12/25,834.7466392,0,0,341925,11963,No,Yes,5506
Massachusetts,2020/12/26,834.7466392,7677,47,349602,12010,No,Yes,5506
Massachusetts,2020/12/27,834.7466392,3134,100,352736,12110,No,Yes,5506
Massachusetts,2020/12/28,834.7466392,4198,48,356934,12158,No,Yes,5506
Massachusetts,2020/12/29,834.7466392,4145,60,361079,12218,No,Yes,5506
Massachusetts,2020/12/30,834.7466392,6839,120,367918,12338,No,Yes,10986
Massachusetts,2020/12/31,834.7466392,7260,85,375178,12423,No,Yes,10986
Massachusetts,2021/1/1,834.7466392,0,0,375178,12423,No,Yes,10986
Massachusetts,2021/1/2,834.7466392,9003,79,384181,12502,No,Yes,10986
Massachusetts,2021/1/3,834.7466392,3481,108,387662,12610,No,Yes,10986
Massachusetts,2021/1/4,834.7466392,4920,59,392582,12669,No,Yes,10986
Massachusetts,2021/1/5,834.7466392,4620,65,397202,12734,No,Yes,10986
Massachusetts,2021/1/6,834.7466392,6851,102,404053,12836,No,Yes,14084
Massachusetts,2021/1/7,834.7466392,7548,73,411601,12909,No,Yes,14084
Massachusetts,2021/1/8,834.7466392,8120,76,419721,12985,No,Yes,14084
Massachusetts,2021/1/9,834.7466392,7414,89,427135,13074,No,Yes,14084
Massachusetts,2021/1/10,834.7466392,5656,77,432791,13151,No,Yes,14084
Massachusetts,2021/1/11,834.7466392,4251,55,437042,13206,No,Yes,14084
Massachusetts,2021/1/12,834.7466392,5487,67,442529,13273,No,Yes,14084
Massachusetts,2021/1/13,834.7466392,5918,86,448447,13359,No,Yes,11980
Massachusetts,2021/1/14,834.7466392,5955,74,454402,13433,No,Yes,11980
Massachusetts,2021/1/15,834.7466392,5525,76,459927,13509,No,Yes,11980
Massachusetts,2021/1/16,834.7466392,5799,74,465726,13583,No,Yes,11980
Massachusetts,2021/1/17,834.7466392,4414,69,470140,13652,No,Yes,11980
Massachusetts,2021/1/18,834.7466392,3301,53,473441,13705,No,Yes,11980
Massachusetts,2021/1/19,834.7466392,3085,44,476526,13749,No,Yes,11980
Massachusetts,2021/1/20,834.7466392,4514,80,481040,13829,No,Yes,11615
Massachusetts,2021/1/21,834.7466392,5140,77,486180,13906,No,Yes,11615
Massachusetts,2021/1/22,834.7466392,5272,81,491452,13987,No,Yes,11615
Massachusetts,2021/1/23,834.7466392,4641,77,496093,14064,No,Yes,11615
Massachusetts,2021/1/24,834.7466392,3944,69,500037,14133,No,Yes,11615
Massachusetts,2021/1/25,834.7466392,3651,45,503688,14178,No,Yes,11615
Massachusetts,2021/1/26,834.7466392,2495,42,506183,14220,No,Yes,11615
Massachusetts,2021/1/27,834.7466392,3320,84,509503,14304,No,Yes,12664
Massachusetts,2021/1/28,834.7466392,4631,44,514134,14348,No,Yes,12664
Massachusetts,2021/1/29,834.7466392,3118,96,517252,14444,No,Yes,12664
Massachusetts,2021/1/30,834.7466392,4108,87,521360,14531,No,Yes,12664
Massachusetts,2021/1/31,834.7466392,2665,46,524025,14577,No,Yes,12664
Massachusetts,2021/2/1,834.7466392,2398,30,526423,14607,No,Yes,12664
Massachusetts,2021/2/2,834.7466392,2239,45,528662,14652,No,Yes,12664
Massachusetts,2021/2/3,834.7466392,2455,56,531117,14708,No,Yes,13464
Massachusetts,2021/2/4,834.7466392,2804,76,533921,14784,No,Yes,13464
Massachusetts,2021/2/5,834.7466392,3287,75,537208,14859,No,Yes,13464
Massachusetts,2021/2/6,834.7466392,3619,62,540827,14921,No,Yes,13464
Massachusetts,2021/2/7,834.7466392,3107,78,543934,14999,No,Yes,13464
Massachusetts,2021/2/8,834.7466392,1369,55,545303,15054,No,Yes,13464
Massachusetts,2021/2/9,834.7466392,1593,70,546896,15124,No,Yes,13464
Massachusetts,2021/2/10,834.7466392,2050,83,548946,15207,No,Yes,12087
Massachusetts,2021/2/11,834.7466392,2450,62,551396,15269,No,Yes,12087
Massachusetts,2021/2/12,834.7466392,2416,89,553812,15358,No,Yes,12087
Massachusetts,2021/2/13,834.7466392,2083,66,555895,15424,No,Yes,12087
Massachusetts,2021/2/14,834.7466392,1882,60,557777,15484,No,Yes,12087
Massachusetts,2021/2/15,834.7466392,1573,33,559350,15517,No,Yes,12087
Massachusetts,2021/2/16,834.7466392,1226,50,560576,15567,No,Yes,12087
Massachusetts,2021/2/17,834.7466392,1360,56,561936,15623,No,Yes,11395
Massachusetts,2021/2/18,834.7466392,2040,63,563976,15686,No,Yes,11395
Massachusetts,2021/2/19,834.7466392,1818,40,565794,15726,No,Yes,11395
Massachusetts,2021/2/20,834.7466392,1970,53,567764,15779,No,Yes,11395
Massachusetts,2021/2/21,834.7466392,1520,47,569284,15826,No,Yes,11395
Massachusetts,2021/2/22,834.7466392,1262,27,570546,15853,No,Yes,11395
Massachusetts,2021/2/23,834.7466392,1237,30,571783,15883,No,Yes,11395
Massachusetts,2021/2/24,834.7466392,2102,62,573885,15945,No,Yes,11395
Massachusetts,2021/2/25,834.7466392,2108,33,575993,15978,No,Yes,11395
Massachusetts,2021/2/26,834.7466392,1987,46,577980,16024,No,Yes,11395
Massachusetts,2021/2/27,834.7466392,1700,43,579680,16067,No,Yes,11395
Massachusetts,2021/2/28,834.7466392,1468,51,581148,16118,No,Yes,11395
Massachusetts,2021/3/1,834.7466392,1395,26,582543,16144,No,Yes,11395
Massachusetts,2021/3/2,834.7466392,301,38,582844,16182,No,Yes,11395
Massachusetts,2021/3/3,834.7466392,1899,70,584743,16252,No,Yes,11395
Massachusetts,2021/3/4,834.7466392,1567,44,586310,16296,No,Yes,11395
Michigan,2020/3/1,171.54832,0,0,0,0,No,No,1575
Michigan,2020/3/2,171.54832,0,0,0,0,No,No,1575
Michigan,2020/3/3,171.54832,0,0,0,0,No,No,1575
Michigan,2020/3/4,171.54832,0,0,0,0,No,No,1663
Michigan,2020/3/5,171.54832,0,0,0,0,No,No,1663
Michigan,2020/3/6,171.54832,0,0,0,0,No,No,1663
Michigan,2020/3/7,171.54832,0,0,0,0,No,No,1663
Michigan,2020/3/8,171.54832,0,0,0,0,No,No,1663
Michigan,2020/3/9,171.54832,0,0,0,0,No,No,1663
Michigan,2020/3/10,171.54832,2,0,2,0,No,No,1663
Michigan,2020/3/11,171.54832,0,0,2,0,No,No,1819
Michigan,2020/3/12,171.54832,10,0,12,0,No,No,1819
Michigan,2020/3/13,171.54832,13,0,25,0,No,No,1819
Michigan,2020/3/14,171.54832,8,0,33,0,No,No,1819
Michigan,2020/3/15,171.54832,20,0,53,0,No,No,1819
Michigan,2020/3/16,171.54832,1,0,54,0,No,No,1819
Michigan,2020/3/17,171.54832,11,0,65,0,No,No,1819
Michigan,2020/3/18,171.54832,15,1,80,1,No,No,10892
Michigan,2020/3/19,171.54832,254,2,334,3,No,No,10892
Michigan,2020/3/20,171.54832,214,1,548,4,No,No,10892
Michigan,2020/3/21,171.54832,239,2,787,6,No,No,10892
Michigan,2020/3/22,171.54832,246,3,1033,9,No,No,10892
Michigan,2020/3/23,171.54832,291,7,1324,16,No,No,10892
Michigan,2020/3/24,171.54832,467,8,1791,24,Yes,No,10892
Michigan,2020/3/25,171.54832,502,19,2293,43,Yes,No,80984
Michigan,2020/3/26,171.54832,584,20,2877,63,Yes,No,80984
Michigan,2020/3/27,171.54832,778,30,3655,93,Yes,No,80984
Michigan,2020/3/28,171.54832,979,19,4634,112,Yes,No,80984
Michigan,2020/3/29,171.54832,852,20,5486,132,Yes,No,80984
Michigan,2020/3/30,171.54832,1022,65,6508,197,Yes,No,80984
Michigan,2020/3/31,171.54832,1121,67,7629,264,Yes,No,80984
Michigan,2020/4/1,171.54832,1663,72,9292,336,Yes,No,106739
Michigan,2020/4/2,171.54832,1499,81,10791,417,Yes,No,106739
Michigan,2020/4/3,171.54832,1878,61,12669,478,Yes,No,106739
Michigan,2020/4/4,171.54832,1556,63,14225,541,Yes,No,106739
Michigan,2020/4/5,171.54832,1408,76,15633,617,Yes,No,106739
Michigan,2020/4/6,171.54832,1496,110,17129,727,Yes,No,106739
Michigan,2020/4/7,171.54832,1722,118,18851,845,Yes,No,106739
Michigan,2020/4/8,171.54832,1369,114,20220,959,Yes,No,77515
Michigan,2020/4/9,171.54832,1155,117,21375,1076,Yes,No,77515
Michigan,2020/4/10,171.54832,1271,204,22646,1280,Yes,No,77515
Michigan,2020/4/11,171.54832,1209,115,23855,1395,Yes,No,77515
Michigan,2020/4/12,171.54832,641,93,24496,1488,Yes,No,77515
Michigan,2020/4/13,171.54832,994,115,25490,1603,Yes,No,77515
Michigan,2020/4/14,171.54832,1355,164,26845,1767,Yes,No,77515
Michigan,2020/4/15,171.54832,1049,153,27894,1920,Yes,No,66432
Michigan,2020/4/16,171.54832,1226,172,29120,2092,Yes,No,66432
Michigan,2020/4/17,171.54832,834,135,29954,2227,Yes,No,66432
Michigan,2020/4/18,171.54832,764,80,30718,2307,Yes,No,66432
Michigan,2020/4/19,171.54832,631,82,31349,2389,Yes,No,66432
Michigan,2020/4/20,171.54832,580,77,31929,2466,Yes,No,66432
Michigan,2020/4/21,171.54832,1007,232,32936,2698,Yes,No,66432
Michigan,2020/4/22,171.54832,1037,115,33973,2813,Yes,No,74966
Michigan,2020/4/23,171.54832,1280,164,35253,2977,Yes,No,74966
Michigan,2020/4/24,171.54832,1375,107,36628,3084,Yes,No,74966
Michigan,2020/4/25,171.54832,674,189,37302,3273,Yes,No,74966
Michigan,2020/4/26,171.54832,701,41,38003,3314,Yes,No,74966
Michigan,2020/4/27,171.54832,454,92,38457,3406,Yes,No,74966
Michigan,2020/4/28,171.54832,1012,160,39469,3566,Yes,No,74966
Michigan,2020/4/29,171.54832,974,104,40443,3670,Yes,No,28985
Michigan,2020/4/30,171.54832,905,118,41348,3788,Yes,No,28985
Michigan,2020/5/1,171.54832,1000,78,42348,3866,Yes,No,28985
Michigan,2020/5/2,171.54832,843,154,43191,4020,Yes,No,28985
Michigan,2020/5/3,171.54832,612,29,43803,4049,Yes,No,28985
Michigan,2020/5/4,171.54832,193,86,43996,4135,Yes,No,28985
Michigan,2020/5/5,171.54832,395,44,44391,4179,Yes,No,28985
Michigan,2020/5/6,171.54832,688,71,45079,4250,Yes,No,26666
Michigan,2020/5/7,171.54832,564,93,45643,4343,Yes,No,26666
Michigan,2020/5/8,171.54832,676,50,46319,4393,Yes,No,26666
Michigan,2020/5/9,171.54832,416,133,46735,4526,Yes,No,26666
Michigan,2020/5/10,171.54832,381,25,47116,4551,Yes,No,26666
Michigan,2020/5/11,171.54832,410,33,47526,4584,Yes,No,26666
Michigan,2020/5/12,171.54832,420,90,47946,4674,Yes,No,26666
Michigan,2020/5/13,171.54832,361,40,48307,4714,Yes,No,25150
Michigan,2020/5/14,171.54832,1182,73,49489,4787,Yes,No,25150
Michigan,2020/5/15,171.54832,493,38,49982,4825,Yes,No,25150
Michigan,2020/5/16,171.54832,434,55,50416,4880,Yes,No,25150
Michigan,2020/5/17,171.54832,638,11,51054,4891,Yes,No,25150
Michigan,2020/5/18,171.54832,799,24,51853,4915,Yes,No,25150
Michigan,2020/5/19,171.54832,484,102,52337,5017,Yes,No,25150
Michigan,2020/5/20,171.54832,651,43,52988,5060,Yes,No,27919
Michigan,2020/5/21,171.54832,480,69,53468,5129,Yes,No,27919
Michigan,2020/5/22,171.54832,397,29,53865,5158,Yes,No,27919
Michigan,2020/5/23,171.54832,439,65,54304,5223,Yes,No,27919
Michigan,2020/5/24,171.54832,312,5,54616,5228,Yes,No,27919
Michigan,2020/5/25,171.54832,200,12,54816,5240,Yes,No,27919
Michigan,2020/5/26,171.54832,224,26,55040,5266,Yes,No,27919
Michigan,2020/5/27,171.54832,504,68,55544,5334,Yes,No,21335
Michigan,2020/5/28,171.54832,400,38,55944,5372,Yes,No,21335
Michigan,2020/5/29,171.54832,645,34,56589,5406,Yes,No,21335
Michigan,2020/5/30,171.54832,259,57,56848,5463,Yes,No,21335
Michigan,2020/5/31,171.54832,507,28,57355,5491,Yes,No,21335
Michigan,2020/6/1,171.54832,1080,34,58435,5525,Yes,No,21335
Michigan,2020/6/2,171.54832,245,37,58680,5562,No,No,21335
Michigan,2020/6/3,171.54832,310,17,58990,5579,No,No,19949
Michigan,2020/6/4,171.54832,225,25,59215,5604,No,No,19949
Michigan,2020/6/5,171.54832,4529,250,63744,5854,No,No,19949
Michigan,2020/6/6,171.54832,452,40,64196,5894,No,No,19949
Michigan,2020/6/7,171.54832,419,4,64615,5898,No,No,19949
Michigan,2020/6/8,171.54832,296,18,64911,5916,No,No,19949
Michigan,2020/6/9,171.54832,279,30,65190,5946,No,No,19949
Michigan,2020/6/10,171.54832,187,12,65377,5958,No,No,18367
Michigan,2020/6/11,171.54832,250,27,65627,5985,No,No,18367
Michigan,2020/6/12,171.54832,254,9,65881,5994,No,No,18367
Michigan,2020/6/13,171.54832,143,23,66024,6017,No,No,18367
Michigan,2020/6/14,171.54832,222,3,66246,6020,No,No,18367
Michigan,2020/6/15,171.54832,56,5,66302,6025,No,No,18367
Michigan,2020/6/16,171.54832,164,14,66466,6039,No,No,18367
Michigan,2020/6/17,171.54832,228,2,66694,6041,No,No,18671
Michigan,2020/6/18,171.54832,286,23,66980,6064,No,No,18671
Michigan,2020/6/19,171.54832,320,7,67300,6071,No,No,18671
Michigan,2020/6/20,171.54832,421,20,67721,6091,No,No,18671
Michigan,2020/6/21,171.54832,152,3,67873,6094,No,No,18671
Michigan,2020/6/22,171.54832,271,7,68144,6101,No,No,18671
Michigan,2020/6/23,171.54832,229,12,68373,6113,No,No,18671
Michigan,2020/6/24,171.54832,338,5,68711,6118,No,No,18338
Michigan,2020/6/25,171.54832,448,19,69159,6137,No,No,18338
Michigan,2020/6/26,171.54832,314,1,69473,6138,No,No,18338
Michigan,2020/6/27,171.54832,329,19,69802,6157,No,No,18338
Michigan,2020/6/28,171.54832,240,4,70042,6161,No,No,18338
Michigan,2020/6/29,171.54832,314,4,70356,6165,No,No,18338
Michigan,2020/6/30,171.54832,494,32,70850,6197,No,No,18338
Michigan,2020/7/1,171.54832,429,5,71279,6202,No,No,19056
Michigan,2020/7/2,171.54832,574,14,71853,6216,No,No,19056
Michigan,2020/7/3,171.54832,453,3,72306,6219,No,No,19056
Michigan,2020/7/4,171.54832,396,3,72702,6222,No,No,19056
Michigan,2020/7/5,171.54832,325,0,73027,6222,No,No,19056
Michigan,2020/7/6,171.54832,376,3,73403,6225,No,No,19056
Michigan,2020/7/7,171.54832,608,31,74011,6256,No,No,19056
Michigan,2020/7/8,171.54832,649,10,74660,6266,No,No,20563
Michigan,2020/7/9,171.54832,587,9,75247,6275,No,No,20563
Michigan,2020/7/10,171.54832,624,13,75871,6288,No,Yes,20563
Michigan,2020/7/11,171.54832,628,28,76499,6316,No,Yes,20563
Michigan,2020/7/12,171.54832,437,1,76936,6317,No,Yes,20563
Michigan,2020/7/13,171.54832,418,7,77354,6324,No,Yes,20563
Michigan,2020/7/14,171.54832,691,6,78045,6330,No,Yes,20563
Michigan,2020/7/15,171.54832,1036,3,79081,6333,No,Yes,23676
Michigan,2020/7/16,171.54832,896,18,79977,6351,No,Yes,23676
Michigan,2020/7/17,171.54832,775,7,80752,6358,No,Yes,23676
Michigan,2020/7/18,171.54832,632,9,81384,6367,No,Yes,23676
Michigan,2020/7/19,171.54832,551,2,81935,6369,No,Yes,23676
Michigan,2020/7/20,171.54832,551,8,82486,6377,No,Yes,23676
Michigan,2020/7/21,171.54832,698,8,83184,6385,No,Yes,23676
Michigan,2020/7/22,171.54832,707,6,83891,6391,No,Yes,17437
Michigan,2020/7/23,171.54832,694,6,84585,6397,No,Yes,17437
Michigan,2020/7/24,171.54832,653,5,85238,6402,No,Yes,17437
Michigan,2020/7/25,171.54832,427,0,85665,6402,No,Yes,17437
Michigan,2020/7/26,171.54832,1085,0,86750,6402,No,Yes,17437
Michigan,2020/7/27,171.54832,579,5,87329,6407,No,Yes,17437
Michigan,2020/7/28,171.54832,696,19,88025,6426,No,Yes,17437
Michigan,2020/7/29,171.54832,1001,0,89026,6426,No,Yes,11690
Michigan,2020/7/30,171.54832,900,20,89926,6446,No,Yes,11690
Michigan,2020/7/31,171.54832,826,7,90752,6453,No,Yes,11690
Michigan,2020/8/1,171.54832,698,7,91450,6460,No,Yes,11690
Michigan,2020/8/2,171.54832,407,0,91857,6460,No,Yes,11690
Michigan,2020/8/3,171.54832,646,10,92503,6470,No,Yes,11690
Michigan,2020/8/4,171.54832,790,4,93293,6474,No,Yes,11690
Michigan,2020/8/5,171.54832,752,6,94045,6480,No,Yes,9467
Michigan,2020/8/6,171.54832,774,28,94819,6508,No,Yes,9467
Michigan,2020/8/7,171.54832,813,19,95632,6527,No,Yes,9467
Michigan,2020/8/8,171.54832,696,-6,96328,6521,No,Yes,9467
Michigan,2020/8/9,171.54832,507,-1,96835,6520,No,Yes,9467
Michigan,2020/8/10,171.54832,637,7,97472,6527,No,Yes,9467
Michigan,2020/8/11,171.54832,889,7,98361,6534,No,Yes,9467
Michigan,2020/8/12,171.54832,464,7,98825,6541,No,Yes,11047
Michigan,2020/8/13,171.54832,1138,15,99963,6556,No,Yes,11047
Michigan,2020/8/14,171.54832,850,11,100813,6567,No,Yes,11047
Michigan,2020/8/15,171.54832,1018,19,101831,6586,No,Yes,11047
Michigan,2020/8/16,171.54832,492,6,102323,6592,No,Yes,11047
Michigan,2020/8/17,171.54832,549,0,102872,6592,No,Yes,11047
Michigan,2020/8/18,171.54832,655,15,103527,6607,No,Yes,11047
Michigan,2020/8/19,171.54832,708,12,104235,6619,No,Yes,8676
Michigan,2020/8/20,171.54832,536,17,104771,6636,No,Yes,8676
Michigan,2020/8/21,171.54832,58,1,104829,6637,No,Yes,8676
Michigan,2020/8/22,171.54832,1312,20,106141,6657,No,Yes,8676
Michigan,2020/8/23,171.54832,734,4,106875,6661,No,Yes,8676
Michigan,2020/8/24,171.54832,941,4,107816,6665,No,Yes,8676
Michigan,2020/8/25,171.54832,926,22,108742,6687,No,Yes,8676
Michigan,2020/8/26,171.54832,903,5,109645,6692,No,Yes,8511
Michigan,2020/8/27,171.54832,846,16,110491,6708,No,Yes,8511
Michigan,2020/8/28,171.54832,812,6,111303,6714,No,Yes,8511
Michigan,2020/8/29,171.54832,801,33,112104,6747,No,Yes,8511
Michigan,2020/8/30,171.54832,494,3,112598,6750,No,Yes,8511
Michigan,2020/8/31,171.54832,565,6,113163,6756,No,Yes,8511
Michigan,2020/9/1,171.54832,806,14,113969,6770,No,Yes,8511
Michigan,2020/9/2,171.54832,634,13,114603,6783,No,Yes,8901
Michigan,2020/9/3,171.54832,790,11,115393,6794,No,Yes,8901
Michigan,2020/9/4,171.54832,1077,8,116470,6802,No,Yes,8901
Michigan,2020/9/5,171.54832,797,7,117267,6809,No,Yes,8901
Michigan,2020/9/6,171.54832,43,0,117310,6809,No,Yes,8901
Michigan,2020/9/7,171.54832,1078,4,118388,6813,No,Yes,8901
Michigan,2020/9/8,171.54832,596,1,118984,6814,No,Yes,8901
Michigan,2020/9/9,171.54832,968,75,119952,6889,No,Yes,8848
Michigan,2020/9/10,171.54832,944,5,120896,6894,No,Yes,8848
Michigan,2020/9/11,171.54832,1423,6,122319,6900,No,Yes,8848
Michigan,2020/9/12,171.54832,729,12,123048,6912,No,Yes,8848
Michigan,2020/9/13,171.54832,27,0,123075,6912,No,Yes,8848
Michigan,2020/9/14,171.54832,1201,10,124276,6922,No,Yes,8848
Michigan,2020/9/15,171.54832,702,11,124978,6933,No,Yes,8848
Michigan,2020/9/16,171.54832,804,11,125782,6944,No,Yes,8679
Michigan,2020/9/17,171.54832,1012,12,126794,6956,No,Yes,8679
Michigan,2020/9/18,171.54832,764,-1,127558,6955,No,Yes,8679
Michigan,2020/9/19,171.54832,554,15,128112,6970,No,Yes,8679
Michigan,2020/9/20,171.54832,36,1,128148,6971,No,Yes,8679
Michigan,2020/9/21,171.54832,1507,11,129655,6982,No,Yes,8679
Michigan,2020/9/22,171.54832,751,16,130406,6998,No,Yes,8679
Michigan,2020/9/23,171.54832,886,15,131292,7013,No,Yes,8805
Michigan,2020/9/24,171.54832,1108,7,132400,7020,No,Yes,8805
Michigan,2020/9/25,171.54832,1043,8,133443,7028,No,Yes,8805
Michigan,2020/9/26,171.54832,929,16,134372,7044,No,Yes,8805
Michigan,2020/9/27,171.54832,37,0,134409,7044,No,Yes,8805
Michigan,2020/9/28,171.54832,1373,8,135782,7052,No,Yes,8805
Michigan,2020/9/29,171.54832,1117,21,136899,7073,No,Yes,8805
Michigan,2020/9/30,171.54832,1175,11,138074,7084,No,Yes,7732
Michigan,2020/10/1,171.54832,990,19,139064,7103,No,Yes,7732
Michigan,2020/10/2,171.54832,993,7,140057,7110,No,Yes,7732
Michigan,2020/10/3,171.54832,1179,15,141236,7125,No,Yes,7732
Michigan,2020/10/4,171.54832,51,0,141287,7125,No,Yes,7732
Michigan,2020/10/5,171.54832,1470,16,142757,7141,No,Yes,7732
Michigan,2020/10/6,171.54832,1144,22,143901,7163,No,Yes,7732
Michigan,2020/10/7,171.54832,1230,8,145131,7171,No,Yes,8581
Michigan,2020/10/8,171.54832,1417,23,146548,7194,No,Yes,8581
Michigan,2020/10/9,171.54832,1332,8,147880,7202,No,Yes,8581
Michigan,2020/10/10,171.54832,1526,19,149406,7221,No,Yes,8581
Michigan,2020/10/11,171.54832,42,0,149448,7221,No,Yes,8581
Michigan,2020/10/12,171.54832,1836,6,151284,7227,No,Yes,8581
Michigan,2020/10/13,171.54832,1558,30,152842,7257,No,Yes,8581
Michigan,2020/10/14,171.54832,1567,13,154409,7270,No,Yes,7964
Michigan,2020/10/15,171.54832,2517,34,156926,7304,No,Yes,7964
Michigan,2020/10/16,171.54832,2218,16,159144,7320,No,Yes,7964
Michigan,2020/10/17,171.54832,115,3,159259,7323,No,Yes,7964
Michigan,2020/10/18,171.54832,78,0,159337,7323,No,Yes,7964
Michigan,2020/10/19,171.54832,4718,41,164055,7364,No,Yes,7964
Michigan,2020/10/20,171.54832,1894,22,165949,7386,No,Yes,7964
Michigan,2020/10/21,171.54832,1908,34,167857,7420,No,Yes,7126
Michigan,2020/10/22,171.54832,2245,45,170102,7465,No,Yes,7126
Michigan,2020/10/23,171.54832,2026,20,172128,7485,No,Yes,7126
Michigan,2020/10/24,171.54832,3257,37,175385,7522,No,Yes,7126
Michigan,2020/10/25,171.54832,130,0,175515,7522,No,Yes,7126
Michigan,2020/10/26,171.54832,4109,29,179624,7551,No,Yes,7126
Michigan,2020/10/27,171.54832,2660,34,182284,7585,No,Yes,7126
Michigan,2020/10/28,171.54832,3534,21,185818,7606,No,Yes,7060
Michigan,2020/10/29,171.54832,4108,45,189926,7651,No,Yes,7060
Michigan,2020/10/30,171.54832,3434,13,193360,7664,No,Yes,7060
Michigan,2020/10/31,171.54832,3804,35,197164,7699,No,Yes,7060
Michigan,2020/11/1,171.54832,337,1,197501,7700,No,Yes,7060
Michigan,2020/11/2,171.54832,6634,16,204135,7716,No,Yes,7060
Michigan,2020/11/3,171.54832,3664,42,207799,7758,No,Yes,7060
Michigan,2020/11/4,171.54832,4327,25,212126,7783,No,Yes,8764
Michigan,2020/11/5,171.54832,6010,50,218136,7833,No,Yes,8764
Michigan,2020/11/6,171.54832,4287,50,222423,7883,No,Yes,8764
Michigan,2020/11/7,171.54832,6283,60,228706,7943,No,Yes,8764
Michigan,2020/11/8,171.54832,379,1,229085,7944,No,Yes,8764
Michigan,2020/11/9,171.54832,9051,64,238136,8008,No,Yes,8764
Michigan,2020/11/10,171.54832,6869,87,245005,8095,No,Yes,8764
Michigan,2020/11/11,171.54832,6494,42,251499,8137,No,Yes,9262
Michigan,2020/11/12,171.54832,7474,50,258973,8187,No,Yes,9262
Michigan,2020/11/13,171.54832,9099,125,268072,8312,No,Yes,9262
Michigan,2020/11/14,171.54832,7321,63,275393,8375,No,Yes,9262
Michigan,2020/11/15,171.54832,499,3,275892,8378,No,Yes,9262
Michigan,2020/11/16,171.54832,12651,59,288543,8437,No,Yes,9262
Michigan,2020/11/17,171.54832,7893,76,296436,8513,No,Yes,9262
Michigan,2020/11/18,171.54832,6105,63,302541,8576,No,Yes,11813
Michigan,2020/11/19,171.54832,7855,141,310396,8717,No,Yes,11813
Michigan,2020/11/20,171.54832,10225,59,320621,8776,No,Yes,11813
Michigan,2020/11/21,171.54832,7557,98,328178,8874,No,Yes,11813
Michigan,2020/11/22,171.54832,655,0,328833,8874,No,Yes,11813
Michigan,2020/11/23,171.54832,11390,63,340223,8937,No,Yes,11813
Michigan,2020/11/24,171.54832,6853,157,347076,9094,No,Yes,11813
Michigan,2020/11/25,171.54832,4976,74,352052,9168,No,Yes,7061
Michigan,2020/11/26,171.54832,290,1,352342,9169,No,Yes,7061
Michigan,2020/11/27,171.54832,16680,183,369022,9352,No,Yes,7061
Michigan,2020/11/28,171.54832,8257,109,377279,9461,No,Yes,7061
Michigan,2020/11/29,171.54832,317,0,377596,9461,No,Yes,7061
Michigan,2020/11/30,171.54832,10768,104,388364,9565,No,Yes,7061
Michigan,2020/12/1,171.54832,6474,193,394838,9758,No,Yes,7061
Michigan,2020/12/2,171.54832,7417,81,402255,9839,No,Yes,7656
Michigan,2020/12/3,171.54832,8124,192,410379,10031,No,Yes,7656
Michigan,2020/12/4,171.54832,9325,82,419704,10113,No,Yes,7656
Michigan,2020/12/5,171.54832,6072,200,425776,10313,No,Yes,7656
Michigan,2020/12/6,171.54832,348,0,426124,10313,No,Yes,7656
Michigan,2020/12/7,171.54832,9557,102,435681,10415,No,Yes,7656
Michigan,2020/12/8,171.54832,6823,205,442504,10620,No,Yes,7656
Michigan,2020/12/9,171.54832,5313,79,447817,10699,No,Yes,7568
Michigan,2020/12/10,171.54832,6363,196,454180,10895,No,Yes,7568
Michigan,2020/12/11,171.54832,5631,66,459811,10961,No,Yes,7568
Michigan,2020/12/12,171.54832,4557,225,464368,11186,No,Yes,7568
Michigan,2020/12/13,171.54832,238,0,464606,11186,No,Yes,7568
Michigan,2020/12/14,171.54832,7560,96,472166,11282,No,Yes,7568
Michigan,2020/12/15,171.54832,5447,206,477613,11488,No,Yes,7568
Michigan,2020/12/16,171.54832,4604,94,482217,11582,No,Yes,7543
Michigan,2020/12/17,171.54832,4614,211,486831,11793,No,Yes,7543
Michigan,2020/12/18,171.54832,4508,68,491339,11861,No,Yes,7543
Michigan,2020/12/19,171.54832,3943,205,495282,12066,No,Yes,7543
Michigan,2020/12/20,171.54832,176,0,495458,12066,No,Yes,7543
Michigan,2020/12/21,171.54832,5003,80,500461,12146,No,Yes,7543
Michigan,2020/12/22,171.54832,3519,187,503980,12333,No,Yes,7543
Michigan,2020/12/23,171.54832,3795,72,507775,12405,No,Yes,5506
Michigan,2020/12/24,171.54832,254,1,508029,12406,No,Yes,5506
Michigan,2020/12/25,171.54832,142,0,508171,12406,No,Yes,5506
Michigan,2020/12/26,171.54832,7313,274,515484,12680,No,Yes,5506
Michigan,2020/12/27,171.54832,92,0,515576,12680,No,Yes,5506
Michigan,2020/12/28,171.54832,3715,64,519291,12744,No,Yes,5506
Michigan,2020/12/29,171.54832,3794,212,523085,12956,No,Yes,5506
Michigan,2020/12/30,171.54832,3847,52,526932,13008,No,Yes,10986
Michigan,2020/12/31,171.54832,267,2,527199,13010,No,Yes,10986
Michigan,2021/1/1,171.54832,177,1,527376,13011,No,Yes,10986
Michigan,2021/1/2,171.54832,8439,285,535815,13296,No,Yes,10986
Michigan,2021/1/3,171.54832,222,0,536037,13296,No,Yes,10986
Michigan,2021/1/4,171.54832,5684,85,541721,13381,No,Yes,10986
Michigan,2021/1/5,171.54832,3137,217,544858,13598,No,Yes,10986
Michigan,2021/1/6,171.54832,4609,59,549467,13657,No,Yes,14084
Michigan,2021/1/7,171.54832,4309,206,553776,13863,No,Yes,14084
Michigan,2021/1/8,171.54832,3898,40,557674,13903,No,Yes,14084
Michigan,2021/1/9,171.54832,2745,231,560419,14134,No,Yes,14084
Michigan,2021/1/10,171.54832,56,0,560475,14134,No,Yes,14084
Michigan,2021/1/11,171.54832,5370,49,565845,14183,No,Yes,14084
Michigan,2021/1/12,171.54832,2678,103,568523,14286,No,Yes,14084
Michigan,2021/1/13,171.54832,3115,39,571638,14325,No,Yes,11980
Michigan,2021/1/14,171.54832,3668,175,575306,14500,No,Yes,11980
Michigan,2021/1/15,171.54832,2988,39,578294,14539,No,Yes,11980
Michigan,2021/1/16,171.54832,2002,119,580296,14658,No,Yes,11980
Michigan,2021/1/17,171.54832,98,0,580394,14658,No,Yes,11980
Michigan,2021/1/18,171.54832,3452,19,583846,14677,No,Yes,11980
Michigan,2021/1/19,171.54832,2358,47,586204,14724,No,Yes,11980
Michigan,2021/1/20,171.54832,2412,35,588616,14759,No,Yes,11615
Michigan,2021/1/21,171.54832,2587,163,591203,14922,No,Yes,11615
Michigan,2021/1/22,171.54832,2523,18,593726,14940,No,Yes,11615
Michigan,2021/1/23,171.54832,1594,230,595320,15170,No,Yes,11615
Michigan,2021/1/24,171.54832,34,0,595354,15170,No,Yes,11615
Michigan,2021/1/25,171.54832,3095,38,598449,15208,No,Yes,11615
Michigan,2021/1/26,171.54832,2408,86,600857,15294,No,Yes,11615
Michigan,2021/1/27,171.54832,2039,9,602896,15303,No,Yes,12664
Michigan,2021/1/28,171.54832,2256,90,605152,15393,No,Yes,12664
Michigan,2021/1/29,171.54832,2027,8,607179,15401,No,Yes,12664
Michigan,2021/1/30,171.54832,1353,115,608532,15516,No,Yes,12664
Michigan,2021/1/31,171.54832,68,0,608600,15516,No,Yes,12664
Michigan,2021/2/1,171.54832,2623,11,611223,15527,No,Yes,12664
Michigan,2021/2/2,171.54832,1467,72,612690,15599,No,Yes,12664
Michigan,2021/2/3,171.54832,1665,34,614355,15633,No,Yes,13464
Michigan,2021/2/4,171.54832,3074,81,617429,15714,No,Yes,13464
Michigan,2021/2/5,171.54832,1700,25,619129,15739,No,Yes,13464
Michigan,2021/2/6,171.54832,1054,104,620183,15843,No,Yes,13464
Michigan,2021/2/7,171.54832,52,0,620235,15843,No,Yes,13464
Michigan,2021/2/8,171.54832,2255,11,622490,15854,No,Yes,13464
Michigan,2021/2/9,171.54832,853,60,623343,15914,No,Yes,13464
Michigan,2021/2/10,171.54832,1340,15,624683,15929,No,Yes,12087
Michigan,2021/2/11,171.54832,1469,80,626152,16009,No,Yes,12087
Michigan,2021/2/12,171.54832,1415,9,627567,16018,No,Yes,12087
Michigan,2021/2/13,171.54832,1345,90,628912,16108,No,Yes,12087
Michigan,2021/2/14,171.54832,54,0,628966,16108,No,Yes,12087
Michigan,2021/2/15,171.54832,1282,11,630248,16119,No,Yes,12087
Michigan,2021/2/16,171.54832,1146,19,631394,16138,No,Yes,12087
Michigan,2021/2/17,171.54832,1334,13,632728,16151,No,Yes,11395
Michigan,2021/2/18,171.54832,1204,92,633932,16243,No,Yes,11395
Michigan,2021/2/19,171.54832,1417,22,635349,16265,No,Yes,11395
Michigan,2021/2/20,171.54832,818,67,636167,16332,No,Yes,11395
Michigan,2021/2/21,171.54832,10,0,636177,16332,No,Yes,11395
Michigan,2021/2/22,171.54832,1744,2,637921,16334,No,Yes,11395
Michigan,2021/2/23,171.54832,1729,37,639650,16371,No,Yes,11395
Michigan,2021/2/24,171.54832,1535,9,641185,16380,No,Yes,11395
Michigan,2021/2/25,171.54832,1583,48,642768,16428,No,Yes,11395
Michigan,2021/2/26,171.54832,1278,1,644046,16429,No,Yes,11395
Michigan,2021/2/27,171.54832,1329,69,645375,16498,No,Yes,11395
Michigan,2021/2/28,171.54832,36,0,645411,16498,No,Yes,11395
Michigan,2021/3/1,171.54832,1954,11,647365,16509,No,Yes,11395
Michigan,2021/3/2,171.54832,1625,25,648990,16534,No,Yes,11395
Michigan,2021/3/3,171.54832,1808,7,650798,16541,No,Yes,11395
Michigan,2021/3/4,171.54832,1791,39,652589,16580,No,Yes,11395
Minnesota,2020/3/1,67.08416996,0,0,0,0,No,No,1575
Minnesota,2020/3/2,67.08416996,0,0,0,0,No,No,1575
Minnesota,2020/3/3,67.08416996,0,0,0,0,No,No,1575
Minnesota,2020/3/4,67.08416996,0,0,0,0,No,No,1663
Minnesota,2020/3/5,67.08416996,0,0,0,0,No,No,1663
Minnesota,2020/3/6,67.08416996,1,0,1,0,No,No,1663
Minnesota,2020/3/7,67.08416996,0,0,1,0,No,No,1663
Minnesota,2020/3/8,67.08416996,1,0,2,0,No,No,1663
Minnesota,2020/3/9,67.08416996,0,0,2,0,No,No,1663
Minnesota,2020/3/10,67.08416996,1,0,3,0,No,No,1663
Minnesota,2020/3/11,67.08416996,2,0,5,0,No,No,1819
Minnesota,2020/3/12,67.08416996,4,0,9,0,No,No,1819
Minnesota,2020/3/13,67.08416996,5,0,14,0,No,No,1819
Minnesota,2020/3/14,67.08416996,7,0,21,0,No,No,1819
Minnesota,2020/3/15,67.08416996,14,0,35,0,No,No,1819
Minnesota,2020/3/16,67.08416996,19,0,54,0,No,No,1819
Minnesota,2020/3/17,67.08416996,6,0,60,0,No,No,1819
Minnesota,2020/3/18,67.08416996,17,0,77,0,No,No,10892
Minnesota,2020/3/19,67.08416996,12,0,89,0,No,No,10892
Minnesota,2020/3/20,67.08416996,26,0,115,0,No,No,10892
Minnesota,2020/3/21,67.08416996,23,1,138,1,No,No,10892
Minnesota,2020/3/22,67.08416996,33,0,171,1,No,No,10892
Minnesota,2020/3/23,67.08416996,64,0,235,1,No,No,10892
Minnesota,2020/3/24,67.08416996,29,0,264,1,No,No,10892
Minnesota,2020/3/25,67.08416996,25,0,289,1,No,No,80984
Minnesota,2020/3/26,67.08416996,57,1,346,2,No,No,80984
Minnesota,2020/3/27,67.08416996,52,2,398,4,Yes,Yes,80984
Minnesota,2020/3/28,67.08416996,44,1,442,5,Yes,Yes,80984
Minnesota,2020/3/29,67.08416996,62,4,504,9,Yes,Yes,80984
Minnesota,2020/3/30,67.08416996,72,1,576,10,Yes,Yes,80984
Minnesota,2020/3/31,67.08416996,53,2,629,12,Yes,Yes,80984
Minnesota,2020/4/1,67.08416996,60,5,689,17,Yes,Yes,106739
Minnesota,2020/4/2,67.08416996,53,1,742,18,Yes,Yes,106739
Minnesota,2020/4/3,67.08416996,47,4,789,22,Yes,Yes,106739
Minnesota,2020/4/4,67.08416996,76,2,865,24,Yes,Yes,106739
Minnesota,2020/4/5,67.08416996,70,5,935,29,Yes,Yes,106739
Minnesota,2020/4/6,67.08416996,51,1,986,30,Yes,Yes,106739
Minnesota,2020/4/7,67.08416996,83,4,1069,34,Yes,Yes,106739
Minnesota,2020/4/8,67.08416996,85,5,1154,39,Yes,Yes,77515
Minnesota,2020/4/9,67.08416996,88,11,1242,50,Yes,Yes,77515
Minnesota,2020/4/10,67.08416996,93,7,1335,57,Yes,Yes,77515
Minnesota,2020/4/11,67.08416996,92,7,1427,64,Yes,Yes,77515
Minnesota,2020/4/12,67.08416996,194,6,1621,70,Yes,Yes,77515
Minnesota,2020/4/13,67.08416996,29,0,1650,70,Yes,Yes,77515
Minnesota,2020/4/14,67.08416996,45,9,1695,79,Yes,Yes,77515
Minnesota,2020/4/15,67.08416996,114,8,1809,87,Yes,Yes,66432
Minnesota,2020/4/16,67.08416996,103,7,1912,94,Yes,Yes,66432
Minnesota,2020/4/17,67.08416996,159,17,2071,111,Yes,Yes,66432
Minnesota,2020/4/18,67.08416996,142,10,2213,121,Yes,Yes,66432
Minnesota,2020/4/19,67.08416996,143,13,2356,134,Yes,Yes,66432
Minnesota,2020/4/20,67.08416996,114,9,2470,143,Yes,Yes,66432
Minnesota,2020/4/21,67.08416996,97,17,2567,160,Yes,Yes,66432
Minnesota,2020/4/22,67.08416996,154,19,2721,179,Yes,Yes,74966
Minnesota,2020/4/23,67.08416996,221,21,2942,200,Yes,Yes,74966
Minnesota,2020/4/24,67.08416996,243,21,3185,221,Yes,Yes,74966
Minnesota,2020/4/25,67.08416996,261,23,3446,244,Yes,Yes,74966
Minnesota,2020/4/26,67.08416996,156,28,3602,272,Yes,Yes,74966
Minnesota,2020/4/27,67.08416996,214,14,3816,286,Yes,Yes,74966
Minnesota,2020/4/28,67.08416996,365,15,4181,301,Yes,Yes,74966
Minnesota,2020/4/29,67.08416996,463,18,4644,319,Yes,Yes,28985
Minnesota,2020/4/30,67.08416996,492,24,5136,343,Yes,Yes,28985
Minnesota,2020/5/1,67.08416996,594,28,5730,371,Yes,Yes,28985
Minnesota,2020/5/2,67.08416996,498,24,6228,395,Yes,Yes,28985
Minnesota,2020/5/3,67.08416996,435,24,6663,419,Yes,Yes,28985
Minnesota,2020/5/4,67.08416996,571,9,7234,428,Yes,Yes,28985
Minnesota,2020/5/5,67.08416996,617,27,7851,455,Yes,Yes,28985
Minnesota,2020/5/6,67.08416996,728,30,8579,485,Yes,Yes,26666
Minnesota,2020/5/7,67.08416996,785,23,9364,508,Yes,Yes,26666
Minnesota,2020/5/8,67.08416996,723,26,10087,534,Yes,Yes,26666
Minnesota,2020/5/9,67.08416996,702,24,10789,558,Yes,Yes,26666
Minnesota,2020/5/10,67.08416996,481,20,11270,578,Yes,Yes,26666
Minnesota,2020/5/11,67.08416996,528,13,11798,591,Yes,Yes,26666
Minnesota,2020/5/12,67.08416996,695,23,12493,614,Yes,Yes,26666
Minnesota,2020/5/13,67.08416996,423,24,12916,638,Yes,Yes,25150
Minnesota,2020/5/14,67.08416996,527,34,13443,672,Yes,Yes,25150
Minnesota,2020/5/15,67.08416996,797,20,14240,692,Yes,Yes,25150
Minnesota,2020/5/16,67.08416996,729,17,14969,709,Yes,Yes,25150
Minnesota,2020/5/17,67.08416996,708,22,15677,731,Yes,Yes,25150
Minnesota,2020/5/18,67.08416996,695,9,16372,740,No,No,25150
Minnesota,2020/5/19,67.08416996,666,17,17038,757,No,No,25150
Minnesota,2020/5/20,67.08416996,641,29,17679,786,No,No,27919
Minnesota,2020/5/21,67.08416996,530,32,18209,818,No,No,27919
Minnesota,2020/5/22,67.08416996,805,33,19014,851,No,No,27919
Minnesota,2020/5/23,67.08416996,840,10,19854,861,No,No,27919
Minnesota,2020/5/24,67.08416996,728,17,20582,878,No,No,27919
Minnesota,2020/5/25,67.08416996,742,12,21324,890,No,No,27919
Minnesota,2020/5/26,67.08416996,645,18,21969,908,No,No,27919
Minnesota,2020/5/27,67.08416996,505,34,22474,942,No,No,21335
Minnesota,2020/5/28,67.08416996,483,35,22957,977,No,No,21335
Minnesota,2020/5/29,67.08416996,584,29,23541,1006,No,No,21335
Minnesota,2020/5/30,67.08416996,659,30,24200,1036,No,No,21335
Minnesota,2020/5/31,67.08416996,660,14,24860,1050,No,No,21335
Minnesota,2020/6/1,67.08416996,358,10,25218,1060,No,No,21335
Minnesota,2020/6/2,67.08416996,300,22,25518,1082,No,No,21335
Minnesota,2020/6/3,67.08416996,363,15,25881,1097,No,No,19949
Minnesota,2020/6/4,67.08416996,403,29,26284,1126,No,No,19949
Minnesota,2020/6/5,67.08416996,707,33,26991,1159,No,No,19949
Minnesota,2020/6/6,67.08416996,521,22,27512,1181,No,No,19949
Minnesota,2020/6/7,67.08416996,385,16,27897,1197,No,No,19949
Minnesota,2020/6/8,67.08416996,338,11,28235,1208,No,No,19949
Minnesota,2020/6/9,67.08416996,299,20,28534,1228,No,No,19949
Minnesota,2020/6/10,67.08416996,366,39,28900,1267,No,No,18367
Minnesota,2020/6/11,67.08416996,447,13,29347,1280,No,No,18367
Minnesota,2020/6/12,67.08416996,479,25,29826,1305,No,No,18367
Minnesota,2020/6/13,67.08416996,377,9,30203,1314,No,No,18367
Minnesota,2020/6/14,67.08416996,299,15,30502,1329,No,No,18367
Minnesota,2020/6/15,67.08416996,222,6,30724,1335,No,No,18367
Minnesota,2020/6/16,67.08416996,189,9,30913,1344,No,No,18367
Minnesota,2020/6/17,67.08416996,415,13,31328,1357,No,No,18671
Minnesota,2020/6/18,67.08416996,379,19,31707,1376,No,No,18671
Minnesota,2020/6/19,67.08416996,356,17,32063,1393,No,No,18671
Minnesota,2020/6/20,67.08416996,436,11,32499,1404,No,No,18671
Minnesota,2020/6/21,67.08416996,453,8,32952,1412,No,No,18671
Minnesota,2020/6/22,67.08416996,307,4,33259,1416,No,No,18671
Minnesota,2020/6/23,67.08416996,242,9,33501,1425,No,No,18671
Minnesota,2020/6/24,67.08416996,297,7,33798,1432,No,No,18338
Minnesota,2020/6/25,67.08416996,360,9,34158,1441,No,No,18338
Minnesota,2020/6/26,67.08416996,493,5,34651,1446,No,No,18338
Minnesota,2020/6/27,67.08416996,417,6,35068,1452,No,No,18338
Minnesota,2020/6/28,67.08416996,516,8,35584,1460,No,No,18338
Minnesota,2020/6/29,67.08416996,312,10,35896,1470,No,No,18338
Minnesota,2020/6/30,67.08416996,442,6,36338,1476,No,No,18338
Minnesota,2020/7/1,67.08416996,415,6,36753,1482,No,No,19056
Minnesota,2020/7/2,67.08416996,494,13,37247,1495,No,No,19056
Minnesota,2020/7/3,67.08416996,414,8,37661,1503,No,No,19056
Minnesota,2020/7/4,67.08416996,0,0,37661,1503,No,No,19056
Minnesota,2020/7/5,67.08416996,512,5,38173,1508,No,No,19056
Minnesota,2020/7/6,67.08416996,433,3,38606,1511,No,No,19056
Minnesota,2020/7/7,67.08416996,564,3,39170,1514,No,No,19056
Minnesota,2020/7/8,67.08416996,457,9,39627,1523,No,No,20563
Minnesota,2020/7/9,67.08416996,574,5,40201,1528,No,No,20563
Minnesota,2020/7/10,67.08416996,604,5,40805,1533,No,No,20563
Minnesota,2020/7/11,67.08416996,804,4,41609,1537,No,No,20563
Minnesota,2020/7/12,67.08416996,710,3,42319,1540,No,No,20563
Minnesota,2020/7/13,67.08416996,491,2,42810,1542,No,No,20563
Minnesota,2020/7/14,67.08416996,398,6,43208,1548,No,No,20563
Minnesota,2020/7/15,67.08416996,574,10,43782,1558,No,No,23676
Minnesota,2020/7/16,67.08416996,605,8,44387,1566,No,No,23676
Minnesota,2020/7/17,67.08416996,666,7,45053,1573,No,No,23676
Minnesota,2020/7/18,67.08416996,457,5,45510,1578,No,No,23676
Minnesota,2020/7/19,67.08416996,734,3,46244,1581,No,No,23676
Minnesota,2020/7/20,67.08416996,903,4,47147,1585,No,No,23676
Minnesota,2020/7/21,67.08416996,350,3,47497,1588,No,No,23676
Minnesota,2020/7/22,67.08416996,504,4,48001,1592,No,No,17437
Minnesota,2020/7/23,67.08416996,760,9,48761,1601,No,No,17437
Minnesota,2020/7/24,67.08416996,767,5,49528,1606,No,No,17437
Minnesota,2020/7/25,67.08416996,803,5,50331,1611,No,No,17437
Minnesota,2020/7/26,67.08416996,862,3,51193,1614,No,No,17437
Minnesota,2020/7/27,67.08416996,650,2,51843,1616,No,No,17437
Minnesota,2020/7/28,67.08416996,478,4,52321,1620,No,No,17437
Minnesota,2020/7/29,67.08416996,666,9,52987,1629,No,No,11690
Minnesota,2020/7/30,67.08416996,745,5,53732,1634,No,No,11690
Minnesota,2020/7/31,67.08416996,771,6,54503,1640,No,No,11690
Minnesota,2020/8/1,67.08416996,725,6,55228,1646,No,No,11690
Minnesota,2020/8/2,67.08416996,759,8,55987,1654,No,No,11690
Minnesota,2020/8/3,67.08416996,613,2,56600,1656,No,No,11690
Minnesota,2020/8/4,67.08416996,602,4,57202,1660,No,No,11690
Minnesota,2020/8/5,67.08416996,618,10,57820,1670,No,No,9467
Minnesota,2020/8/6,67.08416996,861,7,58681,1677,No,No,9467
Minnesota,2020/8/7,67.08416996,545,4,59226,1681,No,No,9467
Minnesota,2020/8/8,67.08416996,916,8,60142,1689,No,No,9467
Minnesota,2020/8/9,67.08416996,797,9,60939,1698,No,No,9467
Minnesota,2020/8/10,67.08416996,618,3,61557,1701,No,No,9467
Minnesota,2020/8/11,67.08416996,323,6,61880,1707,No,No,9467
Minnesota,2020/8/12,67.08416996,469,17,62349,1724,No,No,11047
Minnesota,2020/8/13,67.08416996,690,7,63039,1731,No,No,11047
Minnesota,2020/8/14,67.08416996,730,8,63769,1739,No,No,11047
Minnesota,2020/8/15,67.08416996,690,6,64459,1745,No,No,11047
Minnesota,2020/8/16,67.08416996,739,7,65198,1752,No,No,11047
Minnesota,2020/8/17,67.08416996,564,6,65762,1758,No,No,11047
Minnesota,2020/8/18,67.08416996,345,9,66107,1767,No,No,11047
Minnesota,2020/8/19,67.08416996,557,17,66664,1784,No,No,8676
Minnesota,2020/8/20,67.08416996,690,7,67354,1791,No,No,8676
Minnesota,2020/8/21,67.08416996,825,8,68179,1799,No,No,8676
Minnesota,2020/8/22,67.08416996,734,8,68913,1807,No,No,8676
Minnesota,2020/8/23,67.08416996,717,6,69630,1813,No,No,8676
Minnesota,2020/8/24,67.08416996,714,4,70344,1817,No,No,8676
Minnesota,2020/8/25,67.08416996,409,8,70753,1825,No,No,8676
Minnesota,2020/8/26,67.08416996,532,17,71285,1842,No,No,8511
Minnesota,2020/8/27,67.08416996,1154,13,72439,1855,No,No,8511
Minnesota,2020/8/28,67.08416996,850,4,73289,1859,No,No,8511
Minnesota,2020/8/29,67.08416996,1017,4,74306,1863,No,No,8511
Minnesota,2020/8/30,67.08416996,932,2,75238,1865,No,No,8511
Minnesota,2020/8/31,67.08416996,675,1,75913,1866,No,No,8511
Minnesota,2020/9/1,67.08416996,491,6,76404,1872,No,No,8511
Minnesota,2020/9/2,67.08416996,733,10,77137,1882,No,No,8901
Minnesota,2020/9/3,67.08416996,1038,7,78175,1889,No,No,8901
Minnesota,2020/9/4,67.08416996,843,10,79018,1899,No,No,8901
Minnesota,2020/9/5,67.08416996,914,4,79932,1903,No,No,8901
Minnesota,2020/9/6,67.08416996,707,6,80639,1909,No,No,8901
Minnesota,2020/9/7,67.08416996,638,3,81277,1912,No,No,8901
Minnesota,2020/9/8,67.08416996,383,2,81660,1914,No,No,8901
Minnesota,2020/9/9,67.08416996,260,7,81920,1921,No,No,8848
Minnesota,2020/9/10,67.08416996,381,15,82301,1936,No,No,8848
Minnesota,2020/9/11,67.08416996,467,13,82768,1949,No,No,8848
Minnesota,2020/9/12,67.08416996,872,9,83640,1958,No,No,8848
Minnesota,2020/9/13,67.08416996,723,13,84363,1971,No,No,8848
Minnesota,2020/9/14,67.08416996,638,3,85001,1974,No,No,8848
Minnesota,2020/9/15,67.08416996,402,5,85403,1979,No,No,8848
Minnesota,2020/9/16,67.08416996,462,6,85865,1985,No,No,8679
Minnesota,2020/9/17,67.08416996,909,9,86774,1994,No,No,8679
Minnesota,2020/9/18,67.08416996,1085,8,87859,2002,No,No,8679
Minnesota,2020/9/19,67.08416996,914,13,88773,2015,No,No,8679
Minnesota,2020/9/20,67.08416996,1296,2,90069,2017,No,No,8679
Minnesota,2020/9/21,67.08416996,925,4,90994,2021,No,No,8679
Minnesota,2020/9/22,67.08416996,480,10,91474,2031,No,No,8679
Minnesota,2020/9/23,67.08416996,678,6,92152,2037,No,No,8805
Minnesota,2020/9/24,67.08416996,912,3,93064,2040,No,No,8805
Minnesota,2020/9/25,67.08416996,1177,6,94241,2046,No,No,8805
Minnesota,2020/9/26,67.08416996,1470,10,95711,2056,No,No,8805
Minnesota,2020/9/27,67.08416996,1075,4,96786,2060,No,No,8805
Minnesota,2020/9/28,67.08416996,904,7,97690,2067,No,No,8805
Minnesota,2020/9/29,67.08416996,809,5,98499,2072,No,No,8805
Minnesota,2020/9/30,67.08416996,688,17,99187,2089,No,No,7732
Minnesota,2020/10/1,67.08416996,1066,13,100253,2102,No,No,7732
Minnesota,2020/10/2,67.08416996,1166,10,101419,2112,No,No,7732
Minnesota,2020/10/3,67.08416996,1421,14,102840,2126,No,No,7732
Minnesota,2020/10/4,67.08416996,1039,7,103879,2133,No,No,7732
Minnesota,2020/10/5,67.08416996,973,3,104852,2136,No,No,7732
Minnesota,2020/10/6,67.08416996,941,4,105793,2140,No,No,7732
Minnesota,2020/10/7,67.08416996,911,14,106704,2154,No,No,8581
Minnesota,2020/10/8,67.08416996,1271,6,107975,2160,No,No,8581
Minnesota,2020/10/9,67.08416996,1390,14,109365,2174,No,No,8581
Minnesota,2020/10/10,67.08416996,1516,10,110881,2184,No,No,8581
Minnesota,2020/10/11,67.08416996,1440,10,112321,2194,No,No,8581
Minnesota,2020/10/12,67.08416996,1171,3,113492,2197,No,No,8581
Minnesota,2020/10/13,67.08416996,1135,7,114627,2204,No,No,8581
Minnesota,2020/10/14,67.08416996,1369,29,115996,2233,No,No,7964
Minnesota,2020/10/15,67.08416996,1163,19,117159,2252,No,No,7964
Minnesota,2020/10/16,67.08416996,2290,13,119449,2265,No,No,7964
Minnesota,2020/10/17,67.08416996,1694,5,121143,2270,No,No,7964
Minnesota,2020/10/18,67.08416996,1722,17,122865,2287,No,No,7964
Minnesota,2020/10/19,67.08416996,1627,5,124492,2292,No,No,7964
Minnesota,2020/10/20,67.08416996,1092,7,125584,2299,No,No,7964
Minnesota,2020/10/21,67.08416996,1060,35,126644,2334,No,No,7126
Minnesota,2020/10/22,67.08416996,1561,20,128205,2354,No,No,7126
Minnesota,2020/10/23,67.08416996,1711,13,129916,2367,No,No,7126
Minnesota,2020/10/24,67.08416996,2259,14,132175,2381,No,No,7126
Minnesota,2020/10/25,67.08416996,1680,21,133855,2402,No,No,7126
Minnesota,2020/10/26,67.08416996,1570,4,135425,2406,No,No,7126
Minnesota,2020/10/27,67.08416996,2164,15,137589,2421,No,No,7126
Minnesota,2020/10/28,67.08416996,1908,19,139497,2440,No,No,7060
Minnesota,2020/10/29,67.08416996,2867,32,142364,2472,No,No,7060
Minnesota,2020/10/30,67.08416996,3155,19,145519,2491,No,No,7060
Minnesota,2020/10/31,67.08416996,3007,20,148526,2511,No,No,7060
Minnesota,2020/11/1,67.08416996,2200,18,150726,2529,No,No,7060
Minnesota,2020/11/2,67.08416996,2948,9,153674,2538,No,No,7060
Minnesota,2020/11/3,67.08416996,3476,15,157150,2553,No,No,7060
Minnesota,2020/11/4,67.08416996,3827,31,160977,2584,No,No,8764
Minnesota,2020/11/5,67.08416996,3942,25,164919,2609,No,No,8764
Minnesota,2020/11/6,67.08416996,5442,36,170361,2645,No,No,8764
Minnesota,2020/11/7,67.08416996,4647,34,175008,2679,No,No,8764
Minnesota,2020/11/8,67.08416996,5908,31,180916,2710,No,No,8764
Minnesota,2020/11/9,67.08416996,3926,19,184842,2729,No,No,8764
Minnesota,2020/11/10,67.08416996,4893,23,189735,2752,No,No,8764
Minnesota,2020/11/11,67.08416996,4891,58,194626,2810,No,No,9262
Minnesota,2020/11/12,67.08416996,7225,39,201851,2849,No,No,9262
Minnesota,2020/11/13,67.08416996,5544,46,207395,2895,No,No,9262
Minnesota,2020/11/14,67.08416996,8689,35,216084,2930,No,No,9262
Minnesota,2020/11/15,67.08416996,7553,31,223637,2961,No,No,9262
Minnesota,2020/11/16,67.08416996,7437,12,231074,2973,No,No,9262
Minnesota,2020/11/17,67.08416996,5931,26,237005,2999,No,No,9262
Minnesota,2020/11/18,67.08416996,5094,67,242099,3066,No,No,11813
Minnesota,2020/11/19,67.08416996,7863,72,249962,3138,No,No,11813
Minnesota,2020/11/20,67.08416996,6794,68,256756,3206,No,No,11813
Minnesota,2020/11/21,67.08416996,6252,51,263008,3257,No,No,11813
Minnesota,2020/11/22,67.08416996,7205,40,270213,3297,No,No,11813
Minnesota,2020/11/23,67.08416996,6343,24,276556,3321,No,No,11813
Minnesota,2020/11/24,67.08416996,6416,38,282972,3359,No,No,11813
Minnesota,2020/11/25,67.08416996,6390,75,289362,3434,No,No,7061
Minnesota,2020/11/26,67.08416996,0,0,289362,3434,No,No,7061
Minnesota,2020/11/27,67.08416996,5698,101,295060,3535,No,No,7061
Minnesota,2020/11/28,67.08416996,9022,45,304082,3580,No,No,7061
Minnesota,2020/11/29,67.08416996,8946,57,313028,3637,No,No,7061
Minnesota,2020/11/30,67.08416996,5794,15,318822,3652,No,No,7061
Minnesota,2020/12/1,67.08416996,3549,22,322371,3674,No,No,7061
Minnesota,2020/12/2,67.08416996,5165,77,327536,3751,No,No,7656
Minnesota,2020/12/3,67.08416996,6149,92,333685,3843,No,No,7656
Minnesota,2020/12/4,67.08416996,5347,61,339032,3904,No,No,7656
Minnesota,2020/12/5,67.08416996,6308,75,345340,3979,No,No,7656
Minnesota,2020/12/6,67.08416996,5581,64,350921,4043,No,No,7656
Minnesota,2020/12/7,67.08416996,5290,21,356211,4064,No,No,7656
Minnesota,2020/12/8,67.08416996,3051,22,359262,4086,No,No,7656
Minnesota,2020/12/9,67.08416996,4516,82,363778,4168,No,No,7568
Minnesota,2020/12/10,67.08416996,3499,89,367277,4257,No,No,7568
Minnesota,2020/12/11,67.08416996,3750,94,371027,4351,No,No,7568
Minnesota,2020/12/12,67.08416996,4430,67,375457,4418,No,No,7568
Minnesota,2020/12/13,67.08416996,3425,85,378882,4503,No,No,7568
Minnesota,2020/12/14,67.08416996,3018,18,381900,4521,No,No,7568
Minnesota,2020/12/15,67.08416996,2323,21,384223,4542,No,No,7568
Minnesota,2020/12/16,67.08416996,2248,92,386471,4634,No,No,7543
Minnesota,2020/12/17,67.08416996,2759,83,389230,4717,No,No,7543
Minnesota,2020/12/18,67.08416996,2718,65,391948,4782,No,No,7543
Minnesota,2020/12/19,67.08416996,2746,57,394694,4839,No,No,7543
Minnesota,2020/12/20,67.08416996,2684,70,397378,4909,No,No,7543
Minnesota,2020/12/21,67.08416996,1992,22,399370,4931,No,No,7543
Minnesota,2020/12/22,67.08416996,1700,24,401070,4955,No,No,7543
Minnesota,2020/12/23,67.08416996,1508,75,402578,5030,No,No,5506
Minnesota,2020/12/24,67.08416996,1884,79,404462,5109,No,No,5506
Minnesota,2020/12/25,67.08416996,0,0,404462,5109,No,No,5506
Minnesota,2020/12/26,67.08416996,2142,57,406604,5166,No,No,5506
Minnesota,2020/12/27,67.08416996,2516,40,409120,5206,No,No,5506
Minnesota,2020/12/28,67.08416996,1077,13,410197,5219,No,No,5506
Minnesota,2020/12/29,67.08416996,972,36,411169,5255,No,No,5506
Minnesota,2020/12/30,67.08416996,1997,66,413166,5321,No,No,10986
Minnesota,2020/12/31,67.08416996,2195,61,415361,5382,No,No,10986
Minnesota,2021/1/1,67.08416996,0,0,415361,5382,No,No,10986
Minnesota,2021/1/2,67.08416996,2530,54,417891,5436,No,No,10986
Minnesota,2021/1/3,67.08416996,2712,53,420603,5489,No,No,10986
Minnesota,2021/1/4,67.08416996,3144,13,423747,5502,No,No,10986
Minnesota,2021/1/5,67.08416996,1573,18,425320,5520,No,No,10986
Minnesota,2021/1/6,67.08416996,2335,76,427655,5596,No,No,14084
Minnesota,2021/1/7,67.08416996,1983,44,429638,5640,No,No,14084
Minnesota,2021/1/8,67.08416996,2374,48,432012,5688,No,No,14084
Minnesota,2021/1/9,67.08416996,2469,43,434481,5731,No,No,14084
Minnesota,2021/1/10,67.08416996,2159,44,436640,5775,No,No,14084
Minnesota,2021/1/11,67.08416996,980,4,437620,5779,No,No,14084
Minnesota,2021/1/12,67.08416996,1315,13,438935,5792,No,No,14084
Minnesota,2021/1/13,67.08416996,1487,50,440422,5842,No,No,11980
Minnesota,2021/1/14,67.08416996,1581,43,442003,5885,No,No,11980
Minnesota,2021/1/15,67.08416996,1627,33,443630,5918,No,No,11980
Minnesota,2021/1/16,67.08416996,1485,37,445115,5955,No,No,11980
Minnesota,2021/1/17,67.08416996,1333,40,446448,5995,No,No,11980
Minnesota,2021/1/18,67.08416996,969,12,447417,6007,No,No,11980
Minnesota,2021/1/19,67.08416996,919,6,448336,6013,No,No,11980
Minnesota,2021/1/20,67.08416996,1224,34,449560,6047,No,No,11615
Minnesota,2021/1/21,67.08416996,1270,32,450830,6079,No,No,11615
Minnesota,2021/1/22,67.08416996,1506,21,452336,6100,No,No,11615
Minnesota,2021/1/23,67.08416996,1540,31,453876,6131,No,No,11615
Minnesota,2021/1/24,67.08416996,1181,32,455057,6163,No,No,11615
Minnesota,2021/1/25,67.08416996,794,3,455851,6166,No,No,11615
Minnesota,2021/1/26,67.08416996,707,8,456558,6174,No,No,11615
Minnesota,2021/1/27,67.08416996,827,18,457385,6192,No,No,12664
Minnesota,2021/1/28,67.08416996,1316,16,458701,6208,No,No,12664
Minnesota,2021/1/29,67.08416996,1114,28,459815,6236,No,No,12664
Minnesota,2021/1/30,67.08416996,1072,19,460887,6255,No,No,12664
Minnesota,2021/1/31,67.08416996,988,13,461875,6268,No,No,12664
Minnesota,2021/2/1,67.08416996,721,2,462596,6270,No,No,12664
Minnesota,2021/2/2,67.08416996,604,8,463200,6278,No,No,12664
Minnesota,2021/2/3,67.08416996,634,24,463834,6302,No,No,13464
Minnesota,2021/2/4,67.08416996,1410,17,465244,6319,No,No,13464
Minnesota,2021/2/5,67.08416996,1048,22,466292,6341,No,No,13464
Minnesota,2021/2/6,67.08416996,993,16,467285,6357,No,No,13464
Minnesota,2021/2/7,67.08416996,901,10,468186,6367,No,No,13464
Minnesota,2021/2/8,67.08416996,564,3,468750,6370,No,No,13464
Minnesota,2021/2/9,67.08416996,572,6,469322,6376,No,No,13464
Minnesota,2021/2/10,67.08416996,651,11,469973,6387,No,No,12087
Minnesota,2021/2/11,67.08416996,898,24,470871,6411,No,No,12087
Minnesota,2021/2/12,67.08416996,1048,19,471919,6430,No,No,12087
Minnesota,2021/2/13,67.08416996,940,7,472859,6437,No,No,12087
Minnesota,2021/2/14,67.08416996,776,7,473635,6444,No,No,12087
Minnesota,2021/2/15,67.08416996,602,2,474237,6446,No,No,12087
Minnesota,2021/2/16,67.08416996,452,2,474689,6448,No,No,12087
Minnesota,2021/2/17,67.08416996,758,10,475447,6458,No,No,11395
Minnesota,2021/2/18,67.08416996,913,14,476360,6472,No,No,11395
Minnesota,2021/2/19,67.08416996,995,8,477355,6480,No,No,11395
Minnesota,2021/2/20,67.08416996,870,11,478225,6491,No,No,11395
Minnesota,2021/2/21,67.08416996,879,9,479104,6500,No,No,11395
Minnesota,2021/2/22,67.08416996,555,1,479659,6501,No,No,11395
Minnesota,2021/2/23,67.08416996,500,1,480159,6502,No,No,11395
Minnesota,2021/2/24,67.08416996,754,9,480913,6511,No,No,11395
Minnesota,2021/2/25,67.08416996,986,7,481899,6518,No,No,11395
Minnesota,2021/2/26,67.08416996,1147,12,483046,6530,No,No,11395
Minnesota,2021/2/27,67.08416996,812,13,483858,6543,No,No,11395
Minnesota,2021/2/28,67.08416996,804,8,484662,6551,No,No,11395
Minnesota,2021/3/1,67.08416996,636,3,485298,6554,No,No,11395
Minnesota,2021/3/2,67.08416996,425,4,485723,6558,No,No,11395
Minnesota,2021/3/3,67.08416996,779,17,486502,6575,No,No,11395
Minnesota,2021/3/4,67.08416996,940,14,487442,6589,No,No,11395
Mississippi,2020/3/1,62.37213932,0,0,0,0,No,No,1575
Mississippi,2020/3/2,62.37213932,0,0,0,0,No,No,1575
Mississippi,2020/3/3,62.37213932,0,0,0,0,No,No,1575
Mississippi,2020/3/4,62.37213932,0,0,0,0,No,No,1663
Mississippi,2020/3/5,62.37213932,0,0,0,0,No,No,1663
Mississippi,2020/3/6,62.37213932,0,0,0,0,No,No,1663
Mississippi,2020/3/7,62.37213932,0,0,0,0,No,No,1663
Mississippi,2020/3/8,62.37213932,0,0,0,0,No,No,1663
Mississippi,2020/3/9,62.37213932,0,0,0,0,No,No,1663
Mississippi,2020/3/10,62.37213932,0,0,0,0,No,No,1663
Mississippi,2020/3/11,62.37213932,1,0,1,0,No,No,1819
Mississippi,2020/3/12,62.37213932,0,0,1,0,No,No,1819
Mississippi,2020/3/13,62.37213932,5,0,6,0,No,No,1819
Mississippi,2020/3/14,62.37213932,0,0,6,0,No,No,1819
Mississippi,2020/3/15,62.37213932,4,0,10,0,No,No,1819
Mississippi,2020/3/16,62.37213932,2,0,12,0,No,No,1819
Mississippi,2020/3/17,62.37213932,9,0,21,0,No,No,1819
Mississippi,2020/3/18,62.37213932,13,0,34,0,No,No,10892
Mississippi,2020/3/19,62.37213932,16,1,50,1,No,No,10892
Mississippi,2020/3/20,62.37213932,30,0,80,1,No,No,10892
Mississippi,2020/3/21,62.37213932,60,0,140,1,No,No,10892
Mississippi,2020/3/22,62.37213932,67,0,207,1,No,No,10892
Mississippi,2020/3/23,62.37213932,42,0,249,1,No,No,10892
Mississippi,2020/3/24,62.37213932,71,0,320,1,No,No,10892
Mississippi,2020/3/25,62.37213932,56,4,376,5,No,No,80984
Mississippi,2020/3/26,62.37213932,110,1,486,6,No,No,80984
Mississippi,2020/3/27,62.37213932,93,2,579,8,No,No,80984
Mississippi,2020/3/28,62.37213932,90,5,669,13,No,No,80984
Mississippi,2020/3/29,62.37213932,90,1,759,14,No,No,80984
Mississippi,2020/3/30,62.37213932,89,2,848,16,No,No,80984
Mississippi,2020/3/31,62.37213932,89,4,937,20,No,No,80984
Mississippi,2020/4/1,62.37213932,136,2,1073,22,No,No,106739
Mississippi,2020/4/2,62.37213932,104,4,1177,26,No,No,106739
Mississippi,2020/4/3,62.37213932,181,3,1358,29,Yes,No,106739
Mississippi,2020/4/4,62.37213932,97,6,1455,35,Yes,No,106739
Mississippi,2020/4/5,62.37213932,183,8,1638,43,Yes,No,106739
Mississippi,2020/4/6,62.37213932,100,8,1738,51,Yes,No,106739
Mississippi,2020/4/7,62.37213932,177,8,1915,59,Yes,No,106739
Mississippi,2020/4/8,62.37213932,88,8,2003,67,Yes,No,77515
Mississippi,2020/4/9,62.37213932,257,9,2260,76,Yes,No,77515
Mississippi,2020/4/10,62.37213932,209,6,2469,82,Yes,No,77515
Mississippi,2020/4/11,62.37213932,173,11,2642,93,Yes,No,77515
Mississippi,2020/4/12,62.37213932,139,3,2781,96,Yes,No,77515
Mississippi,2020/4/13,62.37213932,161,2,2942,98,Yes,No,77515
Mississippi,2020/4/14,62.37213932,145,13,3087,111,Yes,No,77515
Mississippi,2020/4/15,62.37213932,273,11,3360,122,Yes,No,66432
Mississippi,2020/4/16,62.37213932,264,7,3624,129,Yes,No,66432
Mississippi,2020/4/17,62.37213932,169,11,3793,140,Yes,No,66432
Mississippi,2020/4/18,62.37213932,181,12,3974,152,Yes,No,66432
Mississippi,2020/4/19,62.37213932,300,7,4274,159,Yes,No,66432
Mississippi,2020/4/20,62.37213932,238,10,4512,169,Yes,No,66432
Mississippi,2020/4/21,62.37213932,204,14,4716,183,Yes,No,66432
Mississippi,2020/4/22,62.37213932,178,10,4894,193,Yes,No,74966
Mississippi,2020/4/23,62.37213932,259,8,5153,201,Yes,No,74966
Mississippi,2020/4/24,62.37213932,281,8,5434,209,Yes,No,74966
Mississippi,2020/4/25,62.37213932,284,12,5718,221,Yes,No,74966
Mississippi,2020/4/26,62.37213932,193,6,5911,227,Yes,No,74966
Mississippi,2020/4/27,62.37213932,183,2,6094,229,Yes,No,74966
Mississippi,2020/4/28,62.37213932,248,10,6342,239,No,No,74966
Mississippi,2020/4/29,62.37213932,227,11,6569,250,No,No,28985
Mississippi,2020/4/30,62.37213932,246,11,6815,261,No,No,28985
Mississippi,2020/5/1,62.37213932,397,20,7212,281,No,No,28985
Mississippi,2020/5/2,62.37213932,229,10,7441,291,No,No,28985
Mississippi,2020/5/3,62.37213932,109,12,7550,303,No,No,28985
Mississippi,2020/5/4,62.37213932,327,7,7877,310,No,No,28985
Mississippi,2020/5/5,62.37213932,330,32,8207,342,No,No,28985
Mississippi,2020/5/6,62.37213932,217,32,8424,374,No,No,26666
Mississippi,2020/5/7,62.37213932,262,22,8686,396,No,No,26666
Mississippi,2020/5/8,62.37213932,404,13,9090,409,No,No,26666
Mississippi,2020/5/9,62.37213932,288,12,9378,421,No,No,26666
Mississippi,2020/5/10,62.37213932,123,9,9501,430,No,No,26666
Mississippi,2020/5/11,62.37213932,173,5,9674,435,No,No,26666
Mississippi,2020/5/12,62.37213932,234,22,9908,457,No,No,26666
Mississippi,2020/5/13,62.37213932,182,8,10090,465,No,No,25150
Mississippi,2020/5/14,62.37213932,393,15,10483,480,No,No,25150
Mississippi,2020/5/15,62.37213932,318,13,10801,493,No,No,25150
Mississippi,2020/5/16,62.37213932,322,17,11123,510,No,No,25150
Mississippi,2020/5/17,62.37213932,173,11,11296,521,No,No,25150
Mississippi,2020/5/18,62.37213932,136,7,11432,528,No,No,25150
Mississippi,2020/5/19,62.37213932,272,26,11704,554,No,No,25150
Mississippi,2020/5/20,62.37213932,263,16,11967,570,No,No,27919
Mississippi,2020/5/21,62.37213932,255,10,12222,580,No,No,27919
Mississippi,2020/5/22,62.37213932,402,16,12624,596,No,No,27919
Mississippi,2020/5/23,62.37213932,381,20,13005,616,No,No,27919
Mississippi,2020/5/24,62.37213932,247,9,13252,625,No,No,27919
Mississippi,2020/5/25,62.37213932,206,10,13458,635,No,No,27919
Mississippi,2020/5/26,62.37213932,273,17,13731,652,No,No,27919
Mississippi,2020/5/27,62.37213932,313,18,14044,670,No,No,21335
Mississippi,2020/5/28,62.37213932,328,23,14372,693,No,No,21335
Mississippi,2020/5/29,62.37213932,418,17,14790,710,No,No,21335
Mississippi,2020/5/30,62.37213932,439,13,15229,723,No,No,21335
Mississippi,2020/5/31,62.37213932,272,11,15501,734,No,No,21335
Mississippi,2020/6/1,62.37213932,251,5,15752,739,No,No,21335
Mississippi,2020/6/2,62.37213932,268,28,16020,767,No,No,21335
Mississippi,2020/6/3,62.37213932,302,15,16322,782,No,No,19949
Mississippi,2020/6/4,62.37213932,238,12,16560,794,No,No,19949
Mississippi,2020/6/5,62.37213932,209,9,16769,803,No,No,19949
Mississippi,2020/6/6,62.37213932,265,8,17034,811,No,No,19949
Mississippi,2020/6/7,62.37213932,236,6,17270,817,No,No,19949
Mississippi,2020/6/8,62.37213932,498,20,17768,837,No,No,19949
Mississippi,2020/6/9,62.37213932,341,10,18109,847,No,No,19949
Mississippi,2020/6/10,62.37213932,374,21,18483,868,No,No,18367
Mississippi,2020/6/11,62.37213932,0,0,18483,868,No,No,18367
Mississippi,2020/6/12,62.37213932,608,13,19091,881,No,No,18367
Mississippi,2020/6/13,62.37213932,257,8,19348,889,No,No,18367
Mississippi,2020/6/14,62.37213932,168,2,19516,891,No,No,18367
Mississippi,2020/6/15,62.37213932,283,4,19799,895,No,No,18367
Mississippi,2020/6/16,62.37213932,353,20,20152,915,No,No,18367
Mississippi,2020/6/17,62.37213932,489,23,20641,938,No,No,18671
Mississippi,2020/6/18,62.37213932,381,5,21022,943,No,No,18671
Mississippi,2020/6/19,62.37213932,0,0,21022,943,No,No,18671
Mississippi,2020/6/20,62.37213932,0,0,21022,943,No,No,18671
Mississippi,2020/6/21,62.37213932,0,0,21022,943,No,No,18671
Mississippi,2020/6/22,62.37213932,1265,35,22287,978,No,No,18671
Mississippi,2020/6/23,62.37213932,611,11,22898,989,No,No,18671
Mississippi,2020/6/24,62.37213932,526,22,23424,1011,No,No,18338
Mississippi,2020/6/25,62.37213932,1092,5,24516,1016,No,No,18338
Mississippi,2020/6/26,62.37213932,550,6,25066,1022,No,No,18338
Mississippi,2020/6/27,62.37213932,465,13,25531,1035,No,No,18338
Mississippi,2020/6/28,62.37213932,368,4,25899,1039,No,No,18338
Mississippi,2020/6/29,62.37213932,669,20,26568,1059,No,No,18338
Mississippi,2020/6/30,62.37213932,680,14,27248,1073,No,No,18338
Mississippi,2020/7/1,62.37213932,652,9,27900,1082,No,No,19056
Mississippi,2020/7/2,62.37213932,870,10,28770,1092,No,No,19056
Mississippi,2020/7/3,62.37213932,914,11,29684,1103,No,No,19056
Mississippi,2020/7/4,62.37213932,990,4,30674,1107,No,No,19056
Mississippi,2020/7/5,62.37213932,226,4,30900,1111,No,No,19056
Mississippi,2020/7/6,62.37213932,357,3,31257,1114,No,No,19056
Mississippi,2020/7/7,62.37213932,957,44,32214,1158,No,No,19056
Mississippi,2020/7/8,62.37213932,674,30,32888,1188,No,No,20563
Mississippi,2020/7/9,62.37213932,703,16,33591,1204,No,No,20563
Mississippi,2020/7/10,62.37213932,1031,11,34622,1215,No,No,20563
Mississippi,2020/7/11,62.37213932,797,15,35419,1230,No,No,20563
Mississippi,2020/7/12,62.37213932,868,19,36287,1249,No,No,20563
Mississippi,2020/7/13,62.37213932,393,1,36680,1250,No,No,20563
Mississippi,2020/7/14,62.37213932,862,22,37542,1272,No,No,20563
Mississippi,2020/7/15,62.37213932,1025,18,38567,1290,No,No,23676
Mississippi,2020/7/16,62.37213932,1230,18,39797,1308,No,No,23676
Mississippi,2020/7/17,62.37213932,1032,24,40829,1332,No,No,23676
Mississippi,2020/7/18,62.37213932,1017,14,41846,1346,No,No,23676
Mississippi,2020/7/19,62.37213932,792,9,42638,1355,No,No,23676
Mississippi,2020/7/20,62.37213932,1251,3,43889,1358,No,No,23676
Mississippi,2020/7/21,62.37213932,1635,31,45524,1389,No,No,23676
Mississippi,2020/7/22,62.37213932,1547,34,47071,1423,No,No,17437
Mississippi,2020/7/23,62.37213932,982,13,48053,1436,No,No,17437
Mississippi,2020/7/24,62.37213932,1610,27,49663,1463,No,No,17437
Mississippi,2020/7/25,62.37213932,1434,17,51097,1480,No,No,17437
Mississippi,2020/7/26,62.37213932,1207,15,52304,1495,No,No,17437
Mississippi,2020/7/27,62.37213932,653,6,52957,1501,No,No,17437
Mississippi,2020/7/28,62.37213932,1342,42,54299,1543,No,No,17437
Mississippi,2020/7/29,62.37213932,1505,20,55804,1563,No,No,11690
Mississippi,2020/7/30,62.37213932,1775,48,57579,1611,No,No,11690
Mississippi,2020/7/31,62.37213932,1168,52,58747,1663,No,No,11690
Mississippi,2020/8/1,62.37213932,1134,30,59881,1693,No,No,11690
Mississippi,2020/8/2,62.37213932,672,10,60553,1703,No,No,11690
Mississippi,2020/8/3,62.37213932,572,8,61125,1711,No,No,11690
Mississippi,2020/8/4,62.37213932,1074,42,62199,1753,No,No,11690
Mississippi,2020/8/5,62.37213932,1245,51,63444,1804,No,Yes,9467
Mississippi,2020/8/6,62.37213932,956,21,64400,1825,No,Yes,9467
Mississippi,2020/8/7,62.37213932,1036,23,65436,1848,No,Yes,9467
Mississippi,2020/8/8,62.37213932,1210,26,66646,1874,No,Yes,9467
Mississippi,2020/8/9,62.37213932,527,22,67173,1896,No,Yes,9467
Mississippi,2020/8/10,62.37213932,476,16,67649,1912,No,Yes,9467
Mississippi,2020/8/11,62.37213932,644,32,68293,1944,No,Yes,9467
Mississippi,2020/8/12,62.37213932,1081,45,69374,1989,No,Yes,11047
Mississippi,2020/8/13,62.37213932,612,22,69986,2011,No,Yes,11047
Mississippi,2020/8/14,62.37213932,944,32,70930,2043,No,Yes,11047
Mississippi,2020/8/15,62.37213932,825,37,71755,2080,No,Yes,11047
Mississippi,2020/8/16,62.37213932,381,4,72136,2084,No,Yes,11047
Mississippi,2020/8/17,62.37213932,276,11,72412,2095,No,Yes,11047
Mississippi,2020/8/18,62.37213932,795,33,73207,2128,No,Yes,11047
Mississippi,2020/8/19,62.37213932,1348,35,74555,2163,No,Yes,8676
Mississippi,2020/8/20,62.37213932,894,27,75449,2190,No,Yes,8676
Mississippi,2020/8/21,62.37213932,874,24,76323,2214,No,Yes,8676
Mississippi,2020/8/22,62.37213932,945,23,77268,2237,No,Yes,8676
Mississippi,2020/8/23,62.37213932,626,3,77894,2240,No,Yes,8676
Mississippi,2020/8/24,62.37213932,511,8,78405,2248,No,Yes,8676
Mississippi,2020/8/25,62.37213932,801,67,79206,2315,No,Yes,8676
Mississippi,2020/8/26,62.37213932,904,58,80110,2373,No,Yes,8511
Mississippi,2020/8/27,62.37213932,585,26,80695,2399,No,Yes,8511
Mississippi,2020/8/28,62.37213932,599,14,81294,2413,No,Yes,8511
Mississippi,2020/8/29,62.37213932,735,14,82029,2427,No,Yes,8511
Mississippi,2020/8/30,62.37213932,647,14,82676,2441,No,Yes,8511
Mississippi,2020/8/31,62.37213932,274,32,82950,2473,No,Yes,8511
Mississippi,2020/9/1,62.37213932,634,20,83584,2493,No,No,8511
Mississippi,2020/9/2,62.37213932,781,33,84365,2526,No,No,8901
Mississippi,2020/9/3,62.37213932,751,10,85116,2536,No,No,8901
Mississippi,2020/9/4,62.37213932,823,22,85939,2558,No,No,8901
Mississippi,2020/9/5,62.37213932,539,11,86478,2569,No,No,8901
Mississippi,2020/9/6,62.37213932,410,15,86888,2584,No,No,8901
Mississippi,2020/9/7,62.37213932,242,1,87130,2585,No,No,8901
Mississippi,2020/9/8,62.37213932,249,0,87379,2585,No,No,8901
Mississippi,2020/9/9,62.37213932,426,38,87805,2623,No,No,8848
Mississippi,2020/9/10,62.37213932,517,33,88322,2656,No,No,8848
Mississippi,2020/9/11,62.37213932,853,14,89175,2670,No,No,8848
Mississippi,2020/9/12,62.37213932,445,15,89620,2685,No,No,8848
Mississippi,2020/9/13,62.37213932,254,12,89874,2697,No,No,8848
Mississippi,2020/9/14,62.37213932,144,9,90018,2706,No,No,8848
Mississippi,2020/9/15,62.37213932,505,28,90523,2734,No,No,8848
Mississippi,2020/9/16,62.37213932,711,22,91234,2756,No,No,8679
Mississippi,2020/9/17,62.37213932,701,24,91935,2780,No,No,8679
Mississippi,2020/9/18,62.37213932,497,12,92432,2792,No,No,8679
Mississippi,2020/9/19,62.37213932,655,17,93087,2809,No,No,8679
Mississippi,2020/9/20,62.37213932,277,1,93364,2810,No,No,8679
Mississippi,2020/9/21,62.37213932,192,0,93556,2810,No,No,8679
Mississippi,2020/9/22,62.37213932,465,36,94021,2846,No,No,8679
Mississippi,2020/9/23,62.37213932,552,24,94573,2870,No,No,8805
Mississippi,2020/9/24,62.37213932,737,4,95310,2874,No,No,8805
Mississippi,2020/9/25,62.37213932,722,20,96032,2894,No,No,8805
Mississippi,2020/9/26,62.37213932,645,17,96677,2911,No,No,8805
Mississippi,2020/9/27,62.37213932,182,8,96859,2919,No,No,8805
Mississippi,2020/9/28,62.37213932,190,2,97049,2921,No,No,8805
Mississippi,2020/9/29,62.37213932,589,36,97638,2957,No,No,8805
Mississippi,2020/9/30,62.37213932,552,12,98190,2969,No,No,7732
Mississippi,2020/10/1,62.37213932,696,10,98886,2979,No,No,7732
Mississippi,2020/10/2,62.37213932,672,20,99558,2999,No,No,7732
Mississippi,2020/10/3,62.37213932,609,12,100167,3011,No,No,7732
Mississippi,2020/10/4,62.37213932,321,2,100488,3013,No,No,7732
Mississippi,2020/10/5,62.37213932,215,0,100703,3013,No,No,7732
Mississippi,2020/10/6,62.37213932,975,14,101678,3027,No,No,7732
Mississippi,2020/10/7,62.37213932,563,24,102241,3051,No,No,8581
Mississippi,2020/10/8,62.37213932,578,23,102819,3074,No,No,8581
Mississippi,2020/10/9,62.37213932,862,6,103681,3080,No,No,8581
Mississippi,2020/10/10,62.37213932,957,16,104638,3096,No,No,8581
Mississippi,2020/10/11,62.37213932,294,5,104932,3101,No,No,8581
Mississippi,2020/10/12,62.37213932,296,0,105228,3101,No,No,8581
Mississippi,2020/10/13,62.37213932,713,14,105941,3115,No,No,8581
Mississippi,2020/10/14,62.37213932,876,25,106817,3140,No,No,7964
Mississippi,2020/10/15,62.37213932,1322,12,108139,3152,No,No,7964
Mississippi,2020/10/16,62.37213932,1116,8,109255,3160,No,No,7964
Mississippi,2020/10/17,62.37213932,751,11,110006,3171,No,No,7964
Mississippi,2020/10/18,62.37213932,233,0,110239,3171,No,No,7964
Mississippi,2020/10/19,62.37213932,353,0,110592,3171,No,No,7964
Mississippi,2020/10/20,62.37213932,730,31,111322,3202,No,No,7964
Mississippi,2020/10/21,62.37213932,801,21,112123,3223,No,No,7126
Mississippi,2020/10/22,62.37213932,958,8,113081,3231,No,No,7126
Mississippi,2020/10/23,62.37213932,795,7,113876,3238,No,No,7126
Mississippi,2020/10/24,62.37213932,1212,17,115088,3255,No,No,7126
Mississippi,2020/10/25,62.37213932,0,0,115088,3255,No,No,7126
Mississippi,2020/10/26,62.37213932,675,8,115763,3263,No,No,7126
Mississippi,2020/10/27,62.37213932,854,20,116617,3283,No,No,7126
Mississippi,2020/10/28,62.37213932,1000,19,117617,3302,No,No,7060
Mississippi,2020/10/29,62.37213932,970,8,118587,3310,No,No,7060
Mississippi,2020/10/30,62.37213932,749,18,119336,3328,No,No,7060
Mississippi,2020/10/31,62.37213932,824,6,120160,3334,No,No,7060
Mississippi,2020/11/1,62.37213932,340,14,120500,3348,No,No,7060
Mississippi,2020/11/2,62.37213932,365,0,120865,3348,No,No,7060
Mississippi,2020/11/3,62.37213932,644,36,121509,3384,No,No,7060
Mississippi,2020/11/4,62.37213932,766,13,122275,3397,No,No,8764
Mississippi,2020/11/5,62.37213932,1612,8,123887,3405,No,No,8764
Mississippi,2020/11/6,62.37213932,967,14,124854,3419,No,No,8764
Mississippi,2020/11/7,62.37213932,1031,14,125885,3433,No,No,8764
Mississippi,2020/11/8,62.37213932,804,10,126689,3443,No,No,8764
Mississippi,2020/11/9,62.37213932,516,0,127205,3443,No,No,8764
Mississippi,2020/11/10,62.37213932,933,37,128138,3480,No,No,8764
Mississippi,2020/11/11,62.37213932,1256,17,129394,3497,No,No,9262
Mississippi,2020/11/12,62.37213932,1271,17,130665,3514,No,No,9262
Mississippi,2020/11/13,62.37213932,1305,5,131970,3519,No,No,9262
Mississippi,2020/11/14,62.37213932,1370,21,133340,3540,No,No,9262
Mississippi,2020/11/15,62.37213932,969,3,134309,3543,No,No,9262
Mississippi,2020/11/16,62.37213932,589,2,134898,3545,No,No,9262
Mississippi,2020/11/17,62.37213932,905,36,135803,3581,No,No,9262
Mississippi,2020/11/18,62.37213932,1593,20,137396,3601,No,No,11813
Mississippi,2020/11/19,62.37213932,1395,18,138791,3619,No,No,11813
Mississippi,2020/11/20,62.37213932,1638,23,140429,3642,No,No,11813
Mississippi,2020/11/21,62.37213932,1972,15,142401,3657,No,No,11813
Mississippi,2020/11/22,62.37213932,779,19,143180,3676,No,No,11813
Mississippi,2020/11/23,62.37213932,699,0,143879,3676,No,No,11813
Mississippi,2020/11/24,62.37213932,665,53,144544,3729,No,No,11813
Mississippi,2020/11/25,62.37213932,1092,16,145636,3745,No,No,7061
Mississippi,2020/11/26,62.37213932,1746,18,147382,3763,No,No,7061
Mississippi,2020/11/27,62.37213932,1005,6,148387,3769,No,No,7061
Mississippi,2020/11/28,62.37213932,1553,10,149940,3779,No,No,7061
Mississippi,2020/11/29,62.37213932,1845,27,151785,3806,No,No,7061
Mississippi,2020/11/30,62.37213932,1485,1,153270,3807,No,No,7061
Mississippi,2020/12/1,62.37213932,1141,29,154411,3836,No,No,7061
Mississippi,2020/12/2,62.37213932,2457,15,156868,3851,No,No,7656
Mississippi,2020/12/3,62.37213932,2168,28,159036,3879,No,No,7656
Mississippi,2020/12/4,62.37213932,2480,37,161516,3916,No,No,7656
Mississippi,2020/12/5,62.37213932,1942,33,163458,3949,No,No,7656
Mississippi,2020/12/6,62.37213932,1473,12,164931,3961,No,No,7656
Mississippi,2020/12/7,62.37213932,1263,0,166194,3961,No,No,7656
Mississippi,2020/12/8,62.37213932,1732,56,167926,4017,No,No,7656
Mississippi,2020/12/9,62.37213932,2746,24,170672,4041,No,No,7568
Mississippi,2020/12/10,62.37213932,2283,42,172955,4083,No,No,7568
Mississippi,2020/12/11,62.37213932,2327,41,175282,4124,No,No,7568
Mississippi,2020/12/12,62.37213932,2665,56,177947,4180,No,No,7568
Mississippi,2020/12/13,62.37213932,1500,19,179447,4199,No,No,7568
Mississippi,2020/12/14,62.37213932,1648,5,181095,4204,No,No,7568
Mississippi,2020/12/15,62.37213932,2205,48,183300,4252,No,No,7568
Mississippi,2020/12/16,62.37213932,2343,42,185643,4294,No,No,7543
Mississippi,2020/12/17,62.37213932,2261,26,187904,4320,No,No,7543
Mississippi,2020/12/18,62.37213932,2507,34,190411,4354,No,No,7543
Mississippi,2020/12/19,62.37213932,1700,36,192111,4390,No,No,7543
Mississippi,2020/12/20,62.37213932,2222,19,194333,4409,No,No,7543
Mississippi,2020/12/21,62.37213932,1167,2,195500,4411,No,No,7543
Mississippi,2020/12/22,62.37213932,2191,79,197691,4490,No,No,7543
Mississippi,2020/12/23,62.37213932,2634,43,200325,4533,No,No,5506
Mississippi,2020/12/24,62.37213932,2326,23,202651,4556,No,No,5506
Mississippi,2020/12/25,62.37213932,1527,6,204178,4562,No,No,5506
Mississippi,2020/12/26,62.37213932,845,3,205023,4565,No,No,5506
Mississippi,2020/12/27,62.37213932,1365,41,206388,4606,No,No,5506
Mississippi,2020/12/28,62.37213932,1701,28,208089,4634,No,No,5506
Mississippi,2020/12/29,62.37213932,1943,85,210032,4719,No,No,5506
Mississippi,2020/12/30,62.37213932,3023,28,213055,4747,No,No,10986
Mississippi,2020/12/31,62.37213932,2756,40,215811,4787,No,No,10986
Mississippi,2021/1/1,62.37213932,2575,29,218386,4816,No,No,10986
Mississippi,2021/1/2,62.37213932,1891,24,220277,4840,No,No,10986
Mississippi,2021/1/3,62.37213932,1784,31,222061,4871,No,No,10986
Mississippi,2021/1/4,62.37213932,1616,13,223677,4884,No,No,10986
Mississippi,2021/1/5,62.37213932,1767,91,225444,4975,No,No,10986
Mississippi,2021/1/6,62.37213932,2791,38,228235,5013,No,No,14084
Mississippi,2021/1/7,62.37213932,3255,48,231490,5061,No,No,14084
Mississippi,2021/1/8,62.37213932,2175,40,233665,5101,No,No,14084
Mississippi,2021/1/9,62.37213932,3203,45,236868,5146,No,No,14084
Mississippi,2021/1/10,62.37213932,2214,21,239082,5167,No,No,14084
Mississippi,2021/1/11,62.37213932,1227,19,240309,5186,No,No,14084
Mississippi,2021/1/12,62.37213932,1648,98,241957,5284,No,No,14084
Mississippi,2021/1/13,62.37213932,1942,31,243899,5315,No,No,11980
Mississippi,2021/1/14,62.37213932,1948,41,245847,5356,No,No,11980
Mississippi,2021/1/15,62.37213932,2342,55,248189,5411,No,No,11980
Mississippi,2021/1/16,62.37213932,2680,70,250869,5481,No,No,11980
Mississippi,2021/1/17,62.37213932,1606,40,252475,5521,No,No,11980
Mississippi,2021/1/18,62.37213932,1457,3,253932,5524,No,No,11980
Mississippi,2021/1/19,62.37213932,1193,50,255125,5574,No,No,11980
Mississippi,2021/1/20,62.37213932,1702,64,256827,5638,No,No,11615
Mississippi,2021/1/21,62.37213932,2290,30,259117,5668,No,No,11615
Mississippi,2021/1/22,62.37213932,2050,45,261167,5713,No,No,11615
Mississippi,2021/1/23,62.37213932,1856,39,263023,5752,No,No,11615
Mississippi,2021/1/24,62.37213932,1196,20,264219,5772,No,No,11615
Mississippi,2021/1/25,62.37213932,927,5,265146,5777,No,No,11615
Mississippi,2021/1/26,62.37213932,1452,75,266598,5852,No,No,11615
Mississippi,2021/1/27,62.37213932,2074,65,268672,5917,No,No,12664
Mississippi,2021/1/28,62.37213932,1804,28,270476,5945,No,No,12664
Mississippi,2021/1/29,62.37213932,2186,38,272662,5983,No,No,12664
Mississippi,2021/1/30,62.37213932,1528,35,274190,6018,No,No,12664
Mississippi,2021/1/31,62.37213932,811,27,275001,6045,No,No,12664
Mississippi,2021/2/1,62.37213932,705,11,275706,6056,No,No,12664
Mississippi,2021/2/2,62.37213932,825,76,276531,6132,No,No,12664
Mississippi,2021/2/3,62.37213932,791,26,277322,6158,No,No,13464
Mississippi,2021/2/4,62.37213932,1210,24,278532,6182,No,No,13464
Mississippi,2021/2/5,62.37213932,1210,40,279742,6222,No,No,13464
Mississippi,2021/2/6,62.37213932,1036,44,280778,6266,No,No,13464
Mississippi,2021/2/7,62.37213932,900,3,281678,6269,No,No,13464
Mississippi,2021/2/8,62.37213932,635,1,282313,6270,No,No,13464
Mississippi,2021/2/9,62.37213932,656,72,282969,6342,No,No,13464
Mississippi,2021/2/10,62.37213932,784,25,283753,6367,No,No,12087
Mississippi,2021/2/11,62.37213932,911,23,284664,6390,No,No,12087
Mississippi,2021/2/12,62.37213932,984,39,285648,6429,No,No,12087
Mississippi,2021/2/13,62.37213932,695,32,286343,6461,No,No,12087
Mississippi,2021/2/14,62.37213932,1093,1,287436,6462,No,No,12087
Mississippi,2021/2/15,62.37213932,544,2,287980,6464,No,No,12087
Mississippi,2021/2/16,62.37213932,734,37,288714,6501,No,No,12087
Mississippi,2021/2/17,62.37213932,684,23,289398,6524,No,No,11395
Mississippi,2021/2/18,62.37213932,134,7,289532,6531,No,No,11395
Mississippi,2021/2/19,62.37213932,360,3,289892,6534,No,No,11395
Mississippi,2021/2/20,62.37213932,350,19,290242,6553,No,No,11395
Mississippi,2021/2/21,62.37213932,390,0,290632,6553,No,No,11395
Mississippi,2021/2/22,62.37213932,242,0,290874,6553,No,No,11395
Mississippi,2021/2/23,62.37213932,348,24,291222,6577,No,No,11395
Mississippi,2021/2/24,62.37213932,669,28,291891,6605,No,No,11395
Mississippi,2021/2/25,62.37213932,920,8,292811,6613,No,No,11395
Mississippi,2021/2/26,62.37213932,731,25,293542,6638,No,No,11395
Mississippi,2021/2/27,62.37213932,549,31,294091,6669,No,No,11395
Mississippi,2021/2/28,62.37213932,704,12,294795,6681,No,No,11395
Mississippi,2021/3/1,62.37213932,199,0,294994,6681,No,No,11395
Mississippi,2021/3/2,62.37213932,301,43,295295,6724,No,No,11395
Mississippi,2021/3/3,62.37213932,380,19,295675,6743,No,No,11395
Mississippi,2021/3/4,62.37213932,479,21,296154,6764,No,No,11395
Missouri,2020/3/1,88.07261143,0,0,0,0,No,No,1575
Missouri,2020/3/2,88.07261143,0,0,0,0,No,No,1575
Missouri,2020/3/3,88.07261143,0,0,0,0,No,No,1575
Missouri,2020/3/4,88.07261143,0,0,0,0,No,No,1663
Missouri,2020/3/5,88.07261143,0,0,0,0,No,No,1663
Missouri,2020/3/6,88.07261143,0,0,0,0,No,No,1663
Missouri,2020/3/7,88.07261143,1,0,1,0,No,No,1663
Missouri,2020/3/8,88.07261143,0,0,1,0,No,No,1663
Missouri,2020/3/9,88.07261143,0,0,1,0,No,No,1663
Missouri,2020/3/10,88.07261143,0,0,1,0,No,No,1663
Missouri,2020/3/11,88.07261143,0,0,1,0,No,No,1819
Missouri,2020/3/12,88.07261143,1,0,2,0,No,No,1819
Missouri,2020/3/13,88.07261143,2,0,4,0,No,No,1819
Missouri,2020/3/14,88.07261143,1,0,5,0,No,No,1819
Missouri,2020/3/15,88.07261143,0,0,5,0,No,No,1819
Missouri,2020/3/16,88.07261143,4,0,9,0,No,No,1819
Missouri,2020/3/17,88.07261143,7,0,16,0,No,No,1819
Missouri,2020/3/18,88.07261143,5,1,21,1,No,No,10892
Missouri,2020/3/19,88.07261143,14,0,35,1,No,No,10892
Missouri,2020/3/20,88.07261143,38,2,73,3,No,No,10892
Missouri,2020/3/21,88.07261143,20,0,93,3,No,No,10892
Missouri,2020/3/22,88.07261143,37,0,130,3,No,No,10892
Missouri,2020/3/23,88.07261143,53,1,183,4,No,No,10892
Missouri,2020/3/24,88.07261143,72,1,255,5,No,No,10892
Missouri,2020/3/25,88.07261143,129,3,384,8,No,No,80984
Missouri,2020/3/26,88.07261143,124,0,508,8,No,No,80984
Missouri,2020/3/27,88.07261143,162,1,670,9,No,No,80984
Missouri,2020/3/28,88.07261143,167,2,837,11,No,No,80984
Missouri,2020/3/29,88.07261143,65,1,902,12,No,No,80984
Missouri,2020/3/30,88.07261143,147,1,1049,13,No,No,80984
Missouri,2020/3/31,88.07261143,301,2,1350,15,No,No,80984
Missouri,2020/4/1,88.07261143,230,6,1580,21,No,No,106739
Missouri,2020/4/2,88.07261143,254,7,1834,28,No,No,106739
Missouri,2020/4/3,88.07261143,279,8,2113,36,No,No,106739
Missouri,2020/4/4,88.07261143,178,8,2291,44,No,No,106739
Missouri,2020/4/5,88.07261143,76,8,2367,52,No,No,106739
Missouri,2020/4/6,88.07261143,355,4,2722,56,Yes,No,106739
Missouri,2020/4/7,88.07261143,315,24,3037,80,Yes,No,106739
Missouri,2020/4/8,88.07261143,290,6,3327,86,Yes,No,77515
Missouri,2020/4/9,88.07261143,212,8,3539,94,Yes,No,77515
Missouri,2020/4/10,88.07261143,260,11,3799,105,Yes,No,77515
Missouri,2020/4/11,88.07261143,225,11,4024,116,Yes,No,77515
Missouri,2020/4/12,88.07261143,136,0,4160,116,Yes,No,77515
Missouri,2020/4/13,88.07261143,228,20,4388,136,Yes,No,77515
Missouri,2020/4/14,88.07261143,298,15,4686,151,Yes,No,77515
Missouri,2020/4/15,88.07261143,209,13,4895,164,Yes,No,66432
Missouri,2020/4/16,88.07261143,216,6,5111,170,Yes,No,66432
Missouri,2020/4/17,88.07261143,172,14,5283,184,Yes,No,66432
Missouri,2020/4/18,88.07261143,234,10,5517,194,Yes,No,66432
Missouri,2020/4/19,88.07261143,150,2,5667,196,Yes,No,66432
Missouri,2020/4/20,88.07261143,140,5,5807,201,Yes,No,66432
Missouri,2020/4/21,88.07261143,134,20,5941,221,Yes,No,66432
Missouri,2020/4/22,88.07261143,196,15,6137,236,Yes,No,74966
Missouri,2020/4/23,88.07261143,184,12,6321,248,Yes,No,74966
Missouri,2020/4/24,88.07261143,304,19,6625,267,Yes,No,74966
Missouri,2020/4/25,88.07261143,201,13,6826,280,Yes,No,74966
Missouri,2020/4/26,88.07261143,171,2,6997,282,Yes,No,74966
Missouri,2020/4/27,88.07261143,174,14,7171,296,Yes,No,74966
Missouri,2020/4/28,88.07261143,135,28,7306,324,Yes,No,74966
Missouri,2020/4/29,88.07261143,120,7,7426,331,Yes,No,28985
Missouri,2020/4/30,88.07261143,137,10,7563,341,Yes,No,28985
Missouri,2020/5/1,88.07261143,277,14,7840,355,Yes,No,28985
Missouri,2020/5/2,88.07261143,314,18,8154,373,Yes,No,28985
Missouri,2020/5/3,88.07261143,300,5,8454,378,Yes,No,28985
Missouri,2020/5/4,88.07261143,322,9,8776,387,No,No,28985
Missouri,2020/5/5,88.07261143,143,21,8919,408,No,No,28985
Missouri,2020/5/6,88.07261143,245,21,9164,429,No,No,26666
Missouri,2020/5/7,88.07261143,245,20,9409,449,No,No,26666
Missouri,2020/5/8,88.07261143,164,32,9573,481,No,No,26666
Missouri,2020/5/9,88.07261143,164,11,9737,492,No,No,26666
Missouri,2020/5/10,88.07261143,169,10,9906,502,No,No,26666
Missouri,2020/5/11,88.07261143,119,10,10025,512,No,No,26666
Missouri,2020/5/12,88.07261143,99,16,10124,528,No,No,26666
Missouri,2020/5/13,88.07261143,245,20,10369,548,No,No,25150
Missouri,2020/5/14,88.07261143,121,16,10490,564,No,No,25150
Missouri,2020/5/15,88.07261143,77,15,10567,579,No,No,25150
Missouri,2020/5/16,88.07261143,227,14,10794,593,No,No,25150
Missouri,2020/5/17,88.07261143,275,8,11069,601,No,No,25150
Missouri,2020/5/18,88.07261143,156,8,11225,609,No,No,25150
Missouri,2020/5/19,88.07261143,144,22,11369,631,No,No,25150
Missouri,2020/5/20,88.07261143,141,12,11510,643,No,No,27919
Missouri,2020/5/21,88.07261143,147,27,11657,670,No,No,27919
Missouri,2020/5/22,88.07261143,140,10,11797,680,No,No,27919
Missouri,2020/5/23,88.07261143,125,5,11922,685,No,No,27919
Missouri,2020/5/24,88.07261143,192,4,12114,689,No,No,27919
Missouri,2020/5/25,88.07261143,182,5,12296,694,No,No,27919
Missouri,2020/5/26,88.07261143,141,4,12437,698,No,No,27919
Missouri,2020/5/27,88.07261143,187,7,12624,705,No,No,21335
Missouri,2020/5/28,88.07261143,191,10,12815,715,No,No,21335
Missouri,2020/5/29,88.07261143,134,25,12949,740,No,No,21335
Missouri,2020/5/30,88.07261143,169,42,13118,782,No,No,21335
Missouri,2020/5/31,88.07261143,179,2,13297,784,No,No,21335
Missouri,2020/6/1,88.07261143,226,2,13523,786,No,No,21335
Missouri,2020/6/2,88.07261143,299,11,13822,797,No,No,21335
Missouri,2020/6/3,88.07261143,198,4,14020,801,No,No,19949
Missouri,2020/6/4,88.07261143,266,5,14286,806,No,No,19949
Missouri,2020/6/5,88.07261143,229,10,14515,816,No,No,19949
Missouri,2020/6/6,88.07261143,144,7,14659,823,No,No,19949
Missouri,2020/6/7,88.07261143,326,0,14985,823,No,No,19949
Missouri,2020/6/8,88.07261143,174,9,15159,832,No,No,19949
Missouri,2020/6/9,88.07261143,237,22,15396,854,No,No,19949
Missouri,2020/6/10,88.07261143,266,7,15662,861,No,No,18367
Missouri,2020/6/11,88.07261143,262,12,15924,873,No,No,18367
Missouri,2020/6/12,88.07261143,187,11,16111,884,No,No,18367
Missouri,2020/6/13,88.07261143,216,6,16327,890,No,No,18367
Missouri,2020/6/14,88.07261143,57,0,16384,890,No,No,18367
Missouri,2020/6/15,88.07261143,328,5,16712,895,No,No,18367
Missouri,2020/6/16,88.07261143,218,8,16930,903,No,No,18367
Missouri,2020/6/17,88.07261143,221,21,17151,924,No,No,18671
Missouri,2020/6/18,88.07261143,337,39,17488,963,No,No,18671
Missouri,2020/6/19,88.07261143,292,10,17780,973,No,No,18671
Missouri,2020/6/20,88.07261143,375,2,18155,975,No,No,18671
Missouri,2020/6/21,88.07261143,397,0,18552,975,No,No,18671
Missouri,2020/6/22,88.07261143,181,5,18733,980,No,No,18671
Missouri,2020/6/23,88.07261143,415,13,19148,993,No,No,18671
Missouri,2020/6/24,88.07261143,330,8,19478,1001,No,No,18338
Missouri,2020/6/25,88.07261143,598,5,20076,1006,No,No,18338
Missouri,2020/6/26,88.07261143,491,13,20567,1019,No,No,18338
Missouri,2020/6/27,88.07261143,342,2,20909,1021,No,No,18338
Missouri,2020/6/28,88.07261143,345,2,21254,1023,No,No,18338
Missouri,2020/6/29,88.07261143,494,3,21748,1026,No,No,18338
Missouri,2020/6/30,88.07261143,527,11,22275,1037,No,No,18338
Missouri,2020/7/1,88.07261143,320,12,22595,1049,No,No,19056
Missouri,2020/7/2,88.07261143,490,7,23085,1056,No,No,19056
Missouri,2020/7/3,88.07261143,535,4,23620,1060,No,No,19056
Missouri,2020/7/4,88.07261143,441,2,24061,1062,No,No,19056
Missouri,2020/7/5,88.07261143,273,0,24334,1062,No,No,19056
Missouri,2020/7/6,88.07261143,516,6,24850,1068,No,No,19056
Missouri,2020/7/7,88.07261143,716,15,25566,1083,No,No,19056
Missouri,2020/7/8,88.07261143,777,6,26343,1089,No,No,20563
Missouri,2020/7/9,88.07261143,958,6,27301,1095,No,No,20563
Missouri,2020/7/10,88.07261143,759,12,28060,1107,No,No,20563
Missouri,2020/7/11,88.07261143,589,5,28649,1112,No,No,20563
Missouri,2020/7/12,88.07261143,524,1,29173,1113,No,No,20563
Missouri,2020/7/13,88.07261143,608,13,29781,1126,No,No,20563
Missouri,2020/7/14,88.07261143,1036,10,30817,1136,No,No,20563
Missouri,2020/7/15,88.07261143,920,5,31737,1141,No,No,23676
Missouri,2020/7/16,88.07261143,859,4,32596,1145,No,No,23676
Missouri,2020/7/17,88.07261143,940,6,33536,1151,No,No,23676
Missouri,2020/7/18,88.07261143,827,7,34363,1158,No,No,23676
Missouri,2020/7/19,88.07261143,791,0,35154,1158,No,No,23676
Missouri,2020/7/20,88.07261143,890,6,36044,1164,No,No,23676
Missouri,2020/7/21,88.07261143,1204,11,37248,1175,No,No,23676
Missouri,2020/7/22,88.07261143,1206,21,38454,1196,No,No,17437
Missouri,2020/7/23,88.07261143,1469,16,39923,1212,No,No,17437
Missouri,2020/7/24,88.07261143,1301,9,41224,1221,No,No,17437
Missouri,2020/7/25,88.07261143,1086,3,42310,1224,No,No,17437
Missouri,2020/7/26,88.07261143,1167,7,43477,1231,No,No,17437
Missouri,2020/7/27,88.07261143,1336,14,44813,1245,No,No,17437
Missouri,2020/7/28,88.07261143,1412,18,46225,1263,No,No,17437
Missouri,2020/7/29,88.07261143,1458,6,47683,1269,No,No,11690
Missouri,2020/7/30,88.07261143,1988,19,49671,1288,No,No,11690
Missouri,2020/7/31,88.07261143,1403,17,51074,1305,No,No,11690
Missouri,2020/8/1,88.07261143,938,6,52012,1311,No,No,11690
Missouri,2020/8/2,88.07261143,565,0,52577,1311,No,No,11690
Missouri,2020/8/3,88.07261143,1099,5,53676,1316,No,No,11690
Missouri,2020/8/4,88.07261143,1214,14,54890,1330,No,No,11690
Missouri,2020/8/5,88.07261143,1061,7,55951,1337,No,No,9467
Missouri,2020/8/6,88.07261143,1224,12,57175,1349,No,No,9467
Missouri,2020/8/7,88.07261143,1146,25,58321,1374,No,No,9467
Missouri,2020/8/8,88.07261143,389,7,58710,1381,No,No,9467
Missouri,2020/8/9,88.07261143,1185,5,59895,1386,No,No,9467
Missouri,2020/8/10,88.07261143,987,11,60882,1397,No,No,9467
Missouri,2020/8/11,88.07261143,1067,5,61949,1402,No,No,9467
Missouri,2020/8/12,88.07261143,1423,6,63372,1408,No,No,11047
Missouri,2020/8/13,88.07261143,1561,9,64933,1417,No,No,11047
Missouri,2020/8/14,88.07261143,1372,8,66305,1425,No,No,11047
Missouri,2020/8/15,88.07261143,1137,6,67442,1431,No,No,11047
Missouri,2020/8/16,88.07261143,1051,5,68493,1436,No,No,11047
Missouri,2020/8/17,88.07261143,1395,32,69888,1468,No,No,11047
Missouri,2020/8/18,88.07261143,871,9,70759,1477,No,No,11047
Missouri,2020/8/19,88.07261143,1043,13,71802,1490,No,No,8676
Missouri,2020/8/20,88.07261143,1110,18,72912,1508,No,No,8676
Missouri,2020/8/21,88.07261143,1309,3,74221,1511,No,No,8676
Missouri,2020/8/22,88.07261143,1247,8,75468,1519,No,No,8676
Missouri,2020/8/23,88.07261143,871,0,76339,1519,No,No,8676
Missouri,2020/8/24,88.07261143,915,14,77254,1533,No,No,8676
Missouri,2020/8/25,88.07261143,992,20,78246,1553,No,No,8676
Missouri,2020/8/26,88.07261143,1342,13,79588,1566,No,No,8511
Missouri,2020/8/27,88.07261143,1325,17,80913,1583,No,No,8511
Missouri,2020/8/28,88.07261143,1536,16,82449,1599,No,No,8511
Missouri,2020/8/29,88.07261143,1524,14,83973,1613,No,No,8511
Missouri,2020/8/30,88.07261143,1160,2,85133,1615,No,No,8511
Missouri,2020/8/31,88.07261143,1195,8,86328,1623,No,No,8511
Missouri,2020/9/1,88.07261143,1086,28,87414,1651,No,No,8511
Missouri,2020/9/2,88.07261143,1560,18,88974,1669,No,No,8901
Missouri,2020/9/3,88.07261143,1418,11,90392,1680,No,No,8901
Missouri,2020/9/4,88.07261143,1602,18,91994,1698,No,No,8901
Missouri,2020/9/5,88.07261143,1719,30,93713,1728,No,No,8901
Missouri,2020/9/6,88.07261143,1210,11,94923,1739,No,No,8901
Missouri,2020/9/7,88.07261143,872,0,95795,1739,No,No,8901
Missouri,2020/9/8,88.07261143,1249,7,97044,1746,No,No,8901
Missouri,2020/9/9,88.07261143,1402,9,98446,1755,No,No,8848
Missouri,2020/9/10,88.07261143,1231,18,99677,1773,No,No,8848
Missouri,2020/9/11,88.07261143,1608,11,101285,1784,No,No,8848
Missouri,2020/9/12,88.07261143,1800,18,103085,1802,No,No,8848
Missouri,2020/9/13,88.07261143,1518,10,104603,1812,No,No,8848
Missouri,2020/9/14,88.07261143,1454,0,106057,1812,No,No,8848
Missouri,2020/9/15,88.07261143,1630,18,107687,1830,No,No,8848
Missouri,2020/9/16,88.07261143,1310,14,108997,1844,No,No,8679
Missouri,2020/9/17,88.07261143,1557,20,110554,1864,No,No,8679
Missouri,2020/9/18,88.07261143,1993,28,112547,1892,No,No,8679
Missouri,2020/9/19,88.07261143,1247,13,113794,1905,No,No,8679
Missouri,2020/9/20,88.07261143,1206,-9,115000,1896,No,No,8679
Missouri,2020/9/21,88.07261143,1814,40,116814,1936,No,No,8679
Missouri,2020/9/22,88.07261143,1760,38,118574,1974,No,No,8679
Missouri,2020/9/23,88.07261143,1550,61,120124,2035,No,No,8805
Missouri,2020/9/24,88.07261143,1361,20,121485,2055,No,No,8805
Missouri,2020/9/25,88.07261143,2059,20,123544,2075,No,No,8805
Missouri,2020/9/26,88.07261143,1395,43,124939,2118,No,No,8805
Missouri,2020/9/27,88.07261143,1176,-1,126115,2117,No,No,8805
Missouri,2020/9/28,88.07261143,1779,15,127894,2132,No,No,8805
Missouri,2020/9/29,88.07261143,922,16,128816,2148,No,No,8805
Missouri,2020/9/30,88.07261143,1249,9,130065,2157,No,No,7732
Missouri,2020/10/1,88.07261143,1713,27,131778,2184,No,No,7732
Missouri,2020/10/2,88.07261143,1947,23,133725,2207,No,No,7732
Missouri,2020/10/3,88.07261143,1101,13,134826,2220,No,No,7732
Missouri,2020/10/4,88.07261143,865,0,135691,2220,No,No,7732
Missouri,2020/10/5,88.07261143,1606,9,137297,2229,No,No,7732
Missouri,2020/10/6,88.07261143,1875,29,139172,2258,No,No,7732
Missouri,2020/10/7,88.07261143,2090,76,141262,2334,No,No,8581
Missouri,2020/10/8,88.07261143,1470,26,142732,2360,No,No,8581
Missouri,2020/10/9,88.07261143,2302,103,145034,2463,No,No,8581
Missouri,2020/10/10,88.07261143,3165,20,148199,2483,No,No,8581
Missouri,2020/10/11,88.07261143,282,0,148481,2483,No,No,8581
Missouri,2020/10/12,88.07261143,979,1,149460,2484,No,No,8581
Missouri,2020/10/13,88.07261143,1036,11,150496,2495,No,No,8581
Missouri,2020/10/14,88.07261143,3717,103,154213,2598,No,No,7964
Missouri,2020/10/15,88.07261143,1929,-67,156142,2531,No,No,7964
Missouri,2020/10/16,88.07261143,2622,19,158764,2550,No,No,7964
Missouri,2020/10/17,88.07261143,1890,95,160654,2645,No,No,7964
Missouri,2020/10/18,88.07261143,1502,3,162156,2648,No,No,7964
Missouri,2020/10/19,88.07261143,2093,12,164249,2660,No,No,7964
Missouri,2020/10/20,88.07261143,642,8,164891,2668,No,No,7964
Missouri,2020/10/21,88.07261143,2544,48,167435,2716,No,No,7126
Missouri,2020/10/22,88.07261143,1876,18,169311,2734,No,No,7126
Missouri,2020/10/23,88.07261143,2560,30,171871,2764,No,No,7126
Missouri,2020/10/24,88.07261143,1875,90,173746,2854,No,No,7126
Missouri,2020/10/25,88.07261143,1497,3,175243,2857,No,No,7126
Missouri,2020/10/26,88.07261143,2490,12,177733,2869,No,No,7126
Missouri,2020/10/27,88.07261143,1724,43,179457,2912,No,No,7126
Missouri,2020/10/28,88.07261143,2420,28,181877,2940,No,No,7060
Missouri,2020/10/29,88.07261143,2970,38,184847,2978,No,No,7060
Missouri,2020/10/30,88.07261143,2983,36,187830,3014,No,No,7060
Missouri,2020/10/31,88.07261143,2095,76,189925,3090,No,No,7060
Missouri,2020/11/1,88.07261143,2216,1,192141,3091,No,No,7060
Missouri,2020/11/2,88.07261143,3797,10,195938,3101,No,No,7060
Missouri,2020/11/3,88.07261143,2374,35,198312,3136,No,No,7060
Missouri,2020/11/4,88.07261143,3203,30,201515,3166,No,No,8764
Missouri,2020/11/5,88.07261143,3521,31,205036,3197,No,No,8764
Missouri,2020/11/6,88.07261143,5018,20,210054,3217,No,No,8764
Missouri,2020/11/7,88.07261143,3591,18,213645,3235,No,No,8764
Missouri,2020/11/8,88.07261143,3009,3,216654,3238,No,No,8764
Missouri,2020/11/9,88.07261143,5220,3,221874,3241,No,No,8764
Missouri,2020/11/10,88.07261143,4498,134,226372,3375,No,No,8764
Missouri,2020/11/11,88.07261143,3631,36,230003,3411,No,No,9262
Missouri,2020/11/12,88.07261143,5338,30,235341,3441,No,No,9262
Missouri,2020/11/13,88.07261143,5895,11,241236,3452,No,No,9262
Missouri,2020/11/14,88.07261143,7164,11,248400,3463,No,No,9262
Missouri,2020/11/15,88.07261143,1208,0,249608,3463,No,No,9262
Missouri,2020/11/16,88.07261143,6334,22,255942,3485,No,No,9262
Missouri,2020/11/17,88.07261143,5163,67,261105,3552,No,No,9262
Missouri,2020/11/18,88.07261143,4974,39,266079,3591,No,No,11813
Missouri,2020/11/19,88.07261143,4308,27,270387,3618,No,No,11813
Missouri,2020/11/20,88.07261143,5530,57,275917,3675,No,No,11813
Missouri,2020/11/21,88.07261143,4070,9,279987,3684,No,No,11813
Missouri,2020/11/22,88.07261143,3769,4,283756,3688,No,No,11813
Missouri,2020/11/23,88.07261143,4552,9,288308,3697,No,No,11813
Missouri,2020/11/24,88.07261143,4478,172,292786,3869,No,No,11813
Missouri,2020/11/25,88.07261143,4588,39,297374,3908,No,No,7061
Missouri,2020/11/26,88.07261143,3451,24,300825,3932,No,No,7061
Missouri,2020/11/27,88.07261143,3409,11,304234,3943,No,No,7061
Missouri,2020/11/28,88.07261143,2292,7,306526,3950,No,No,7061
Missouri,2020/11/29,88.07261143,2894,6,309420,3956,No,No,7061
Missouri,2020/11/30,88.07261143,5561,25,314981,3981,No,No,7061
Missouri,2020/12/1,88.07261143,2922,149,317903,4130,No,No,7061
Missouri,2020/12/2,88.07261143,3508,55,321411,4185,No,No,7656
Missouri,2020/12/3,88.07261143,4108,89,325519,4274,No,No,7656
Missouri,2020/12/4,88.07261143,4926,101,330445,4375,No,No,7656
Missouri,2020/12/5,88.07261143,4192,37,334637,4412,No,No,7656
Missouri,2020/12/6,88.07261143,3290,8,337927,4420,No,No,7656
Missouri,2020/12/7,88.07261143,4317,32,342244,4452,No,No,7656
Missouri,2020/12/8,88.07261143,3917,142,346161,4594,No,No,7656
Missouri,2020/12/9,88.07261143,2885,46,349046,4640,No,No,7568
Missouri,2020/12/10,88.07261143,4036,50,353082,4690,No,No,7568
Missouri,2020/12/11,88.07261143,2065,14,355147,4704,No,No,7568
Missouri,2020/12/12,88.07261143,5476,50,360623,4754,No,No,7568
Missouri,2020/12/13,88.07261143,2623,7,363246,4761,No,No,7568
Missouri,2020/12/14,88.07261143,4264,26,367510,4787,No,No,7568
Missouri,2020/12/15,88.07261143,3359,172,370869,4959,No,No,7568
Missouri,2020/12/16,88.07261143,3141,84,374010,5043,No,No,7543
Missouri,2020/12/17,88.07261143,4004,58,378014,5101,No,No,7543
Missouri,2020/12/18,88.07261143,4167,69,382181,5170,No,No,7543
Missouri,2020/12/19,88.07261143,2341,66,384522,5236,No,No,7543
Missouri,2020/12/20,88.07261143,1737,26,386259,5262,No,No,7543
Missouri,2020/12/21,88.07261143,4253,29,390512,5291,No,No,7543
Missouri,2020/12/22,88.07261143,2976,183,393488,5474,No,No,7543
Missouri,2020/12/23,88.07261143,2921,114,396409,5588,No,No,5506
Missouri,2020/12/24,88.07261143,3119,39,399528,5627,No,No,5506
Missouri,2020/12/25,88.07261143,1186,6,400714,5633,No,No,5506
Missouri,2020/12/26,88.07261143,1630,9,402344,5642,No,No,5506
Missouri,2020/12/27,88.07261143,1857,14,404201,5656,No,No,5506
Missouri,2020/12/28,88.07261143,2992,12,407193,5668,No,No,5506
Missouri,2020/12/29,88.07261143,3141,98,410334,5766,No,No,5506
Missouri,2020/12/30,88.07261143,3430,80,413764,5846,No,No,10986
Missouri,2020/12/31,88.07261143,4873,41,418637,5887,No,No,10986
Missouri,2021/1/1,88.07261143,2580,19,421217,5906,No,No,10986
Missouri,2021/1/2,88.07261143,2677,4,423894,5910,No,No,10986
Missouri,2021/1/3,88.07261143,2595,18,426489,5928,No,No,10986
Missouri,2021/1/4,88.07261143,3256,13,429745,5941,No,No,10986
Missouri,2021/1/5,88.07261143,3085,182,432830,6123,No,No,10986
Missouri,2021/1/6,88.07261143,2857,44,435687,6167,No,No,14084
Missouri,2021/1/7,88.07261143,4876,71,440563,6238,No,No,14084
Missouri,2021/1/8,88.07261143,4747,38,445310,6276,No,No,14084
Missouri,2021/1/9,88.07261143,3276,33,448586,6309,No,No,14084
Missouri,2021/1/10,88.07261143,2300,7,450886,6316,No,No,14084
Missouri,2021/1/11,88.07261143,3606,20,454492,6336,No,No,14084
Missouri,2021/1/12,88.07261143,2486,159,456978,6495,No,No,14084
Missouri,2021/1/13,88.07261143,2450,43,459428,6538,No,No,11980
Missouri,2021/1/14,88.07261143,2890,52,462318,6590,No,No,11980
Missouri,2021/1/15,88.07261143,2613,29,464931,6619,No,No,11980
Missouri,2021/1/16,88.07261143,1898,25,466829,6644,No,No,11980
Missouri,2021/1/17,88.07261143,1277,3,468106,6647,No,No,11980
Missouri,2021/1/18,88.07261143,1246,8,469352,6655,No,No,11980
Missouri,2021/1/19,88.07261143,2391,17,471743,6672,No,No,11980
Missouri,2021/1/20,88.07261143,2169,196,473912,6868,No,No,11615
Missouri,2021/1/21,88.07261143,2350,41,476262,6909,No,No,11615
Missouri,2021/1/22,88.07261143,2255,23,478517,6932,No,No,11615
Missouri,2021/1/23,88.07261143,1666,17,480183,6949,No,No,11615
Missouri,2021/1/24,88.07261143,1787,7,481970,6956,No,No,11615
Missouri,2021/1/25,88.07261143,1936,12,483906,6968,No,No,11615
Missouri,2021/1/26,88.07261143,1627,114,485533,7082,No,No,11615
Missouri,2021/1/27,88.07261143,1740,36,487273,7118,No,No,12664
Missouri,2021/1/28,88.07261143,2178,23,489451,7141,No,No,12664
Missouri,2021/1/29,88.07261143,2161,21,491612,7162,No,No,12664
Missouri,2021/1/30,88.07261143,1053,13,492665,7175,No,No,12664
Missouri,2021/1/31,88.07261143,766,1,493431,7176,No,No,12664
Missouri,2021/2/1,88.07261143,1438,6,494869,7182,No,No,12664
Missouri,2021/2/2,88.07261143,1612,228,496481,7410,No,No,12664
Missouri,2021/2/3,88.07261143,1300,81,497781,7491,No,No,13464
Missouri,2021/2/4,88.07261143,1491,27,499272,7518,No,No,13464
Missouri,2021/2/5,88.07261143,1782,22,501054,7540,No,No,13464
Missouri,2021/2/6,88.07261143,816,17,501870,7557,No,No,13464
Missouri,2021/2/7,88.07261143,562,5,502432,7562,No,No,13464
Missouri,2021/2/8,88.07261143,1121,16,503553,7578,No,No,13464
Missouri,2021/2/9,88.07261143,789,11,504342,7589,No,No,13464
Missouri,2021/2/10,88.07261143,1184,17,505526,7606,No,No,12087
Missouri,2021/2/11,88.07261143,1121,192,506647,7798,No,No,12087
Missouri,2021/2/12,88.07261143,958,42,507605,7840,No,No,12087
Missouri,2021/2/13,88.07261143,624,30,508229,7870,No,No,12087
Missouri,2021/2/14,88.07261143,394,5,508623,7875,No,No,12087
Missouri,2021/2/15,88.07261143,408,4,509031,7879,No,No,12087
Missouri,2021/2/16,88.07261143,619,9,509650,7888,No,No,12087
Missouri,2021/2/17,88.07261143,1055,41,510705,7929,No,No,11395
Missouri,2021/2/18,88.07261143,801,158,511506,8087,No,No,11395
Missouri,2021/2/19,88.07261143,766,53,512272,8140,No,No,11395
Missouri,2021/2/20,88.07261143,481,11,512753,8151,No,No,11395
Missouri,2021/2/21,88.07261143,304,0,513057,8151,No,No,11395
Missouri,2021/2/22,88.07261143,749,16,513806,8167,No,No,11395
Missouri,2021/2/23,88.07261143,588,117,514394,8284,No,No,11395
Missouri,2021/2/24,88.07261143,765,32,515159,8316,No,No,11395
Missouri,2021/2/25,88.07261143,649,39,515808,8355,No,No,11395
Missouri,2021/2/26,88.07261143,621,16,516429,8371,No,No,11395
Missouri,2021/2/27,88.07261143,367,12,516796,8383,No,No,11395
Missouri,2021/2/28,88.07261143,275,-1,517071,8382,No,No,11395
Missouri,2021/3/1,88.07261143,526,3,517597,8385,No,No,11395
Missouri,2021/3/2,88.07261143,432,17,518029,8402,No,No,11395
Missouri,2021/3/3,88.07261143,501,163,518530,8565,No,No,11395
Missouri,2021/3/4,88.07261143,578,6,519108,8571,No,No,11395
Montana,2020/3/1,7.263779581,0,0,0,0,No,No,1575
Montana,2020/3/2,7.263779581,0,0,0,0,No,No,1575
Montana,2020/3/3,7.263779581,0,0,0,0,No,No,1575
Montana,2020/3/4,7.263779581,0,0,0,0,No,No,1663
Montana,2020/3/5,7.263779581,0,0,0,0,No,No,1663
Montana,2020/3/6,7.263779581,0,0,0,0,No,No,1663
Montana,2020/3/7,7.263779581,0,0,0,0,No,No,1663
Montana,2020/3/8,7.263779581,0,0,0,0,No,No,1663
Montana,2020/3/9,7.263779581,0,0,0,0,No,No,1663
Montana,2020/3/10,7.263779581,0,0,0,0,No,No,1663
Montana,2020/3/11,7.263779581,0,0,0,0,No,No,1819
Montana,2020/3/12,7.263779581,0,0,0,0,No,No,1819
Montana,2020/3/13,7.263779581,4,0,4,0,No,No,1819
Montana,2020/3/14,7.263779581,2,0,6,0,No,No,1819
Montana,2020/3/15,7.263779581,0,0,6,0,No,No,1819
Montana,2020/3/16,7.263779581,2,0,8,0,No,No,1819
Montana,2020/3/17,7.263779581,0,0,8,0,No,No,1819
Montana,2020/3/18,7.263779581,4,0,12,0,No,No,10892
Montana,2020/3/19,7.263779581,7,0,19,0,No,No,10892
Montana,2020/3/20,7.263779581,0,0,19,0,No,No,10892
Montana,2020/3/21,7.263779581,10,0,29,0,No,No,10892
Montana,2020/3/22,7.263779581,5,0,34,0,No,No,10892
Montana,2020/3/23,7.263779581,11,0,45,0,No,No,10892
Montana,2020/3/24,7.263779581,6,0,51,0,No,No,10892
Montana,2020/3/25,7.263779581,14,0,65,0,No,No,80984
Montana,2020/3/26,7.263779581,25,0,90,0,No,No,80984
Montana,2020/3/27,7.263779581,31,1,121,1,No,No,80984
Montana,2020/3/28,7.263779581,26,0,147,1,Yes,No,80984
Montana,2020/3/29,7.263779581,14,0,161,1,Yes,No,80984
Montana,2020/3/30,7.263779581,16,3,177,4,Yes,No,80984
Montana,2020/3/31,7.263779581,21,1,198,5,Yes,No,80984
Montana,2020/4/1,7.263779581,21,0,219,5,Yes,No,106739
Montana,2020/4/2,7.263779581,22,0,241,5,Yes,No,106739
Montana,2020/4/3,7.263779581,21,0,262,5,Yes,No,106739
Montana,2020/4/4,7.263779581,19,1,281,6,Yes,No,106739
Montana,2020/4/5,7.263779581,17,0,298,6,Yes,No,106739
Montana,2020/4/6,7.263779581,21,0,319,6,Yes,No,106739
Montana,2020/4/7,7.263779581,0,0,319,6,Yes,No,106739
Montana,2020/4/8,7.263779581,13,0,332,6,Yes,No,77515
Montana,2020/4/9,7.263779581,22,0,354,6,Yes,No,77515
Montana,2020/4/10,7.263779581,11,0,365,6,Yes,No,77515
Montana,2020/4/11,7.263779581,12,0,377,6,Yes,No,77515
Montana,2020/4/12,7.263779581,10,0,387,6,Yes,No,77515
Montana,2020/4/13,7.263779581,7,1,394,7,Yes,No,77515
Montana,2020/4/14,7.263779581,5,0,399,7,Yes,No,77515
Montana,2020/4/15,7.263779581,5,0,404,7,Yes,No,66432
Montana,2020/4/16,7.263779581,11,0,415,7,Yes,No,66432
Montana,2020/4/17,7.263779581,7,1,422,8,Yes,No,66432
Montana,2020/4/18,7.263779581,4,2,426,10,Yes,No,66432
Montana,2020/4/19,7.263779581,7,0,433,10,Yes,No,66432
Montana,2020/4/20,7.263779581,0,2,433,12,Yes,No,66432
Montana,2020/4/21,7.263779581,4,0,437,12,Yes,No,66432
Montana,2020/4/22,7.263779581,2,2,439,14,Yes,No,74966
Montana,2020/4/23,7.263779581,3,0,442,14,Yes,No,74966
Montana,2020/4/24,7.263779581,2,0,444,14,Yes,No,74966
Montana,2020/4/25,7.263779581,1,0,445,14,Yes,No,74966
Montana,2020/4/26,7.263779581,3,0,448,14,Yes,No,74966
Montana,2020/4/27,7.263779581,1,0,449,14,No,No,74966
Montana,2020/4/28,7.263779581,2,1,451,15,No,No,74966
Montana,2020/4/29,7.263779581,0,1,451,16,No,No,28985
Montana,2020/4/30,7.263779581,1,0,452,16,No,No,28985
Montana,2020/5/1,7.263779581,0,0,452,16,No,No,28985
Montana,2020/5/2,7.263779581,2,0,454,16,No,No,28985
Montana,2020/5/3,7.263779581,0,0,454,16,No,No,28985
Montana,2020/5/4,7.263779581,2,0,456,16,No,No,28985
Montana,2020/5/5,7.263779581,0,0,456,16,No,No,28985
Montana,2020/5/6,7.263779581,0,0,456,16,No,No,26666
Montana,2020/5/7,7.263779581,0,0,456,16,No,No,26666
Montana,2020/5/8,7.263779581,2,0,458,16,No,No,26666
Montana,2020/5/9,7.263779581,0,0,458,16,No,No,26666
Montana,2020/5/10,7.263779581,0,0,458,16,No,No,26666
Montana,2020/5/11,7.263779581,1,0,459,16,No,No,26666
Montana,2020/5/12,7.263779581,2,0,461,16,No,No,26666
Montana,2020/5/13,7.263779581,1,0,462,16,No,No,25150
Montana,2020/5/14,7.263779581,0,0,462,16,No,No,25150
Montana,2020/5/15,7.263779581,4,0,466,16,No,No,25150
Montana,2020/5/16,7.263779581,2,0,468,16,No,No,25150
Montana,2020/5/17,7.263779581,0,0,468,16,No,No,25150
Montana,2020/5/18,7.263779581,2,0,470,16,No,No,25150
Montana,2020/5/19,7.263779581,1,0,471,16,No,No,25150
Montana,2020/5/20,7.263779581,7,0,478,16,No,No,27919
Montana,2020/5/21,7.263779581,1,0,479,16,No,No,27919
Montana,2020/5/22,7.263779581,0,0,479,16,No,No,27919
Montana,2020/5/23,7.263779581,0,0,479,16,No,No,27919
Montana,2020/5/24,7.263779581,0,0,479,16,No,No,27919
Montana,2020/5/25,7.263779581,0,0,479,16,No,No,27919
Montana,2020/5/26,7.263779581,0,1,479,17,No,No,27919
Montana,2020/5/27,7.263779581,2,0,481,17,No,No,21335
Montana,2020/5/28,7.263779581,4,0,485,17,No,No,21335
Montana,2020/5/29,7.263779581,8,0,493,17,No,No,21335
Montana,2020/5/30,7.263779581,12,0,505,17,No,No,21335
Montana,2020/5/31,7.263779581,10,0,515,17,No,No,21335
Montana,2020/6/1,7.263779581,4,0,519,17,No,No,21335
Montana,2020/6/2,7.263779581,4,0,523,17,No,No,21335
Montana,2020/6/3,7.263779581,2,0,525,17,No,No,19949
Montana,2020/6/4,7.263779581,12,0,537,17,No,No,19949
Montana,2020/6/5,7.263779581,2,1,539,18,No,No,19949
Montana,2020/6/6,7.263779581,1,0,540,18,No,No,19949
Montana,2020/6/7,7.263779581,5,0,545,18,No,No,19949
Montana,2020/6/8,7.263779581,3,0,548,18,No,No,19949
Montana,2020/6/9,7.263779581,6,0,554,18,No,No,19949
Montana,2020/6/10,7.263779581,7,0,561,18,No,No,18367
Montana,2020/6/11,7.263779581,2,0,563,18,No,No,18367
Montana,2020/6/12,7.263779581,10,0,573,18,No,No,18367
Montana,2020/6/13,7.263779581,15,0,588,18,No,No,18367
Montana,2020/6/14,7.263779581,13,1,601,19,No,No,18367
Montana,2020/6/15,7.263779581,8,0,609,19,No,No,18367
Montana,2020/6/16,7.263779581,5,0,614,19,No,No,18367
Montana,2020/6/17,7.263779581,16,1,630,20,No,No,18671
Montana,2020/6/18,7.263779581,25,0,655,20,No,No,18671
Montana,2020/6/19,7.263779581,11,0,666,20,No,No,18671
Montana,2020/6/20,7.263779581,32,0,698,20,No,No,18671
Montana,2020/6/21,7.263779581,19,0,717,20,No,No,18671
Montana,2020/6/22,7.263779581,17,1,734,21,No,No,18671
Montana,2020/6/23,7.263779581,9,0,743,21,No,No,18671
Montana,2020/6/24,7.263779581,23,0,766,21,No,No,18338
Montana,2020/6/25,7.263779581,37,0,803,21,No,No,18338
Montana,2020/6/26,7.263779581,26,1,829,22,No,No,18338
Montana,2020/6/27,7.263779581,23,0,852,22,No,No,18338
Montana,2020/6/28,7.263779581,11,0,863,22,No,No,18338
Montana,2020/6/29,7.263779581,56,0,919,22,No,No,18338
Montana,2020/6/30,7.263779581,48,0,967,22,No,No,18338
Montana,2020/7/1,7.263779581,49,0,1016,22,No,No,19056
Montana,2020/7/2,7.263779581,67,0,1083,22,No,No,19056
Montana,2020/7/3,7.263779581,45,1,1128,23,No,No,19056
Montana,2020/7/4,7.263779581,39,0,1167,23,No,No,19056
Montana,2020/7/5,7.263779581,45,0,1212,23,No,No,19056
Montana,2020/7/6,7.263779581,37,0,1249,23,No,No,19056
Montana,2020/7/7,7.263779581,78,0,1327,23,No,No,19056
Montana,2020/7/8,7.263779581,44,0,1371,23,No,No,20563
Montana,2020/7/9,7.263779581,95,2,1466,25,No,No,20563
Montana,2020/7/10,7.263779581,127,3,1593,28,No,No,20563
Montana,2020/7/11,7.263779581,84,1,1677,29,No,No,20563
Montana,2020/7/12,7.263779581,81,0,1758,29,No,No,20563
Montana,2020/7/13,7.263779581,150,3,1908,32,No,No,20563
Montana,2020/7/14,7.263779581,130,2,2038,34,No,No,20563
Montana,2020/7/15,7.263779581,111,0,2149,34,No,Yes,23676
Montana,2020/7/16,7.263779581,116,1,2265,35,No,Yes,23676
Montana,2020/7/17,7.263779581,118,2,2383,37,No,Yes,23676
Montana,2020/7/18,7.263779581,88,0,2471,37,No,Yes,23676
Montana,2020/7/19,7.263779581,62,0,2533,37,No,Yes,23676
Montana,2020/7/20,7.263779581,107,2,2640,39,No,Yes,23676
Montana,2020/7/21,7.263779581,101,1,2741,40,No,Yes,23676
Montana,2020/7/22,7.263779581,99,2,2840,42,No,Yes,17437
Montana,2020/7/23,7.263779581,84,1,2924,43,No,Yes,17437
Montana,2020/7/24,7.263779581,189,3,3113,46,No,Yes,17437
Montana,2020/7/25,7.263779581,147,0,3260,46,No,Yes,17437
Montana,2020/7/26,7.263779581,82,0,3342,46,No,Yes,17437
Montana,2020/7/27,7.263779581,64,1,3406,47,No,Yes,17437
Montana,2020/7/28,7.263779581,85,5,3491,52,No,Yes,17437
Montana,2020/7/29,7.263779581,204,2,3695,54,No,Yes,11690
Montana,2020/7/30,7.263779581,134,1,3829,55,No,Yes,11690
Montana,2020/7/31,7.263779581,148,5,3977,60,No,Yes,11690
Montana,2020/8/1,7.263779581,104,1,4081,61,No,Yes,11690
Montana,2020/8/2,7.263779581,112,0,4193,61,No,Yes,11690
Montana,2020/8/3,7.263779581,56,3,4249,64,No,Yes,11690
Montana,2020/8/4,7.263779581,111,0,4360,64,No,Yes,11690
Montana,2020/8/5,7.263779581,121,1,4481,65,No,Yes,9467
Montana,2020/8/6,7.263779581,140,1,4621,66,No,Yes,9467
Montana,2020/8/7,7.263779581,150,5,4771,71,No,Yes,9467
Montana,2020/8/8,7.263779581,118,4,4889,75,No,Yes,9467
Montana,2020/8/9,7.263779581,63,0,4952,75,No,Yes,9467
Montana,2020/8/10,7.263779581,80,0,5032,75,No,Yes,9467
Montana,2020/8/11,7.263779581,93,2,5125,77,No,Yes,9467
Montana,2020/8/12,7.263779581,167,3,5292,80,No,Yes,11047
Montana,2020/8/13,7.263779581,138,1,5430,81,No,Yes,11047
Montana,2020/8/14,7.263779581,134,1,5564,82,No,Yes,11047
Montana,2020/8/15,7.263779581,99,0,5663,82,No,Yes,11047
Montana,2020/8/16,7.263779581,88,0,5751,82,No,Yes,11047
Montana,2020/8/17,7.263779581,59,0,5810,82,No,Yes,11047
Montana,2020/8/18,7.263779581,57,2,5867,84,No,Yes,11047
Montana,2020/8/19,7.263779581,109,0,5976,84,No,Yes,8676
Montana,2020/8/20,7.263779581,119,5,6095,89,No,Yes,8676
Montana,2020/8/21,7.263779581,144,1,6239,90,No,Yes,8676
Montana,2020/8/22,7.263779581,153,0,6392,90,No,Yes,8676
Montana,2020/8/23,7.263779581,52,0,6444,90,No,Yes,8676
Montana,2020/8/24,7.263779581,66,1,6510,91,No,Yes,8676
Montana,2020/8/25,7.263779581,139,6,6649,97,No,Yes,8676
Montana,2020/8/26,7.263779581,158,1,6807,98,No,Yes,8511
Montana,2020/8/27,7.263779581,153,0,6960,98,No,Yes,8511
Montana,2020/8/28,7.263779581,126,2,7086,100,No,Yes,8511
Montana,2020/8/29,7.263779581,170,4,7256,104,No,Yes,8511
Montana,2020/8/30,7.263779581,84,0,7340,104,No,Yes,8511
Montana,2020/8/31,7.263779581,100,0,7440,104,No,Yes,8511
Montana,2020/9/1,7.263779581,86,1,7526,105,No,Yes,8511
Montana,2020/9/2,7.263779581,189,4,7715,109,No,Yes,8901
Montana,2020/9/3,7.263779581,188,2,7903,111,No,Yes,8901
Montana,2020/9/4,7.263779581,143,3,8046,114,No,Yes,8901
Montana,2020/9/5,7.263779581,132,2,8178,116,No,Yes,8901
Montana,2020/9/6,7.263779581,94,1,8272,117,No,Yes,8901
Montana,2020/9/7,7.263779581,68,1,8340,118,No,Yes,8901
Montana,2020/9/8,7.263779581,69,1,8409,119,No,Yes,8901
Montana,2020/9/9,7.263779581,90,3,8499,122,No,Yes,8848
Montana,2020/9/10,7.263779581,195,1,8694,123,No,Yes,8848
Montana,2020/9/11,7.263779581,123,9,8817,132,No,Yes,8848
Montana,2020/9/12,7.263779581,129,2,8946,134,No,Yes,8848
Montana,2020/9/13,7.263779581,91,2,9037,136,No,Yes,8848
Montana,2020/9/14,7.263779581,127,3,9164,139,No,Yes,8848
Montana,2020/9/15,7.263779581,117,2,9281,141,No,Yes,8848
Montana,2020/9/16,7.263779581,206,0,9487,141,No,Yes,8679
Montana,2020/9/17,7.263779581,234,2,9721,143,No,Yes,8679
Montana,2020/9/18,7.263779581,213,3,9934,146,No,Yes,8679
Montana,2020/9/19,7.263779581,259,10,10193,156,No,Yes,8679
Montana,2020/9/20,7.263779581,132,1,10325,157,No,Yes,8679
Montana,2020/9/21,7.263779581,184,3,10509,160,No,Yes,8679
Montana,2020/9/22,7.263779581,283,3,10792,163,No,Yes,8679
Montana,2020/9/23,7.263779581,242,2,11034,165,No,Yes,8805
Montana,2020/9/24,7.263779581,347,0,11381,165,No,Yes,8805
Montana,2020/9/25,7.263779581,275,5,11656,170,No,Yes,8805
Montana,2020/9/26,7.263779581,287,1,11943,171,No,Yes,8805
Montana,2020/9/27,7.263779581,183,2,12126,173,No,Yes,8805
Montana,2020/9/28,7.263779581,412,1,12538,174,No,Yes,8805
Montana,2020/9/29,7.263779581,287,3,12825,177,No,Yes,8805
Montana,2020/9/30,7.263779581,354,3,13179,180,No,Yes,7732
Montana,2020/10/1,7.263779581,447,1,13626,181,No,Yes,7732
Montana,2020/10/2,7.263779581,418,5,14044,186,No,Yes,7732
Montana,2020/10/3,7.263779581,446,0,14490,186,No,Yes,7732
Montana,2020/10/4,7.263779581,248,1,14738,187,No,Yes,7732
Montana,2020/10/5,7.263779581,389,3,15127,190,No,Yes,7732
Montana,2020/10/6,7.263779581,506,2,15633,192,No,Yes,7732
Montana,2020/10/7,7.263779581,561,1,16194,193,No,Yes,8581
Montana,2020/10/8,7.263779581,572,4,16766,197,No,Yes,8581
Montana,2020/10/9,7.263779581,712,9,17478,206,No,Yes,8581
Montana,2020/10/10,7.263779581,640,3,18118,209,No,Yes,8581
Montana,2020/10/11,7.263779581,615,1,18733,210,No,Yes,8581
Montana,2020/10/12,7.263779581,472,2,19205,212,No,Yes,8581
Montana,2020/10/13,7.263779581,477,5,19682,217,No,Yes,8581
Montana,2020/10/14,7.263779581,639,8,20321,225,No,Yes,7964
Montana,2020/10/15,7.263779581,722,5,21043,230,No,Yes,7964
Montana,2020/10/16,7.263779581,631,5,21674,235,No,Yes,7964
Montana,2020/10/17,7.263779581,610,5,22284,240,No,Yes,7964
Montana,2020/10/18,7.263779581,537,1,22821,241,No,Yes,7964
Montana,2020/10/19,7.263779581,682,1,23503,242,No,Yes,7964
Montana,2020/10/20,7.263779581,698,10,24201,252,No,Yes,7964
Montana,2020/10/21,7.263779581,617,24,24818,276,No,Yes,7126
Montana,2020/10/22,7.263779581,918,3,25736,279,No,Yes,7126
Montana,2020/10/23,7.263779581,864,4,26600,283,No,Yes,7126
Montana,2020/10/24,7.263779581,549,12,27149,295,No,Yes,7126
Montana,2020/10/25,7.263779581,731,3,27880,298,No,Yes,7126
Montana,2020/10/26,7.263779581,700,6,28580,304,No,Yes,7126
Montana,2020/10/27,7.263779581,842,5,29422,309,No,Yes,7126
Montana,2020/10/28,7.263779581,629,17,30051,326,No,Yes,7060
Montana,2020/10/29,7.263779581,881,13,30932,339,No,Yes,7060
Montana,2020/10/30,7.263779581,1063,29,31995,368,No,Yes,7060
Montana,2020/10/31,7.263779581,806,9,32801,377,No,Yes,7060
Montana,2020/11/1,7.263779581,694,1,33495,378,No,Yes,7060
Montana,2020/11/2,7.263779581,822,9,34317,387,No,Yes,7060
Montana,2020/11/3,7.263779581,905,13,35222,400,No,Yes,7060
Montana,2020/11/4,7.263779581,790,4,36012,404,No,Yes,8764
Montana,2020/11/5,7.263779581,1012,5,37024,409,No,Yes,8764
Montana,2020/11/6,7.263779581,988,11,38012,420,No,Yes,8764
Montana,2020/11/7,7.263779581,936,25,38948,445,No,Yes,8764
Montana,2020/11/8,7.263779581,731,11,39679,456,No,Yes,8764
Montana,2020/11/9,7.263779581,439,7,40118,463,No,Yes,8764
Montana,2020/11/10,7.263779581,1101,5,41219,468,No,Yes,8764
Montana,2020/11/11,7.263779581,913,7,42132,475,No,Yes,9262
Montana,2020/11/12,7.263779581,952,3,43084,478,No,Yes,9262
Montana,2020/11/13,7.263779581,1213,5,44297,483,No,Yes,9262
Montana,2020/11/14,7.263779581,1622,36,45919,519,No,Yes,9262
Montana,2020/11/15,7.263779581,1239,6,47158,525,No,Yes,9262
Montana,2020/11/16,7.263779581,943,3,48101,528,No,Yes,9262
Montana,2020/11/17,7.263779581,1395,20,49496,548,No,Yes,9262
Montana,2020/11/18,7.263779581,1154,20,50650,568,No,Yes,11813
Montana,2020/11/19,7.263779581,1222,1,51872,569,No,Yes,11813
Montana,2020/11/20,7.263779581,1474,6,53346,575,No,Yes,11813
Montana,2020/11/21,7.263779581,1196,29,54542,604,No,Yes,11813
Montana,2020/11/22,7.263779581,1138,3,55680,607,No,Yes,11813
Montana,2020/11/23,7.263779581,748,8,56428,615,No,Yes,11813
Montana,2020/11/24,7.263779581,1131,15,57559,630,No,Yes,11813
Montana,2020/11/25,7.263779581,1061,23,58620,653,No,Yes,7061
Montana,2020/11/26,7.263779581,1062,5,59682,658,No,Yes,7061
Montana,2020/11/27,7.263779581,114,0,59796,658,No,Yes,7061
Montana,2020/11/28,7.263779581,1049,12,60845,670,No,Yes,7061
Montana,2020/11/29,7.263779581,956,2,61801,672,No,Yes,7061
Montana,2020/11/30,7.263779581,455,12,62256,684,No,Yes,7061
Montana,2020/12/1,7.263779581,1068,16,63324,700,No,Yes,7061
Montana,2020/12/2,7.263779581,1075,13,64399,713,No,Yes,7656
Montana,2020/12/3,7.263779581,843,10,65242,723,No,Yes,7656
Montana,2020/12/4,7.263779581,1252,5,66494,728,No,Yes,7656
Montana,2020/12/5,7.263779581,598,6,67092,734,No,Yes,7656
Montana,2020/12/6,7.263779581,783,2,67875,736,No,Yes,7656
Montana,2020/12/7,7.263779581,776,7,68651,743,No,Yes,7656
Montana,2020/12/8,7.263779581,814,20,69465,763,No,Yes,7656
Montana,2020/12/9,7.263779581,726,8,70191,771,No,Yes,7568
Montana,2020/12/10,7.263779581,763,15,70954,786,No,Yes,7568
Montana,2020/12/11,7.263779581,977,19,71931,805,No,Yes,7568
Montana,2020/12/12,7.263779581,728,11,72659,816,No,Yes,7568
Montana,2020/12/13,7.263779581,644,2,73303,818,No,Yes,7568
Montana,2020/12/14,7.263779581,53,0,73356,818,No,Yes,7568
Montana,2020/12/15,7.263779581,804,8,74160,826,No,Yes,7568
Montana,2020/12/16,7.263779581,604,10,74764,836,No,Yes,7543
Montana,2020/12/17,7.263779581,781,13,75545,849,No,Yes,7543
Montana,2020/12/18,7.263779581,511,6,76056,855,No,Yes,7543
Montana,2020/12/19,7.263779581,652,9,76708,864,No,Yes,7543
Montana,2020/12/20,7.263779581,462,1,77170,865,No,Yes,7543
Montana,2020/12/21,7.263779581,286,16,77456,881,No,Yes,7543
Montana,2020/12/22,7.263779581,561,20,78017,901,No,Yes,7543
Montana,2020/12/23,7.263779581,574,16,78591,917,No,Yes,5506
Montana,2020/12/24,7.263779581,475,1,79066,918,No,Yes,5506
Montana,2020/12/25,7.263779581,0,0,79066,918,No,Yes,5506
Montana,2020/12/26,7.263779581,455,1,79521,919,No,Yes,5506
Montana,2020/12/27,7.263779581,259,5,79780,924,No,Yes,5506
Montana,2020/12/28,7.263779581,300,3,80080,927,No,Yes,5506
Montana,2020/12/29,7.263779581,436,12,80516,939,No,Yes,5506
Montana,2020/12/30,7.263779581,836,11,81352,950,No,Yes,10986
Montana,2020/12/31,7.263779581,349,12,81701,962,No,Yes,10986
Montana,2021/1/1,7.263779581,0,0,81701,962,No,Yes,10986
Montana,2021/1/2,7.263779581,290,9,81991,971,No,Yes,10986
Montana,2021/1/3,7.263779581,390,1,82381,972,No,Yes,10986
Montana,2021/1/4,7.263779581,372,3,82753,975,No,Yes,10986
Montana,2021/1/5,7.263779581,776,31,83529,1006,No,Yes,10986
Montana,2021/1/6,7.263779581,626,9,84155,1015,No,Yes,14084
Montana,2021/1/7,7.263779581,693,24,84848,1039,No,Yes,14084
Montana,2021/1/8,7.263779581,820,10,85668,1049,No,Yes,14084
Montana,2021/1/9,7.263779581,448,5,86116,1054,No,Yes,14084
Montana,2021/1/10,7.263779581,208,2,86324,1056,No,Yes,14084
Montana,2021/1/11,7.263779581,433,1,86757,1057,No,Yes,14084
Montana,2021/1/12,7.263779581,422,10,87179,1067,No,Yes,14084
Montana,2021/1/13,7.263779581,580,2,87759,1069,No,Yes,11980
Montana,2021/1/14,7.263779581,431,10,88190,1079,No,Yes,11980
Montana,2021/1/15,7.263779581,535,7,88725,1086,No,Yes,11980
Montana,2021/1/16,7.263779581,331,2,89056,1088,No,Yes,11980
Montana,2021/1/17,7.263779581,337,4,89393,1092,No,Yes,11980
Montana,2021/1/18,7.263779581,191,1,89584,1093,No,Yes,11980
Montana,2021/1/19,7.263779581,368,0,89952,1093,No,Yes,11980
Montana,2021/1/20,7.263779581,397,1,90349,1094,No,Yes,11615
Montana,2021/1/21,7.263779581,393,8,90742,1102,No,Yes,11615
Montana,2021/1/22,7.263779581,403,4,91145,1106,No,Yes,11615
Montana,2021/1/23,7.263779581,303,36,91448,1142,No,Yes,11615
Montana,2021/1/24,7.263779581,214,10,91662,1152,No,Yes,11615
Montana,2021/1/25,7.263779581,243,0,91905,1152,No,Yes,11615
Montana,2021/1/26,7.263779581,344,34,92249,1186,No,Yes,11615
Montana,2021/1/27,7.263779581,370,16,92619,1202,No,Yes,12664
Montana,2021/1/28,7.263779581,399,11,93018,1213,No,Yes,12664
Montana,2021/1/29,7.263779581,304,15,93322,1228,No,Yes,12664
Montana,2021/1/30,7.263779581,471,5,93793,1233,No,Yes,12664
Montana,2021/1/31,7.263779581,168,1,93961,1234,No,Yes,12664
Montana,2021/2/1,7.263779581,185,1,94146,1235,No,Yes,12664
Montana,2021/2/2,7.263779581,314,15,94460,1250,No,Yes,12664
Montana,2021/2/3,7.263779581,430,54,94890,1304,No,Yes,13464
Montana,2021/2/4,7.263779581,301,6,95191,1310,No,Yes,13464
Montana,2021/2/5,7.263779581,348,2,95539,1312,No,Yes,13464
Montana,2021/2/6,7.263779581,214,1,95753,1313,No,Yes,13464
Montana,2021/2/7,7.263779581,60,2,95813,1315,No,Yes,13464
Montana,2021/2/8,7.263779581,180,0,95993,1315,No,Yes,13464
Montana,2021/2/9,7.263779581,378,1,96371,1316,No,Yes,13464
Montana,2021/2/10,7.263779581,307,5,96678,1321,No,Yes,12087
Montana,2021/2/11,7.263779581,260,1,96938,1322,No,Yes,12087
Montana,2021/2/12,7.263779581,221,3,97159,1325,No,Yes,12087
Montana,2021/2/13,7.263779581,179,3,97338,1328,No,Yes,12087
Montana,2021/2/14,7.263779581,87,0,97425,1328,No,Yes,12087
Montana,2021/2/15,7.263779581,150,1,97575,1329,No,Yes,12087
Montana,2021/2/16,7.263779581,184,3,97759,1332,No,Yes,12087
Montana,2021/2/17,7.263779581,236,3,97995,1335,No,Yes,11395
Montana,2021/2/18,7.263779581,216,3,98211,1338,No,Yes,11395
Montana,2021/2/19,7.263779581,254,2,98465,1340,No,Yes,11395
Montana,2021/2/20,7.263779581,216,2,98681,1342,No,Yes,11395
Montana,2021/2/21,7.263779581,98,1,98779,1343,No,Yes,11395
Montana,2021/2/22,7.263779581,150,-1,98929,1342,No,Yes,11395
Montana,2021/2/23,7.263779581,232,5,99161,1347,No,Yes,11395
Montana,2021/2/24,7.263779581,202,2,99363,1349,No,Yes,11395
Montana,2021/2/25,7.263779581,203,2,99566,1351,No,Yes,11395
Montana,2021/2/26,7.263779581,166,6,99732,1357,No,Yes,11395
Montana,2021/2/27,7.263779581,188,0,99920,1357,No,Yes,11395
Montana,2021/2/28,7.263779581,79,1,99999,1358,No,Yes,11395
Montana,2021/3/1,7.263779581,116,0,100115,1358,No,Yes,11395
Montana,2021/3/2,7.263779581,157,15,100272,1373,No,Yes,11395
Montana,2021/3/3,7.263779581,197,1,100469,1374,No,Yes,11395
Montana,2021/3/4,7.263779581,171,3,100640,1377,No,Yes,11395
Nebraska,2020/3/1,25.04833802,13,0,13,0,No,No,1575
Nebraska,2020/3/2,25.04833802,0,0,13,0,No,No,1575
Nebraska,2020/3/3,25.04833802,0,0,13,0,No,No,1575
Nebraska,2020/3/4,25.04833802,0,0,13,0,No,No,1663
Nebraska,2020/3/5,25.04833802,0,0,13,0,No,No,1663
Nebraska,2020/3/6,25.04833802,1,0,14,0,No,No,1663
Nebraska,2020/3/7,25.04833802,0,0,14,0,No,No,1663
Nebraska,2020/3/8,25.04833802,2,0,16,0,No,No,1663
Nebraska,2020/3/9,25.04833802,0,0,16,0,No,No,1663
Nebraska,2020/3/10,25.04833802,1,0,17,0,No,No,1663
Nebraska,2020/3/11,25.04833802,6,0,23,0,No,No,1819
Nebraska,2020/3/12,25.04833802,1,0,24,0,No,No,1819
Nebraska,2020/3/13,25.04833802,3,0,27,0,No,No,1819
Nebraska,2020/3/14,25.04833802,2,0,29,0,No,No,1819
Nebraska,2020/3/15,25.04833802,2,0,31,0,No,No,1819
Nebraska,2020/3/16,25.04833802,2,0,33,0,No,No,1819
Nebraska,2020/3/17,25.04833802,3,0,36,0,No,No,1819
Nebraska,2020/3/18,25.04833802,7,0,43,0,No,No,10892
Nebraska,2020/3/19,25.04833802,4,0,47,0,No,No,10892
Nebraska,2020/3/20,25.04833802,6,0,53,0,No,No,10892
Nebraska,2020/3/21,25.04833802,8,0,61,0,No,No,10892
Nebraska,2020/3/22,25.04833802,1,0,62,0,No,No,10892
Nebraska,2020/3/23,25.04833802,11,0,73,0,No,No,10892
Nebraska,2020/3/24,25.04833802,4,0,77,0,No,No,10892
Nebraska,2020/3/25,25.04833802,7,0,84,0,No,No,80984
Nebraska,2020/3/26,25.04833802,7,0,91,0,No,No,80984
Nebraska,2020/3/27,25.04833802,11,2,102,2,No,No,80984
Nebraska,2020/3/28,25.04833802,20,0,122,2,No,No,80984
Nebraska,2020/3/29,25.04833802,16,0,138,2,No,No,80984
Nebraska,2020/3/30,25.04833802,47,1,185,3,No,No,80984
Nebraska,2020/3/31,25.04833802,14,1,199,4,No,No,80984
Nebraska,2020/4/1,25.04833802,50,1,249,5,No,No,106739
Nebraska,2020/4/2,25.04833802,24,1,273,6,No,No,106739
Nebraska,2020/4/3,25.04833802,24,0,297,6,No,No,106739
Nebraska,2020/4/4,25.04833802,42,2,339,8,No,No,106739
Nebraska,2020/4/5,25.04833802,38,0,377,8,No,No,106739
Nebraska,2020/4/6,25.04833802,61,2,438,10,No,No,106739
Nebraska,2020/4/7,25.04833802,53,2,491,12,No,No,106739
Nebraska,2020/4/8,25.04833802,47,2,538,14,No,No,77515
Nebraska,2020/4/9,25.04833802,56,1,594,15,No,No,77515
Nebraska,2020/4/10,25.04833802,84,3,678,18,No,No,77515
Nebraska,2020/4/11,25.04833802,40,0,718,18,No,No,77515
Nebraska,2020/4/12,25.04833802,87,0,805,18,No,No,77515
Nebraska,2020/4/13,25.04833802,65,1,870,19,No,No,77515
Nebraska,2020/4/14,25.04833802,60,2,930,21,No,No,77515
Nebraska,2020/4/15,25.04833802,64,1,994,22,No,No,66432
Nebraska,2020/4/16,25.04833802,100,2,1094,24,No,No,66432
Nebraska,2020/4/17,25.04833802,122,0,1216,24,No,No,66432
Nebraska,2020/4/18,25.04833802,132,4,1348,28,No,No,66432
Nebraska,2020/4/19,25.04833802,125,0,1473,28,No,No,66432
Nebraska,2020/4/20,25.04833802,173,5,1646,33,No,No,66432
Nebraska,2020/4/21,25.04833802,80,5,1726,38,No,No,66432
Nebraska,2020/4/22,25.04833802,100,4,1826,42,No,No,74966
Nebraska,2020/4/23,25.04833802,364,4,2190,46,No,No,74966
Nebraska,2020/4/24,25.04833802,284,4,2474,50,No,No,74966
Nebraska,2020/4/25,25.04833802,424,2,2898,52,No,No,74966
Nebraska,2020/4/26,25.04833802,228,2,3126,54,No,No,74966
Nebraska,2020/4/27,25.04833802,361,0,3487,54,No,No,74966
Nebraska,2020/4/28,25.04833802,126,2,3613,56,No,No,74966
Nebraska,2020/4/29,25.04833802,263,11,3876,67,No,No,28985
Nebraska,2020/4/30,25.04833802,456,3,4332,70,No,No,28985
Nebraska,2020/5/1,25.04833802,506,2,4838,72,No,No,28985
Nebraska,2020/5/2,25.04833802,494,3,5332,75,No,No,28985
Nebraska,2020/5/3,25.04833802,354,2,5686,77,No,No,28985
Nebraska,2020/5/4,25.04833802,437,1,6123,78,No,No,28985
Nebraska,2020/5/5,25.04833802,319,3,6442,81,No,No,28985
Nebraska,2020/5/6,25.04833802,329,4,6771,85,No,No,26666
Nebraska,2020/5/7,25.04833802,419,6,7190,91,No,No,26666
Nebraska,2020/5/8,25.04833802,640,1,7830,92,No,No,26666
Nebraska,2020/5/9,25.04833802,403,3,8233,95,No,No,26666
Nebraska,2020/5/10,25.04833802,95,2,8328,97,No,No,26666
Nebraska,2020/5/11,25.04833802,247,2,8575,99,No,No,26666
Nebraska,2020/5/12,25.04833802,157,3,8732,102,No,No,26666
Nebraska,2020/5/13,25.04833802,340,4,9072,106,No,No,25150
Nebraska,2020/5/14,25.04833802,339,11,9411,117,No,No,25150
Nebraska,2020/5/15,25.04833802,355,5,9766,122,No,No,25150
Nebraska,2020/5/16,25.04833802,454,7,10220,129,No,No,25150
Nebraska,2020/5/17,25.04833802,128,0,10348,129,No,No,25150
Nebraska,2020/5/18,25.04833802,277,3,10625,132,No,No,25150
Nebraska,2020/5/19,25.04833802,221,4,10846,136,No,No,25150
Nebraska,2020/5/20,25.04833802,273,5,11119,141,No,No,27919
Nebraska,2020/5/21,25.04833802,304,7,11423,148,No,No,27919
Nebraska,2020/5/22,25.04833802,238,1,11661,149,No,No,27919
Nebraska,2020/5/23,25.04833802,327,1,11988,150,No,No,27919
Nebraska,2020/5/24,25.04833802,145,3,12133,153,No,No,27919
Nebraska,2020/5/25,25.04833802,221,2,12354,155,No,No,27919
Nebraska,2020/5/26,25.04833802,264,5,12618,160,No,No,27919
Nebraska,2020/5/27,25.04833802,357,8,12975,168,No,No,21335
Nebraska,2020/5/28,25.04833802,285,2,13260,170,No,No,21335
Nebraska,2020/5/29,25.04833802,394,7,13654,177,No,No,21335
Nebraska,2020/5/30,25.04833802,251,0,13905,177,No,No,21335
Nebraska,2020/5/31,25.04833802,196,1,14101,178,No,No,21335
Nebraska,2020/6/1,25.04833802,244,5,14345,183,No,No,21335
Nebraska,2020/6/2,25.04833802,266,4,14611,187,No,No,21335
Nebraska,2020/6/3,25.04833802,255,2,14866,189,No,No,19949
Nebraska,2020/6/4,25.04833802,251,4,15117,193,No,No,19949
Nebraska,2020/6/5,25.04833802,262,0,15379,193,No,No,19949
Nebraska,2020/6/6,25.04833802,164,3,15543,196,No,No,19949
Nebraska,2020/6/7,25.04833802,91,0,15634,196,No,No,19949
Nebraska,2020/6/8,25.04833802,118,0,15752,196,No,No,19949
Nebraska,2020/6/9,25.04833802,136,3,15888,199,No,No,19949
Nebraska,2020/6/10,25.04833802,137,10,16025,209,No,No,18367
Nebraska,2020/6/11,25.04833802,290,8,16315,217,No,No,18367
Nebraska,2020/6/12,25.04833802,198,4,16513,221,No,No,18367
Nebraska,2020/6/13,25.04833802,121,0,16634,221,No,No,18367
Nebraska,2020/6/14,25.04833802,101,0,16735,221,No,No,18367
Nebraska,2020/6/15,25.04833802,125,5,16860,226,No,No,18367
Nebraska,2020/6/16,25.04833802,171,10,17031,236,No,No,18367
Nebraska,2020/6/17,25.04833802,195,3,17226,239,No,No,18671
Nebraska,2020/6/18,25.04833802,189,5,17415,244,No,No,18671
Nebraska,2020/6/19,25.04833802,176,5,17591,249,No,No,18671
Nebraska,2020/6/20,25.04833802,116,0,17707,249,No,No,18671
Nebraska,2020/6/21,25.04833802,103,3,17810,252,No,No,18671
Nebraska,2020/6/22,25.04833802,147,3,17957,255,No,No,18671
Nebraska,2020/6/23,25.04833802,134,7,18091,262,No,No,18671
Nebraska,2020/6/24,25.04833802,129,1,18220,263,No,No,18338
Nebraska,2020/6/25,25.04833802,126,3,18346,266,No,No,18338
Nebraska,2020/6/26,25.04833802,178,4,18524,270,No,No,18338
Nebraska,2020/6/27,25.04833802,251,1,18775,271,No,No,18338
Nebraska,2020/6/28,25.04833802,125,0,18900,271,No,No,18338
Nebraska,2020/6/29,25.04833802,164,2,19064,273,No,No,18338
Nebraska,2020/6/30,25.04833802,130,6,19194,279,No,No,18338
Nebraska,2020/7/1,25.04833802,131,3,19325,282,No,No,19056
Nebraska,2020/7/2,25.04833802,151,2,19476,284,No,No,19056
Nebraska,2020/7/3,25.04833802,184,1,19660,285,No,No,19056
Nebraska,2020/7/4,25.04833802,166,0,19826,285,No,No,19056
Nebraska,2020/7/5,25.04833802,111,0,19937,285,No,No,19056
Nebraska,2020/7/6,25.04833802,115,1,20052,286,No,No,19056
Nebraska,2020/7/7,25.04833802,153,1,20205,287,No,No,19056
Nebraska,2020/7/8,25.04833802,232,4,20437,291,No,No,20563
Nebraska,2020/7/9,25.04833802,221,3,20658,294,No,No,20563
Nebraska,2020/7/10,25.04833802,176,0,20834,294,No,No,20563
Nebraska,2020/7/11,25.04833802,201,2,21035,296,No,No,20563
Nebraska,2020/7/12,25.04833802,179,0,21214,296,No,No,20563
Nebraska,2020/7/13,25.04833802,230,2,21444,298,No,No,20563
Nebraska,2020/7/14,25.04833802,273,1,21717,299,No,No,20563
Nebraska,2020/7/15,25.04833802,262,3,21979,302,No,No,23676
Nebraska,2020/7/16,25.04833802,199,5,22178,307,No,No,23676
Nebraska,2020/7/17,25.04833802,183,1,22361,308,No,No,23676
Nebraska,2020/7/18,25.04833802,184,0,22545,308,No,No,23676
Nebraska,2020/7/19,25.04833802,92,0,22637,308,No,No,23676
Nebraska,2020/7/20,25.04833802,210,5,22847,313,No,No,23676
Nebraska,2020/7/21,25.04833802,343,0,23190,313,No,No,23676
Nebraska,2020/7/22,25.04833802,296,1,23486,314,No,No,17437
Nebraska,2020/7/23,25.04833802,332,4,23818,318,No,No,17437
Nebraska,2020/7/24,25.04833802,356,4,24174,322,No,No,17437
Nebraska,2020/7/25,25.04833802,238,0,24412,322,No,No,17437
Nebraska,2020/7/26,25.04833802,206,0,24618,322,No,No,17437
Nebraska,2020/7/27,25.04833802,281,0,24899,322,No,No,17437
Nebraska,2020/7/28,25.04833802,241,4,25140,326,No,No,17437
Nebraska,2020/7/29,25.04833802,308,5,25448,331,No,No,11690
Nebraska,2020/7/30,25.04833802,318,2,25766,333,No,No,11690
Nebraska,2020/7/31,25.04833802,445,5,26211,338,No,No,11690
Nebraska,2020/8/1,25.04833802,180,0,26391,338,No,No,11690
Nebraska,2020/8/2,25.04833802,311,0,26702,338,No,No,11690
Nebraska,2020/8/3,25.04833802,254,-4,26956,334,No,No,11690
Nebraska,2020/8/4,25.04833802,222,5,27178,339,No,No,11690
Nebraska,2020/8/5,25.04833802,311,3,27489,342,No,No,9467
Nebraska,2020/8/6,25.04833802,332,5,27821,347,No,No,9467
Nebraska,2020/8/7,25.04833802,283,5,28104,352,No,No,9467
Nebraska,2020/8/8,25.04833802,141,1,28245,353,No,No,9467
Nebraska,2020/8/9,25.04833802,187,0,28432,353,No,No,9467
Nebraska,2020/8/10,25.04833802,264,1,28696,354,No,No,9467
Nebraska,2020/8/11,25.04833802,334,3,29030,357,No,No,9467
Nebraska,2020/8/12,25.04833802,214,2,29244,359,No,No,11047
Nebraska,2020/8/13,25.04833802,416,3,29660,362,No,No,11047
Nebraska,2020/8/14,25.04833802,328,1,29988,363,No,No,11047
Nebraska,2020/8/15,25.04833802,253,0,30241,363,No,No,11047
Nebraska,2020/8/16,25.04833802,131,0,30372,363,No,No,11047
Nebraska,2020/8/17,25.04833802,191,0,30563,363,No,No,11047
Nebraska,2020/8/18,25.04833802,262,7,30825,370,No,No,11047
Nebraska,2020/8/19,25.04833802,215,3,31040,373,No,No,8676
Nebraska,2020/8/20,25.04833802,308,4,31348,377,No,No,8676
Nebraska,2020/8/21,25.04833802,278,4,31626,381,No,No,8676
Nebraska,2020/8/22,25.04833802,154,1,31780,382,No,No,8676
Nebraska,2020/8/23,25.04833802,109,2,31889,384,No,No,8676
Nebraska,2020/8/24,25.04833802,158,0,32047,384,No,No,8676
Nebraska,2020/8/25,25.04833802,332,2,32379,386,No,No,8676
Nebraska,2020/8/26,25.04833802,348,4,32727,390,No,No,8511
Nebraska,2020/8/27,25.04833802,374,4,33101,394,No,No,8511
Nebraska,2020/8/28,25.04833802,335,5,33436,399,No,No,8511
Nebraska,2020/8/29,25.04833802,317,1,33753,400,No,No,8511
Nebraska,2020/8/30,25.04833802,293,0,34046,400,No,No,8511
Nebraska,2020/8/31,25.04833802,241,2,34287,402,No,No,8511
Nebraska,2020/9/1,25.04833802,287,3,34574,405,No,No,8511
Nebraska,2020/9/2,25.04833802,421,3,34995,408,No,No,8901
Nebraska,2020/9/3,25.04833802,474,2,35469,410,No,No,8901
Nebraska,2020/9/4,25.04833802,192,1,35661,411,No,No,8901
Nebraska,2020/9/5,25.04833802,144,4,35805,415,No,No,8901
Nebraska,2020/9/6,25.04833802,86,0,35891,415,No,No,8901
Nebraska,2020/9/7,25.04833802,84,0,35975,415,No,No,8901
Nebraska,2020/9/8,25.04833802,502,3,36477,418,No,No,8901
Nebraska,2020/9/9,25.04833802,440,16,36917,434,No,No,8848
Nebraska,2020/9/10,25.04833802,456,6,37373,440,No,No,8848
Nebraska,2020/9/11,25.04833802,468,9,37841,449,No,No,8848
Nebraska,2020/9/12,25.04833802,267,0,38108,449,No,No,8848
Nebraska,2020/9/13,25.04833802,80,0,38188,449,No,No,8848
Nebraska,2020/9/14,25.04833802,454,1,38642,450,No,No,8848
Nebraska,2020/9/15,25.04833802,328,1,38970,451,No,No,8848
Nebraska,2020/9/16,25.04833802,449,4,39419,455,No,No,8679
Nebraska,2020/9/17,25.04833802,502,2,39921,457,No,No,8679
Nebraska,2020/9/18,25.04833802,466,0,40387,457,No,No,8679
Nebraska,2020/9/19,25.04833802,410,0,40797,457,No,No,8679
Nebraska,2020/9/20,25.04833802,286,0,41083,457,No,No,8679
Nebraska,2020/9/21,25.04833802,305,7,41388,464,No,No,8679
Nebraska,2020/9/22,25.04833802,440,9,41828,473,No,No,8679
Nebraska,2020/9/23,25.04833802,450,4,42278,477,No,No,8805
Nebraska,2020/9/24,25.04833802,453,1,42731,478,No,No,8805
Nebraska,2020/9/25,25.04833802,431,5,43162,483,No,No,8805
Nebraska,2020/9/26,25.04833802,434,1,43596,484,No,No,8805
Nebraska,2020/9/27,25.04833802,467,1,44063,485,No,No,8805
Nebraska,2020/9/28,25.04833802,515,2,44578,487,No,No,8805
Nebraska,2020/9/29,25.04833802,466,6,45044,493,No,No,8805
Nebraska,2020/9/30,25.04833802,520,0,45564,493,No,No,7732
Nebraska,2020/10/1,25.04833802,621,4,46185,497,No,No,7732
Nebraska,2020/10/2,25.04833802,792,1,46977,498,No,No,7732
Nebraska,2020/10/3,25.04833802,426,5,47403,503,No,No,7732
Nebraska,2020/10/4,25.04833802,404,1,47807,504,No,No,7732
Nebraska,2020/10/5,25.04833802,452,5,48259,509,No,No,7732
Nebraska,2020/10/6,25.04833802,498,2,48757,511,No,No,7732
Nebraska,2020/10/7,25.04833802,639,5,49396,516,No,No,8581
Nebraska,2020/10/8,25.04833802,663,2,50059,518,No,No,8581
Nebraska,2020/10/9,25.04833802,109,4,50168,522,No,No,8581
Nebraska,2020/10/10,25.04833802,1719,3,51887,525,No,No,8581
Nebraska,2020/10/11,25.04833802,495,0,52382,525,No,No,8581
Nebraska,2020/10/12,25.04833802,457,4,52839,529,No,No,8581
Nebraska,2020/10/13,25.04833802,704,4,53543,533,No,No,8581
Nebraska,2020/10/14,25.04833802,924,3,54467,536,No,No,7964
Nebraska,2020/10/15,25.04833802,961,10,55428,546,No,No,7964
Nebraska,2020/10/16,25.04833802,1296,10,56724,556,No,No,7964
Nebraska,2020/10/17,25.04833802,610,1,57334,557,No,No,7964
Nebraska,2020/10/18,25.04833802,734,0,58068,557,No,No,7964
Nebraska,2020/10/19,25.04833802,749,11,58817,568,No,No,7964
Nebraska,2020/10/20,25.04833802,592,7,59409,575,No,No,7964
Nebraska,2020/10/21,25.04833802,899,11,60308,586,No,No,7126
Nebraska,2020/10/22,25.04833802,977,3,61285,589,No,No,7126
Nebraska,2020/10/23,25.04833802,1392,9,62677,598,No,No,7126
Nebraska,2020/10/24,25.04833802,587,9,63264,607,No,No,7126
Nebraska,2020/10/25,25.04833802,585,1,63849,608,No,No,7126
Nebraska,2020/10/26,25.04833802,843,4,64692,612,No,No,7126
Nebraska,2020/10/27,25.04833802,860,14,65552,626,No,No,7126
Nebraska,2020/10/28,25.04833802,1130,8,66682,634,No,No,7060
Nebraska,2020/10/29,25.04833802,1468,12,68150,646,No,No,7060
Nebraska,2020/10/30,25.04833802,1549,2,69699,648,No,No,7060
Nebraska,2020/10/31,25.04833802,1062,6,70761,654,No,No,7060
Nebraska,2020/11/1,25.04833802,905,7,71666,661,No,No,7060
Nebraska,2020/11/2,25.04833802,1239,1,72905,662,No,No,7060
Nebraska,2020/11/3,25.04833802,1215,3,74120,665,No,No,7060
Nebraska,2020/11/4,25.04833802,2025,11,76145,676,No,No,8764
Nebraska,2020/11/5,25.04833802,1916,5,78061,681,No,No,8764
Nebraska,2020/11/6,25.04833802,2632,29,80693,710,No,No,8764
Nebraska,2020/11/7,25.04833802,1702,5,82395,715,No,No,8764
Nebraska,2020/11/8,25.04833802,1574,0,83969,715,No,No,8764
Nebraska,2020/11/9,25.04833802,1582,4,85551,719,No,No,8764
Nebraska,2020/11/10,25.04833802,2192,26,87743,745,No,No,8764
Nebraska,2020/11/11,25.04833802,2234,0,89977,745,No,Yes,9262
Nebraska,2020/11/12,25.04833802,2760,27,92737,772,No,Yes,9262
Nebraska,2020/11/13,25.04833802,2273,22,95010,794,No,Yes,9262
Nebraska,2020/11/14,25.04833802,1824,1,96834,795,No,Yes,9262
Nebraska,2020/11/15,25.04833802,1327,1,98161,796,No,Yes,9262
Nebraska,2020/11/16,25.04833802,3546,14,101707,810,No,Yes,9262
Nebraska,2020/11/17,25.04833802,2098,22,103805,832,No,Yes,9262
Nebraska,2020/11/18,25.04833802,2812,10,106617,842,No,Yes,11813
Nebraska,2020/11/19,25.04833802,2708,24,109325,866,No,Yes,11813
Nebraska,2020/11/20,25.04833802,2590,59,111915,925,No,Yes,11813
Nebraska,2020/11/21,25.04833802,1310,8,113225,933,No,Yes,11813
Nebraska,2020/11/22,25.04833802,836,4,114061,937,No,Yes,11813
Nebraska,2020/11/23,25.04833802,2373,25,116434,962,No,Yes,11813
Nebraska,2020/11/24,25.04833802,1495,23,117929,985,No,Yes,11813
Nebraska,2020/11/25,25.04833802,2530,23,120459,1008,No,Yes,7061
Nebraska,2020/11/26,25.04833802,2665,3,123124,1011,No,Yes,7061
Nebraska,2020/11/27,25.04833802,1540,6,124664,1017,No,Yes,7061
Nebraska,2020/11/28,25.04833802,1156,4,125820,1021,No,Yes,7061
Nebraska,2020/11/29,25.04833802,1202,4,127022,1025,No,Yes,7061
Nebraska,2020/11/30,25.04833802,2021,22,129043,1047,No,Yes,7061
Nebraska,2020/12/1,25.04833802,1753,45,130796,1092,No,Yes,7061
Nebraska,2020/12/2,25.04833802,2343,47,133139,1139,No,Yes,7656
Nebraska,2020/12/3,25.04833802,1984,41,135123,1180,No,Yes,7656
Nebraska,2020/12/4,25.04833802,1845,25,136968,1205,No,Yes,7656
Nebraska,2020/12/5,25.04833802,2135,3,139103,1208,No,Yes,7656
Nebraska,2020/12/6,25.04833802,1215,11,140318,1219,No,Yes,7656
Nebraska,2020/12/7,25.04833802,1600,32,141918,1251,No,Yes,7656
Nebraska,2020/12/8,25.04833802,1410,44,143328,1295,No,Yes,7656
Nebraska,2020/12/9,25.04833802,1427,16,144755,1311,No,Yes,7568
Nebraska,2020/12/10,25.04833802,1701,47,146456,1358,No,Yes,7568
Nebraska,2020/12/11,25.04833802,1271,19,147727,1377,No,Yes,7568
Nebraska,2020/12/12,25.04833802,740,18,148467,1395,No,Yes,7568
Nebraska,2020/12/13,25.04833802,1228,4,149695,1399,No,Yes,7568
Nebraska,2020/12/14,25.04833802,627,43,150322,1442,No,Yes,7568
Nebraska,2020/12/15,25.04833802,1579,22,151901,1464,No,Yes,7568
Nebraska,2020/12/16,25.04833802,1343,8,153244,1472,No,Yes,7543
Nebraska,2020/12/17,25.04833802,1181,10,154425,1482,No,Yes,7543
Nebraska,2020/12/18,25.04833802,1339,18,155764,1500,No,Yes,7543
Nebraska,2020/12/19,25.04833802,669,5,156433,1505,No,Yes,7543
Nebraska,2020/12/20,25.04833802,738,10,157171,1515,No,Yes,7543
Nebraska,2020/12/21,25.04833802,948,25,158119,1540,No,Yes,7543
Nebraska,2020/12/22,25.04833802,1148,13,159267,1553,No,Yes,7543
Nebraska,2020/12/23,25.04833802,1319,44,160586,1597,No,Yes,5506
Nebraska,2020/12/24,25.04833802,752,4,161338,1601,No,Yes,5506
Nebraska,2020/12/25,25.04833802,622,-7,161960,1594,No,Yes,5506
Nebraska,2020/12/26,25.04833802,312,1,162272,1595,No,Yes,5506
Nebraska,2020/12/27,25.04833802,614,0,162886,1595,No,Yes,5506
Nebraska,2020/12/28,25.04833802,1017,30,163903,1625,No,Yes,5506
Nebraska,2020/12/29,25.04833802,989,16,164892,1641,No,Yes,5506
Nebraska,2020/12/30,25.04833802,1493,10,166385,1651,No,Yes,10986
Nebraska,2020/12/31,25.04833802,1410,39,167795,1690,No,Yes,10986
Nebraska,2021/1/1,25.04833802,772,17,168567,1707,No,No,10986
Nebraska,2021/1/2,25.04833802,763,1,169330,1708,No,No,10986
Nebraska,2021/1/3,25.04833802,707,0,170037,1708,No,No,10986
Nebraska,2021/1/4,25.04833802,741,19,170778,1727,No,No,10986
Nebraska,2021/1/5,25.04833802,1289,20,172067,1747,No,No,10986
Nebraska,2021/1/6,25.04833802,1558,9,173625,1756,No,No,14084
Nebraska,2021/1/7,25.04833802,965,125,174590,1881,No,No,14084
Nebraska,2021/1/8,25.04833802,1065,-73,175655,1808,No,No,14084
Nebraska,2021/1/9,25.04833802,990,4,176645,1812,No,No,14084
Nebraska,2021/1/10,25.04833802,356,3,177001,1815,No,No,14084
Nebraska,2021/1/11,25.04833802,654,20,177655,1835,No,No,14084
Nebraska,2021/1/12,25.04833802,1035,24,178690,1859,No,No,14084
Nebraska,2021/1/13,25.04833802,1470,11,180160,1870,No,No,11980
Nebraska,2021/1/14,25.04833802,931,15,181091,1885,No,No,11980
Nebraska,2021/1/15,25.04833802,804,19,181895,1904,No,No,11980
Nebraska,2021/1/16,25.04833802,0,0,181895,1904,No,No,11980
Nebraska,2021/1/17,25.04833802,1019,1,182914,1905,No,No,11980
Nebraska,2021/1/18,25.04833802,314,3,183228,1908,No,No,11980
Nebraska,2021/1/19,25.04833802,459,6,183687,1914,No,No,11980
Nebraska,2021/1/20,25.04833802,1969,22,185656,1936,No,No,11615
Nebraska,2021/1/21,25.04833802,816,13,186472,1949,No,No,11615
Nebraska,2021/1/22,25.04833802,1024,11,187496,1960,No,No,11615
Nebraska,2021/1/23,25.04833802,478,6,187974,1966,No,No,11615
Nebraska,2021/1/24,25.04833802,267,0,188241,1966,No,No,11615
Nebraska,2021/1/25,25.04833802,609,18,188850,1984,No,No,11615
Nebraska,2021/1/26,25.04833802,301,13,189151,1997,No,No,11615
Nebraska,2021/1/27,25.04833802,696,13,189847,2010,No,No,12664
Nebraska,2021/1/28,25.04833802,738,3,190585,2013,No,No,12664
Nebraska,2021/1/29,25.04833802,124,7,190709,2020,No,No,12664
Nebraska,2021/1/30,25.04833802,860,5,191569,2025,No,No,12664
Nebraska,2021/1/31,25.04833802,194,0,191763,2025,No,No,12664
Nebraska,2021/2/1,25.04833802,349,6,192112,2031,No,No,12664
Nebraska,2021/2/2,25.04833802,441,5,192553,2036,No,No,12664
Nebraska,2021/2/3,25.04833802,575,6,193128,2042,No,No,13464
Nebraska,2021/2/4,25.04833802,484,25,193612,2067,No,No,13464
Nebraska,2021/2/5,25.04833802,477,9,194089,2076,No,No,13464
Nebraska,2021/2/6,25.04833802,333,5,194422,2081,No,No,13464
Nebraska,2021/2/7,25.04833802,285,0,194707,2081,No,No,13464
Nebraska,2021/2/8,25.04833802,250,11,194957,2092,No,No,13464
Nebraska,2021/2/9,25.04833802,370,8,195327,2100,No,No,13464
Nebraska,2021/2/10,25.04833802,501,9,195828,2109,No,No,12087
Nebraska,2021/2/11,25.04833802,344,8,196172,2117,No,No,12087
Nebraska,2021/2/12,25.04833802,444,7,196616,2124,No,No,12087
Nebraska,2021/2/13,25.04833802,833,-1,197449,2123,No,No,12087
Nebraska,2021/2/14,25.04833802,209,0,197658,2123,No,No,12087
Nebraska,2021/2/15,25.04833802,103,1,197761,2124,No,No,12087
Nebraska,2021/2/16,25.04833802,143,4,197904,2128,No,No,12087
Nebraska,2021/2/17,25.04833802,311,18,198215,2146,No,No,11395
Nebraska,2021/2/18,25.04833802,266,5,198481,2151,No,No,11395
Nebraska,2021/2/19,25.04833802,468,16,198949,2167,No,No,11395
Nebraska,2021/2/20,25.04833802,213,2,199162,2169,No,No,11395
Nebraska,2021/2/21,25.04833802,200,0,199362,2169,No,No,11395
Nebraska,2021/2/22,25.04833802,257,2,199619,2171,No,No,11395
Nebraska,2021/2/23,25.04833802,218,1,199837,2172,No,No,11395
Nebraska,2021/2/24,25.04833802,423,7,200260,2179,No,No,11395
Nebraska,2021/2/25,25.04833802,403,4,200663,2183,No,No,11395
Nebraska,2021/2/26,25.04833802,203,12,200866,2195,No,No,11395
Nebraska,2021/2/27,25.04833802,239,4,201105,2199,No,No,11395
Nebraska,2021/2/28,25.04833802,193,0,201298,2199,No,No,11395
Nebraska,2021/3/1,25.04833802,258,6,201556,2205,No,No,11395
Nebraska,2021/3/2,25.04833802,338,5,201894,2210,No,No,11395
Nebraska,2021/3/3,25.04833802,288,3,202182,2213,No,No,11395
Nebraska,2021/3/4,25.04833802,339,0,202521,2213,No,No,11395
Nevada,2020/3/1,27.86462819,0,0,0,0,No,No,1575
Nevada,2020/3/2,27.86462819,0,0,0,0,No,No,1575
Nevada,2020/3/3,27.86462819,0,0,0,0,No,No,1575
Nevada,2020/3/4,27.86462819,0,0,0,0,No,No,1663
Nevada,2020/3/5,27.86462819,2,0,2,0,No,No,1663
Nevada,2020/3/6,27.86462819,0,0,2,0,No,No,1663
Nevada,2020/3/7,27.86462819,0,0,2,0,No,No,1663
Nevada,2020/3/8,27.86462819,2,0,4,0,No,No,1663
Nevada,2020/3/9,27.86462819,0,0,4,0,No,No,1663
Nevada,2020/3/10,27.86462819,0,0,4,0,No,No,1663
Nevada,2020/3/11,27.86462819,3,0,7,0,No,No,1819
Nevada,2020/3/12,27.86462819,4,0,11,0,No,No,1819
Nevada,2020/3/13,27.86462819,8,0,19,0,No,No,1819
Nevada,2020/3/14,27.86462819,2,0,21,0,No,No,1819
Nevada,2020/3/15,27.86462819,5,0,26,0,No,No,1819
Nevada,2020/3/16,27.86462819,19,1,45,1,No,No,1819
Nevada,2020/3/17,27.86462819,10,0,55,1,No,No,1819
Nevada,2020/3/18,27.86462819,27,0,82,1,No,No,10892
Nevada,2020/3/19,27.86462819,17,0,99,1,No,No,10892
Nevada,2020/3/20,27.86462819,66,1,165,2,No,No,10892
Nevada,2020/3/21,27.86462819,0,0,165,2,No,No,10892
Nevada,2020/3/22,27.86462819,25,0,190,2,No,No,10892
Nevada,2020/3/23,27.86462819,75,2,265,4,No,No,10892
Nevada,2020/3/24,27.86462819,50,2,315,6,No,No,10892
Nevada,2020/3/25,27.86462819,90,4,405,10,No,No,80984
Nevada,2020/3/26,27.86462819,130,0,535,10,No,No,80984
Nevada,2020/3/27,27.86462819,86,0,621,10,No,No,80984
Nevada,2020/3/28,27.86462819,117,4,738,14,No,No,80984
Nevada,2020/3/29,27.86462819,182,1,920,15,No,No,80984
Nevada,2020/3/30,27.86462819,124,3,1044,18,No,No,80984
Nevada,2020/3/31,27.86462819,69,8,1113,26,No,No,80984
Nevada,2020/4/1,27.86462819,166,6,1279,32,Yes,No,106739
Nevada,2020/4/2,27.86462819,179,6,1458,38,Yes,No,106739
Nevada,2020/4/3,27.86462819,91,5,1549,43,Yes,No,106739
Nevada,2020/4/4,27.86462819,209,3,1758,46,Yes,No,106739
Nevada,2020/4/5,27.86462819,122,0,1880,46,Yes,No,106739
Nevada,2020/4/6,27.86462819,91,12,1971,58,Yes,No,106739
Nevada,2020/4/7,27.86462819,130,2,2101,60,Yes,No,106739
Nevada,2020/4/8,27.86462819,217,20,2318,80,Yes,No,77515
Nevada,2020/4/9,27.86462819,138,2,2456,82,Yes,No,77515
Nevada,2020/4/10,27.86462819,150,4,2606,86,Yes,No,77515
Nevada,2020/4/11,27.86462819,114,25,2720,111,Yes,No,77515
Nevada,2020/4/12,27.86462819,140,2,2860,113,Yes,No,77515
Nevada,2020/4/13,27.86462819,176,1,3036,114,Yes,No,77515
Nevada,2020/4/14,27.86462819,101,16,3137,130,Yes,No,77515
Nevada,2020/4/15,27.86462819,75,7,3212,137,Yes,No,66432
Nevada,2020/4/16,27.86462819,109,5,3321,142,Yes,No,66432
Nevada,2020/4/17,27.86462819,203,9,3524,151,Yes,No,66432
Nevada,2020/4/18,27.86462819,102,4,3626,155,Yes,No,66432
Nevada,2020/4/19,27.86462819,84,3,3710,158,Yes,No,66432
Nevada,2020/4/20,27.86462819,120,5,3830,163,Yes,No,66432
Nevada,2020/4/21,27.86462819,107,0,3937,163,Yes,No,66432
Nevada,2020/4/22,27.86462819,144,24,4081,187,Yes,No,74966
Nevada,2020/4/23,27.86462819,127,8,4208,195,Yes,No,74966
Nevada,2020/4/24,27.86462819,190,8,4398,203,Yes,No,74966
Nevada,2020/4/25,27.86462819,141,3,4539,206,Yes,No,74966
Nevada,2020/4/26,27.86462819,99,0,4638,206,Yes,No,74966
Nevada,2020/4/27,27.86462819,70,13,4708,219,Yes,No,74966
Nevada,2020/4/28,27.86462819,104,6,4812,225,Yes,No,74966
Nevada,2020/4/29,27.86462819,122,12,4934,237,Yes,No,28985
Nevada,2020/4/30,27.86462819,119,6,5053,243,Yes,No,28985
Nevada,2020/5/1,27.86462819,196,11,5249,254,Yes,No,28985
Nevada,2020/5/2,27.86462819,141,3,5390,257,Yes,No,28985
Nevada,2020/5/3,27.86462819,83,5,5473,262,Yes,No,28985
Nevada,2020/5/4,27.86462819,154,4,5627,266,Yes,No,28985
Nevada,2020/5/5,27.86462819,38,10,5665,276,Yes,No,28985
Nevada,2020/5/6,27.86462819,79,10,5744,286,Yes,No,26666
Nevada,2020/5/7,27.86462819,114,7,5858,293,Yes,No,26666
Nevada,2020/5/8,27.86462819,84,8,5942,301,Yes,No,26666
Nevada,2020/5/9,27.86462819,104,5,6046,306,Yes,No,26666
Nevada,2020/5/10,27.86462819,74,0,6120,306,Yes,No,26666
Nevada,2020/5/11,27.86462819,32,6,6152,312,Yes,No,26666
Nevada,2020/5/12,27.86462819,159,9,6311,321,Yes,No,26666
Nevada,2020/5/13,27.86462819,171,10,6482,331,Yes,No,25150
Nevada,2020/5/14,27.86462819,122,8,6604,339,Yes,No,25150
Nevada,2020/5/15,27.86462819,129,6,6733,345,Yes,No,25150
Nevada,2020/5/16,27.86462819,77,4,6810,349,No,No,25150
Nevada,2020/5/17,27.86462819,125,1,6935,350,No,No,25150
Nevada,2020/5/18,27.86462819,124,14,7059,364,No,No,25150
Nevada,2020/5/19,27.86462819,110,9,7169,373,No,No,25150
Nevada,2020/5/20,27.86462819,132,5,7301,378,No,No,27919
Nevada,2020/5/21,27.86462819,103,3,7404,381,No,No,27919
Nevada,2020/5/22,27.86462819,127,6,7531,387,No,No,27919
Nevada,2020/5/23,27.86462819,238,5,7769,392,No,No,27919
Nevada,2020/5/24,27.86462819,117,2,7886,394,No,No,27919
Nevada,2020/5/25,27.86462819,73,2,7959,396,No,No,27919
Nevada,2020/5/26,27.86462819,100,0,8059,396,No,No,27919
Nevada,2020/5/27,27.86462819,91,6,8150,402,No,No,21335
Nevada,2020/5/28,27.86462819,97,8,8247,410,No,No,21335
Nevada,2020/5/29,27.86462819,128,5,8375,415,No,No,21335
Nevada,2020/5/30,27.86462819,144,2,8519,417,No,No,21335
Nevada,2020/5/31,27.86462819,109,2,8628,419,No,No,21335
Nevada,2020/6/1,27.86462819,73,1,8701,420,No,No,21335
Nevada,2020/6/2,27.86462819,157,0,8858,420,No,No,21335
Nevada,2020/6/3,27.86462819,92,9,8950,429,No,No,19949
Nevada,2020/6/4,27.86462819,168,0,9118,429,No,No,19949
Nevada,2020/6/5,27.86462819,188,7,9306,436,No,No,19949
Nevada,2020/6/6,27.86462819,188,1,9494,437,No,No,19949
Nevada,2020/6/7,27.86462819,179,1,9673,438,No,No,19949
Nevada,2020/6/8,27.86462819,142,4,9815,442,No,No,19949
Nevada,2020/6/9,27.86462819,231,3,10046,445,No,No,19949
Nevada,2020/6/10,27.86462819,170,4,10216,449,No,No,18367
Nevada,2020/6/11,27.86462819,248,11,10464,460,No,No,18367
Nevada,2020/6/12,27.86462819,240,2,10704,462,No,No,18367
Nevada,2020/6/13,27.86462819,288,1,10992,463,No,No,18367
Nevada,2020/6/14,27.86462819,207,1,11199,464,No,No,18367
Nevada,2020/6/15,27.86462819,117,2,11316,466,No,No,18367
Nevada,2020/6/16,27.86462819,357,1,11673,467,No,No,18367
Nevada,2020/6/17,27.86462819,179,6,11852,473,No,No,18671
Nevada,2020/6/18,27.86462819,312,2,12164,475,No,No,18671
Nevada,2020/6/19,27.86462819,361,4,12525,479,No,No,18671
Nevada,2020/6/20,27.86462819,452,7,12977,486,No,No,18671
Nevada,2020/6/21,27.86462819,259,1,13236,487,No,No,18671
Nevada,2020/6/22,27.86462819,339,3,13575,490,No,No,18671
Nevada,2020/6/23,27.86462819,483,2,14058,492,No,No,18671
Nevada,2020/6/24,27.86462819,402,2,14460,494,No,No,18338
Nevada,2020/6/25,27.86462819,451,1,14911,495,No,No,18338
Nevada,2020/6/26,27.86462819,448,3,15359,498,No,No,18338
Nevada,2020/6/27,27.86462819,1041,2,16400,500,No,No,18338
Nevada,2020/6/28,27.86462819,787,0,17187,500,No,No,18338
Nevada,2020/6/29,27.86462819,784,5,17971,505,No,No,18338
Nevada,2020/6/30,27.86462819,611,2,18582,507,No,No,18338
Nevada,2020/7/1,27.86462819,569,5,19151,512,No,No,19056
Nevada,2020/7/2,27.86462819,720,13,19871,525,No,No,19056
Nevada,2020/7/3,27.86462819,1007,5,20878,530,No,No,19056
Nevada,2020/7/4,27.86462819,793,0,21671,530,No,No,19056
Nevada,2020/7/5,27.86462819,847,7,22518,537,No,No,19056
Nevada,2020/7/6,27.86462819,412,0,22930,537,No,No,19056
Nevada,2020/7/7,27.86462819,918,12,23848,549,No,No,19056
Nevada,2020/7/8,27.86462819,530,7,24378,556,No,No,20563
Nevada,2020/7/9,27.86462819,677,18,25055,574,No,No,20563
Nevada,2020/7/10,27.86462819,906,7,25961,581,No,No,20563
Nevada,2020/7/11,27.86462819,951,11,26912,592,No,No,20563
Nevada,2020/7/12,27.86462819,833,1,27745,593,No,No,20563
Nevada,2020/7/13,27.86462819,852,3,28597,596,No,No,20563
Nevada,2020/7/14,27.86462819,1072,17,29669,613,No,No,20563
Nevada,2020/7/15,27.86462819,918,6,30587,619,No,No,23676
Nevada,2020/7/16,27.86462819,1437,8,32024,627,No,No,23676
Nevada,2020/7/17,27.86462819,1348,11,33372,638,No,No,23676
Nevada,2020/7/18,27.86462819,1234,9,34606,647,No,No,23676
Nevada,2020/7/19,27.86462819,1220,1,35826,648,No,No,23676
Nevada,2020/7/20,27.86462819,979,2,36805,650,No,No,23676
Nevada,2020/7/21,27.86462819,800,30,37605,680,No,No,23676
Nevada,2020/7/22,27.86462819,1154,25,38759,705,No,No,17437
Nevada,2020/7/23,27.86462819,1329,4,40088,709,No,No,17437
Nevada,2020/7/24,27.86462819,925,13,41013,722,No,No,17437
Nevada,2020/7/25,27.86462819,980,11,41993,733,No,No,17437
Nevada,2020/7/26,27.86462819,926,1,42919,734,No,No,17437
Nevada,2020/7/27,27.86462819,961,5,43880,739,No,No,17437
Nevada,2020/7/28,27.86462819,1111,21,44991,760,No,No,17437
Nevada,2020/7/29,27.86462819,946,22,45937,782,No,No,11690
Nevada,2020/7/30,27.86462819,1097,23,47034,805,No,No,11690
Nevada,2020/7/31,27.86462819,1108,26,48142,831,No,No,11690
Nevada,2020/8/1,27.86462819,1065,1,49207,832,No,No,11690
Nevada,2020/8/2,27.86462819,1063,1,50270,833,No,No,11690
Nevada,2020/8/3,27.86462819,966,14,51236,847,No,No,11690
Nevada,2020/8/4,27.86462819,1020,15,52256,862,No,No,11690
Nevada,2020/8/5,27.86462819,663,29,52919,891,No,No,9467
Nevada,2020/8/6,27.86462819,786,10,53705,901,No,No,9467
Nevada,2020/8/7,27.86462819,928,19,54633,920,No,No,9467
Nevada,2020/8/8,27.86462819,848,29,55481,949,No,No,9467
Nevada,2020/8/9,27.86462819,797,10,56278,959,No,No,9467
Nevada,2020/8/10,27.86462819,744,4,57022,963,No,No,9467
Nevada,2020/8/11,27.86462819,586,19,57608,982,No,No,9467
Nevada,2020/8/12,27.86462819,524,17,58132,999,No,No,11047
Nevada,2020/8/13,27.86462819,680,31,58812,1030,No,No,11047
Nevada,2020/8/14,27.86462819,988,15,59800,1045,No,No,11047
Nevada,2020/8/15,27.86462819,848,25,60648,1070,No,No,11047
Nevada,2020/8/16,27.86462819,726,4,61374,1074,No,No,11047
Nevada,2020/8/17,27.86462819,648,3,62022,1077,No,No,11047
Nevada,2020/8/18,27.86462819,730,25,62752,1102,No,No,11047
Nevada,2020/8/19,27.86462819,375,33,63127,1135,No,No,8676
Nevada,2020/8/20,27.86462819,572,40,63699,1175,No,No,8676
Nevada,2020/8/21,27.86462819,874,10,64573,1185,No,No,8676
Nevada,2020/8/22,27.86462819,577,12,65150,1197,No,No,8676
Nevada,2020/8/23,27.86462819,528,2,65678,1199,No,No,8676
Nevada,2020/8/24,27.86462819,395,1,66073,1200,No,No,8676
Nevada,2020/8/25,27.86462819,442,30,66515,1230,No,No,8676
Nevada,2020/8/26,27.86462819,217,20,66732,1250,No,No,8511
Nevada,2020/8/27,27.86462819,592,24,67324,1274,No,No,8511
Nevada,2020/8/28,27.86462819,660,13,67984,1287,No,No,8511
Nevada,2020/8/29,27.86462819,592,16,68576,1303,No,No,8511
Nevada,2020/8/30,27.86462819,405,2,68981,1305,No,No,8511
Nevada,2020/8/31,27.86462819,337,0,69318,1305,No,No,8511
Nevada,2020/9/1,27.86462819,390,8,69708,1313,No,No,8511
Nevada,2020/9/2,27.86462819,219,25,69927,1338,No,No,8901
Nevada,2020/9/3,27.86462819,392,28,70319,1366,No,No,8901
Nevada,2020/9/4,27.86462819,464,10,70783,1376,No,No,8901
Nevada,2020/9/5,27.86462819,401,14,71184,1390,No,No,8901
Nevada,2020/9/6,27.86462819,527,4,71711,1394,No,No,8901
Nevada,2020/9/7,27.86462819,337,0,72048,1394,No,No,8901
Nevada,2020/9/8,27.86462819,117,1,72165,1395,No,No,8901
Nevada,2020/9/9,27.86462819,152,19,72317,1414,No,No,8848
Nevada,2020/9/10,27.86462819,303,18,72620,1432,No,No,8848
Nevada,2020/9/11,27.86462819,266,9,72886,1441,No,No,8848
Nevada,2020/9/12,27.86462819,405,12,73291,1453,No,No,8848
Nevada,2020/9/13,27.86462819,357,1,73648,1454,No,No,8848
Nevada,2020/9/14,27.86462819,241,2,73889,1456,No,No,8848
Nevada,2020/9/15,27.86462819,240,28,74129,1484,No,No,8848
Nevada,2020/9/16,27.86462819,248,12,74377,1496,No,No,8679
Nevada,2020/9/17,27.86462819,415,13,74792,1509,No,No,8679
Nevada,2020/9/18,27.86462819,361,17,75153,1526,No,No,8679
Nevada,2020/9/19,27.86462819,371,2,75524,1528,No,No,8679
Nevada,2020/9/20,27.86462819,390,4,75914,1532,No,No,8679
Nevada,2020/9/21,27.86462819,205,-1,76119,1531,No,No,8679
Nevada,2020/9/22,27.86462819,257,15,76376,1546,No,No,8679
Nevada,2020/9/23,27.86462819,531,10,76907,1556,No,No,8805
Nevada,2020/9/24,27.86462819,431,9,77338,1565,No,No,8805
Nevada,2020/9/25,27.86462819,592,8,77930,1573,No,No,8805
Nevada,2020/9/26,27.86462819,534,10,78464,1583,No,No,8805
Nevada,2020/9/27,27.86462819,356,2,78820,1585,No,No,8805
Nevada,2020/9/28,27.86462819,493,1,79313,1586,No,No,8805
Nevada,2020/9/29,27.86462819,378,8,79691,1594,No,No,8805
Nevada,2020/9/30,27.86462819,393,6,80084,1600,No,No,7732
Nevada,2020/10/1,27.86462819,423,3,80507,1603,No,No,7732
Nevada,2020/10/2,27.86462819,778,8,81285,1611,No,No,7732
Nevada,2020/10/3,27.86462819,544,12,81829,1623,No,No,7732
Nevada,2020/10/4,27.86462819,305,0,82134,1623,No,No,7732
Nevada,2020/10/5,27.86462819,410,1,82544,1624,No,No,7732
Nevada,2020/10/6,27.86462819,492,6,83036,1630,No,No,7732
Nevada,2020/10/7,27.86462819,464,9,83500,1639,No,No,8581
Nevada,2020/10/8,27.86462819,471,11,83971,1650,No,No,8581
Nevada,2020/10/9,27.86462819,814,8,84785,1658,No,No,8581
Nevada,2020/10/10,27.86462819,678,1,85463,1659,No,No,8581
Nevada,2020/10/11,27.86462819,459,4,85922,1663,No,No,8581
Nevada,2020/10/12,27.86462819,511,7,86433,1670,No,No,8581
Nevada,2020/10/13,27.86462819,537,7,86970,1677,No,No,8581
Nevada,2020/10/14,27.86462819,557,17,87527,1694,No,No,7964
Nevada,2020/10/15,27.86462819,554,6,88081,1700,No,No,7964
Nevada,2020/10/16,27.86462819,751,7,88832,1707,No,No,7964
Nevada,2020/10/17,27.86462819,1016,2,89848,1709,No,No,7964
Nevada,2020/10/18,27.86462819,526,2,90374,1711,No,No,7964
Nevada,2020/10/19,27.86462819,604,3,90978,1714,No,No,7964
Nevada,2020/10/20,27.86462819,701,14,91679,1728,No,No,7964
Nevada,2020/10/21,27.86462819,514,7,92193,1735,No,No,7126
Nevada,2020/10/22,27.86462819,835,1,93028,1736,No,No,7126
Nevada,2020/10/23,27.86462819,1016,3,94044,1739,No,No,7126
Nevada,2020/10/24,27.86462819,891,7,94935,1746,No,No,7126
Nevada,2020/10/25,27.86462819,863,2,95798,1748,No,No,7126
Nevada,2020/10/26,27.86462819,532,3,96330,1751,No,No,7126
Nevada,2020/10/27,27.86462819,808,6,97138,1757,No,No,7126
Nevada,2020/10/28,27.86462819,686,10,97824,1767,No,No,7060
Nevada,2020/10/29,27.86462819,990,3,98814,1770,No,No,7060
Nevada,2020/10/30,27.86462819,1224,7,100038,1777,No,No,7060
Nevada,2020/10/31,27.86462819,806,2,100844,1779,No,No,7060
Nevada,2020/11/1,27.86462819,750,4,101594,1783,No,No,7060
Nevada,2020/11/2,27.86462819,649,2,102243,1785,No,No,7060
Nevada,2020/11/3,27.86462819,1062,22,103305,1807,No,No,7060
Nevada,2020/11/4,27.86462819,1209,9,104514,1816,No,No,8764
Nevada,2020/11/5,27.86462819,1192,9,105706,1825,No,No,8764
Nevada,2020/11/6,27.86462819,1552,21,107258,1846,No,No,8764
Nevada,2020/11/7,27.86462819,2068,5,109326,1851,No,No,8764
Nevada,2020/11/8,27.86462819,982,1,110308,1852,No,No,8764
Nevada,2020/11/9,27.86462819,1015,1,111323,1853,No,No,8764
Nevada,2020/11/10,27.86462819,1279,10,112602,1863,No,No,8764
Nevada,2020/11/11,27.86462819,1254,14,113856,1877,No,No,9262
Nevada,2020/11/12,27.86462819,1504,3,115360,1880,No,No,9262
Nevada,2020/11/13,27.86462819,1962,16,117322,1896,No,No,9262
Nevada,2020/11/14,27.86462819,1906,12,119228,1908,No,No,9262
Nevada,2020/11/15,27.86462819,1516,5,120744,1913,No,No,9262
Nevada,2020/11/16,27.86462819,1697,6,122441,1919,No,No,9262
Nevada,2020/11/17,27.86462819,1641,27,124082,1946,No,No,9262
Nevada,2020/11/18,27.86462819,2024,1,126106,1947,No,No,11813
Nevada,2020/11/19,27.86462819,2128,11,128234,1958,No,No,11813
Nevada,2020/11/20,27.86462819,1868,29,130102,1987,No,No,11813
Nevada,2020/11/21,27.86462819,2508,30,132610,2017,No,No,11813
Nevada,2020/11/22,27.86462819,2151,5,134761,2022,No,No,11813
Nevada,2020/11/23,27.86462819,1911,8,136672,2030,No,No,11813
Nevada,2020/11/24,27.86462819,3900,23,140572,2053,No,No,11813
Nevada,2020/11/25,27.86462819,2379,24,142951,2077,No,No,7061
Nevada,2020/11/26,27.86462819,1843,16,144794,2093,No,No,7061
Nevada,2020/11/27,27.86462819,2351,10,147145,2103,No,No,7061
Nevada,2020/11/28,27.86462819,2468,20,149613,2123,No,No,7061
Nevada,2020/11/29,27.86462819,1212,17,150825,2140,No,No,7061
Nevada,2020/11/30,27.86462819,1901,9,152726,2149,No,No,7061
Nevada,2020/12/1,27.86462819,2586,33,155312,2182,No,No,7061
Nevada,2020/12/2,27.86462819,2274,43,157586,2225,No,No,7656
Nevada,2020/12/3,27.86462819,2731,34,160317,2259,No,No,7656
Nevada,2020/12/4,27.86462819,2748,17,163065,2276,No,No,7656
Nevada,2020/12/5,27.86462819,3122,33,166187,2309,No,No,7656
Nevada,2020/12/6,27.86462819,2571,9,168758,2318,No,No,7656
Nevada,2020/12/7,27.86462819,2401,8,171159,2326,No,No,7656
Nevada,2020/12/8,27.86462819,2891,42,174050,2368,No,No,7656
Nevada,2020/12/9,27.86462819,2624,27,176674,2395,No,No,7568
Nevada,2020/12/10,27.86462819,2735,53,179409,2448,No,No,7568
Nevada,2020/12/11,27.86462819,2513,40,181922,2488,No,No,7568
Nevada,2020/12/12,27.86462819,2605,42,184527,2530,No,No,7568
Nevada,2020/12/13,27.86462819,2975,15,187502,2545,No,No,7568
Nevada,2020/12/14,27.86462819,2303,12,189805,2557,No,No,7568
Nevada,2020/12/15,27.86462819,2304,52,192109,2609,No,No,7568
Nevada,2020/12/16,27.86462819,2352,50,194461,2659,No,No,7543
Nevada,2020/12/17,27.86462819,2598,21,197059,2680,No,No,7543
Nevada,2020/12/18,27.86462819,2973,48,200032,2728,No,No,7543
Nevada,2020/12/19,27.86462819,2132,26,202164,2754,No,No,7543
Nevada,2020/12/20,27.86462819,2063,32,204227,2786,No,No,7543
Nevada,2020/12/21,27.86462819,1968,15,206195,2801,No,No,7543
Nevada,2020/12/22,27.86462819,1156,31,207351,2832,No,No,7543
Nevada,2020/12/23,27.86462819,2968,53,210319,2885,No,No,5506
Nevada,2020/12/24,27.86462819,2343,41,212662,2926,No,No,5506
Nevada,2020/12/25,27.86462819,1415,17,214077,2943,No,No,5506
Nevada,2020/12/26,27.86462819,2252,8,216329,2951,No,No,5506
Nevada,2020/12/27,27.86462819,1324,14,217653,2965,No,No,5506
Nevada,2020/12/28,27.86462819,1013,8,218666,2973,No,No,5506
Nevada,2020/12/29,27.86462819,1725,62,220391,3035,No,No,5506
Nevada,2020/12/30,27.86462819,2642,46,223033,3081,No,No,10986
Nevada,2020/12/31,27.86462819,2145,55,225178,3136,No,No,10986
Nevada,2021/1/1,27.86462819,1868,10,227046,3146,No,No,10986
Nevada,2021/1/2,27.86462819,2555,12,229601,3158,No,No,10986
Nevada,2021/1/3,27.86462819,2268,37,231869,3195,No,No,10986
Nevada,2021/1/4,27.86462819,1468,14,233337,3209,No,No,10986
Nevada,2021/1/5,27.86462819,2386,37,235723,3246,No,No,10986
Nevada,2021/1/6,27.86462819,2065,55,237788,3301,No,No,14084
Nevada,2021/1/7,27.86462819,3369,48,241157,3349,No,No,14084
Nevada,2021/1/8,27.86462819,2959,60,244116,3409,No,No,14084
Nevada,2021/1/9,27.86462819,2543,48,246659,3457,No,No,14084
Nevada,2021/1/10,27.86462819,2099,13,248758,3470,No,No,14084
Nevada,2021/1/11,27.86462819,1726,33,250484,3503,No,No,14084
Nevada,2021/1/12,27.86462819,2616,48,253100,3551,No,No,14084
Nevada,2021/1/13,27.86462819,956,45,254056,3596,No,No,11980
Nevada,2021/1/14,27.86462819,2420,68,256476,3664,No,No,11980
Nevada,2021/1/15,27.86462819,1975,40,258451,3704,No,No,11980
Nevada,2021/1/16,27.86462819,1771,60,260222,3764,No,No,11980
Nevada,2021/1/17,27.86462819,1625,20,261847,3784,No,No,11980
Nevada,2021/1/18,27.86462819,1033,0,262880,3784,No,No,11980
Nevada,2021/1/19,27.86462819,1356,10,264236,3794,No,No,11980
Nevada,2021/1/20,27.86462819,1005,75,265241,3869,No,No,11615
Nevada,2021/1/21,27.86462819,1415,46,266656,3915,No,No,11615
Nevada,2021/1/22,27.86462819,1701,52,268357,3967,No,No,11615
Nevada,2021/1/23,27.86462819,1571,50,269928,4017,No,No,11615
Nevada,2021/1/24,27.86462819,1101,10,271029,4027,No,No,11615
Nevada,2021/1/25,27.86462819,990,5,272019,4032,No,No,11615
Nevada,2021/1/26,27.86462819,923,60,272942,4092,No,No,11615
Nevada,2021/1/27,27.86462819,1100,47,274042,4139,No,No,12664
Nevada,2021/1/28,27.86462819,1096,49,275138,4188,No,No,12664
Nevada,2021/1/29,27.86462819,1382,37,276520,4225,No,No,12664
Nevada,2021/1/30,27.86462819,1040,43,277560,4268,No,No,12664
Nevada,2021/1/31,27.86462819,900,3,278460,4271,No,No,12664
Nevada,2021/2/1,27.86462819,781,10,279241,4281,No,No,12664
Nevada,2021/2/2,27.86462819,797,47,280038,4328,No,No,12664
Nevada,2021/2/3,27.86462819,810,48,280848,4376,No,No,13464
Nevada,2021/2/4,27.86462819,945,52,281793,4428,No,No,13464
Nevada,2021/2/5,27.86462819,920,38,282713,4466,No,No,13464
Nevada,2021/2/6,27.86462819,750,32,283463,4498,No,No,13464
Nevada,2021/2/7,27.86462819,674,23,284137,4521,No,No,13464
Nevada,2021/2/8,27.86462819,555,3,284692,4524,No,No,13464
Nevada,2021/2/9,27.86462819,499,41,285191,4565,No,No,13464
Nevada,2021/2/10,27.86462819,691,20,285882,4585,No,No,12087
Nevada,2021/2/11,27.86462819,645,55,286527,4640,No,No,12087
Nevada,2021/2/12,27.86462819,577,28,287104,4668,No,No,12087
Nevada,2021/2/13,27.86462819,780,27,287884,4695,No,No,12087
Nevada,2021/2/14,27.86462819,609,14,288493,4709,No,No,12087
Nevada,2021/2/15,27.86462819,284,13,288777,4722,No,No,12087
Nevada,2021/2/16,27.86462819,330,14,289107,4736,No,No,12087
Nevada,2021/2/17,27.86462819,371,40,289478,4776,No,No,11395
Nevada,2021/2/18,27.86462819,497,31,289975,4807,No,No,11395
Nevada,2021/2/19,27.86462819,437,31,290412,4838,No,No,11395
Nevada,2021/2/20,27.86462819,334,32,290746,4870,No,No,11395
Nevada,2021/2/21,27.86462819,280,2,291026,4872,No,No,11395
Nevada,2021/2/22,27.86462819,185,10,291211,4882,No,No,11395
Nevada,2021/2/23,27.86462819,497,21,291708,4903,No,No,11395
Nevada,2021/2/24,27.86462819,405,19,292113,4922,No,No,11395
Nevada,2021/2/25,27.86462819,589,12,292702,4934,No,No,11395
Nevada,2021/2/26,27.86462819,463,8,293165,4942,No,No,11395
Nevada,2021/2/27,27.86462819,369,15,293534,4957,No,No,11395
Nevada,2021/2/28,27.86462819,281,0,293815,4957,No,No,11395
Nevada,2021/3/1,27.86462819,245,0,294060,4957,No,No,11395
Nevada,2021/3/2,27.86462819,276,15,294336,4972,No,No,11395
Nevada,2021/3/3,27.86462819,419,16,294755,4988,No,No,11395
Nevada,2021/3/4,27.86462819,424,17,295179,5005,No,No,11395
New Hampshire,2020/3/1,146.1426268,0,0,0,0,No,No,1575
New Hampshire,2020/3/2,146.1426268,1,0,1,0,No,No,1575
New Hampshire,2020/3/3,146.1426268,1,0,2,0,No,No,1575
New Hampshire,2020/3/4,146.1426268,0,0,2,0,No,No,1663
New Hampshire,2020/3/5,146.1426268,0,0,2,0,No,No,1663
New Hampshire,2020/3/6,146.1426268,0,0,2,0,No,No,1663
New Hampshire,2020/3/7,146.1426268,2,0,4,0,No,No,1663
New Hampshire,2020/3/8,146.1426268,0,0,4,0,No,No,1663
New Hampshire,2020/3/9,146.1426268,0,0,4,0,No,No,1663
New Hampshire,2020/3/10,146.1426268,1,0,5,0,No,No,1663
New Hampshire,2020/3/11,146.1426268,0,0,5,0,No,No,1819
New Hampshire,2020/3/12,146.1426268,1,0,6,0,No,No,1819
New Hampshire,2020/3/13,146.1426268,1,0,7,0,No,No,1819
New Hampshire,2020/3/14,146.1426268,0,0,7,0,No,No,1819
New Hampshire,2020/3/15,146.1426268,6,0,13,0,No,No,1819
New Hampshire,2020/3/16,146.1426268,4,0,17,0,No,No,1819
New Hampshire,2020/3/17,146.1426268,9,0,26,0,No,No,1819
New Hampshire,2020/3/18,146.1426268,13,0,39,0,No,No,10892
New Hampshire,2020/3/19,146.1426268,5,0,44,0,No,No,10892
New Hampshire,2020/3/20,146.1426268,11,0,55,0,No,No,10892
New Hampshire,2020/3/21,146.1426268,10,0,65,0,No,No,10892
New Hampshire,2020/3/22,146.1426268,13,0,78,0,No,No,10892
New Hampshire,2020/3/23,146.1426268,23,1,101,1,No,No,10892
New Hampshire,2020/3/24,146.1426268,7,0,108,1,No,No,10892
New Hampshire,2020/3/25,146.1426268,29,0,137,1,No,No,80984
New Hampshire,2020/3/26,146.1426268,21,0,158,1,No,No,80984
New Hampshire,2020/3/27,146.1426268,29,1,187,2,Yes,No,80984
New Hampshire,2020/3/28,146.1426268,27,0,214,2,Yes,No,80984
New Hampshire,2020/3/29,146.1426268,44,1,258,3,Yes,No,80984
New Hampshire,2020/3/30,146.1426268,56,0,314,3,Yes,No,80984
New Hampshire,2020/3/31,146.1426268,53,0,367,3,Yes,No,80984
New Hampshire,2020/4/1,146.1426268,48,1,415,4,Yes,No,106739
New Hampshire,2020/4/2,146.1426268,64,1,479,5,Yes,No,106739
New Hampshire,2020/4/3,146.1426268,61,2,540,7,Yes,No,106739
New Hampshire,2020/4/4,146.1426268,81,2,621,9,Yes,No,106739
New Hampshire,2020/4/5,146.1426268,48,0,669,9,Yes,No,106739
New Hampshire,2020/4/6,146.1426268,46,0,715,9,Yes,No,106739
New Hampshire,2020/4/7,146.1426268,32,4,747,13,Yes,No,106739
New Hampshire,2020/4/8,146.1426268,41,5,788,18,Yes,No,77515
New Hampshire,2020/4/9,146.1426268,31,3,819,21,Yes,No,77515
New Hampshire,2020/4/10,146.1426268,66,1,885,22,Yes,No,77515
New Hampshire,2020/4/11,146.1426268,44,1,929,23,Yes,No,77515
New Hampshire,2020/4/12,146.1426268,56,0,985,23,Yes,No,77515
New Hampshire,2020/4/13,146.1426268,35,0,1020,23,Yes,No,77515
New Hampshire,2020/4/14,146.1426268,71,4,1091,27,Yes,No,77515
New Hampshire,2020/4/15,146.1426268,48,5,1139,32,Yes,No,66432
New Hampshire,2020/4/16,146.1426268,72,2,1211,34,Yes,No,66432
New Hampshire,2020/4/17,146.1426268,76,3,1287,37,Yes,No,66432
New Hampshire,2020/4/18,146.1426268,55,1,1342,38,Yes,No,66432
New Hampshire,2020/4/19,146.1426268,50,3,1392,41,Yes,No,66432
New Hampshire,2020/4/20,146.1426268,55,1,1447,42,Yes,No,66432
New Hampshire,2020/4/21,146.1426268,44,0,1491,42,Yes,No,66432
New Hampshire,2020/4/22,146.1426268,97,6,1588,48,Yes,No,74966
New Hampshire,2020/4/23,146.1426268,82,3,1670,51,Yes,No,74966
New Hampshire,2020/4/24,146.1426268,50,2,1720,53,Yes,No,74966
New Hampshire,2020/4/25,146.1426268,73,7,1793,60,Yes,No,74966
New Hampshire,2020/4/26,146.1426268,71,0,1864,60,Yes,No,74966
New Hampshire,2020/4/27,146.1426268,74,0,1938,60,Yes,No,74966
New Hampshire,2020/4/28,146.1426268,72,0,2010,60,Yes,No,74966
New Hampshire,2020/4/29,146.1426268,44,6,2054,66,Yes,No,28985
New Hampshire,2020/4/30,146.1426268,92,6,2146,72,Yes,No,28985
New Hampshire,2020/5/1,146.1426268,164,9,2310,81,Yes,No,28985
New Hampshire,2020/5/2,146.1426268,119,3,2429,84,Yes,No,28985
New Hampshire,2020/5/3,146.1426268,89,2,2518,86,Yes,No,28985
New Hampshire,2020/5/4,146.1426268,70,0,2588,86,Yes,No,28985
New Hampshire,2020/5/5,146.1426268,48,6,2636,92,Yes,No,28985
New Hampshire,2020/5/6,146.1426268,105,19,2741,111,Yes,No,26666
New Hampshire,2020/5/7,146.1426268,102,3,2843,114,Yes,No,26666
New Hampshire,2020/5/8,146.1426268,104,7,2947,121,Yes,No,26666
New Hampshire,2020/5/9,146.1426268,64,10,3011,131,Yes,No,26666
New Hampshire,2020/5/10,146.1426268,60,2,3071,133,Yes,No,26666
New Hampshire,2020/5/11,146.1426268,89,0,3160,133,Yes,No,26666
New Hampshire,2020/5/12,146.1426268,79,9,3239,142,Yes,No,26666
New Hampshire,2020/5/13,146.1426268,60,8,3299,150,Yes,No,25150
New Hampshire,2020/5/14,146.1426268,83,1,3382,151,Yes,No,25150
New Hampshire,2020/5/15,146.1426268,82,8,3464,159,Yes,No,25150
New Hampshire,2020/5/16,146.1426268,92,12,3556,171,Yes,No,25150
New Hampshire,2020/5/17,146.1426268,40,1,3596,172,Yes,No,25150
New Hampshire,2020/5/18,146.1426268,56,0,3652,172,Yes,No,25150
New Hampshire,2020/5/19,146.1426268,69,10,3721,182,Yes,No,25150
New Hampshire,2020/5/20,146.1426268,147,8,3868,190,Yes,No,27919
New Hampshire,2020/5/21,146.1426268,67,9,3935,199,Yes,No,27919
New Hampshire,2020/5/22,146.1426268,79,5,4014,204,Yes,No,27919
New Hampshire,2020/5/23,146.1426268,75,4,4089,208,Yes,No,27919
New Hampshire,2020/5/24,146.1426268,60,1,4149,209,Yes,No,27919
New Hampshire,2020/5/25,146.1426268,48,1,4197,210,Yes,No,27919
New Hampshire,2020/5/26,146.1426268,34,4,4231,214,Yes,No,27919
New Hampshire,2020/5/27,146.1426268,55,9,4286,223,Yes,No,21335
New Hampshire,2020/5/28,146.1426268,103,9,4389,232,Yes,No,21335
New Hampshire,2020/5/29,146.1426268,103,6,4492,238,Yes,No,21335
New Hampshire,2020/5/30,146.1426268,53,4,4545,242,Yes,No,21335
New Hampshire,2020/5/31,146.1426268,106,3,4651,245,Yes,No,21335
New Hampshire,2020/6/1,146.1426268,34,0,4685,245,Yes,No,21335
New Hampshire,2020/6/2,146.1426268,64,11,4749,256,Yes,No,21335
New Hampshire,2020/6/3,146.1426268,46,9,4795,265,Yes,No,19949
New Hampshire,2020/6/4,146.1426268,81,8,4876,273,Yes,No,19949
New Hampshire,2020/6/5,146.1426268,77,5,4953,278,Yes,No,19949
New Hampshire,2020/6/6,146.1426268,66,5,5019,283,Yes,No,19949
New Hampshire,2020/6/7,146.1426268,24,3,5043,286,Yes,No,19949
New Hampshire,2020/6/8,146.1426268,36,0,5079,286,Yes,No,19949
New Hampshire,2020/6/9,146.1426268,53,8,5132,294,Yes,No,19949
New Hampshire,2020/6/10,146.1426268,46,7,5178,301,Yes,No,18367
New Hampshire,2020/6/11,146.1426268,31,7,5209,308,Yes,No,18367
New Hampshire,2020/6/12,146.1426268,42,7,5251,315,Yes,No,18367
New Hampshire,2020/6/13,146.1426268,48,3,5299,318,Yes,No,18367
New Hampshire,2020/6/14,146.1426268,19,2,5318,320,Yes,No,18367
New Hampshire,2020/6/15,146.1426268,27,0,5345,320,Yes,No,18367
New Hampshire,2020/6/16,146.1426268,19,6,5364,326,No,No,18367
New Hampshire,2020/6/17,146.1426268,72,4,5436,330,No,No,18671
New Hampshire,2020/6/18,146.1426268,14,1,5450,331,No,No,18671
New Hampshire,2020/6/19,146.1426268,36,6,5486,337,No,No,18671
New Hampshire,2020/6/20,146.1426268,32,2,5518,339,No,No,18671
New Hampshire,2020/6/21,146.1426268,26,0,5544,339,No,No,18671
New Hampshire,2020/6/22,146.1426268,14,0,5558,339,No,No,18671
New Hampshire,2020/6/23,146.1426268,13,4,5571,343,No,No,18671
New Hampshire,2020/6/24,146.1426268,27,4,5598,347,No,No,18338
New Hampshire,2020/6/25,146.1426268,40,10,5638,357,No,No,18338
New Hampshire,2020/6/26,146.1426268,33,8,5671,365,No,No,18338
New Hampshire,2020/6/27,146.1426268,46,2,5717,367,No,No,18338
New Hampshire,2020/6/28,146.1426268,30,0,5747,367,No,No,18338
New Hampshire,2020/6/29,146.1426268,13,0,5760,367,No,No,18338
New Hampshire,2020/6/30,146.1426268,22,4,5782,371,No,No,18338
New Hampshire,2020/7/1,146.1426268,20,2,5802,373,No,No,19056
New Hampshire,2020/7/2,146.1426268,20,2,5822,375,No,No,19056
New Hampshire,2020/7/3,146.1426268,35,1,5857,376,No,No,19056
New Hampshire,2020/7/4,146.1426268,14,4,5871,380,No,No,19056
New Hampshire,2020/7/5,146.1426268,26,1,5897,381,No,No,19056
New Hampshire,2020/7/6,146.1426268,17,1,5914,382,No,No,19056
New Hampshire,2020/7/7,146.1426268,18,2,5932,384,No,No,19056
New Hampshire,2020/7/8,146.1426268,20,2,5952,386,No,No,20563
New Hampshire,2020/7/9,146.1426268,21,1,5973,387,No,No,20563
New Hampshire,2020/7/10,146.1426268,18,3,5991,390,No,No,20563
New Hampshire,2020/7/11,146.1426268,33,1,6024,391,No,No,20563
New Hampshire,2020/7/12,146.1426268,30,0,6054,391,No,No,20563
New Hampshire,2020/7/13,146.1426268,14,0,6068,391,No,No,20563
New Hampshire,2020/7/14,146.1426268,23,1,6091,392,No,No,20563
New Hampshire,2020/7/15,146.1426268,22,2,6113,394,No,No,23676
New Hampshire,2020/7/16,146.1426268,26,1,6139,395,No,No,23676
New Hampshire,2020/7/17,146.1426268,26,0,6165,395,No,No,23676
New Hampshire,2020/7/18,146.1426268,23,1,6188,396,No,No,23676
New Hampshire,2020/7/19,146.1426268,15,2,6203,398,No,No,23676
New Hampshire,2020/7/20,146.1426268,46,0,6249,398,No,No,23676
New Hampshire,2020/7/21,146.1426268,13,2,6262,400,No,No,23676
New Hampshire,2020/7/22,146.1426268,33,2,6295,402,No,No,17437
New Hampshire,2020/7/23,146.1426268,23,3,6318,405,No,No,17437
New Hampshire,2020/7/24,146.1426268,57,2,6375,407,No,No,17437
New Hampshire,2020/7/25,146.1426268,40,2,6415,409,No,No,17437
New Hampshire,2020/7/26,146.1426268,21,0,6436,409,No,No,17437
New Hampshire,2020/7/27,146.1426268,5,0,6441,409,No,No,17437
New Hampshire,2020/7/28,146.1426268,59,0,6500,409,No,No,17437
New Hampshire,2020/7/29,146.1426268,13,2,6513,411,No,No,11690
New Hampshire,2020/7/30,146.1426268,31,4,6544,415,No,No,11690
New Hampshire,2020/7/31,146.1426268,39,0,6583,415,No,No,11690
New Hampshire,2020/8/1,146.1426268,30,1,6613,416,No,No,11690
New Hampshire,2020/8/2,146.1426268,21,1,6634,417,No,No,11690
New Hampshire,2020/8/3,146.1426268,26,0,6660,417,No,No,11690
New Hampshire,2020/8/4,146.1426268,33,1,6693,418,No,No,11690
New Hampshire,2020/8/5,146.1426268,26,0,6719,418,No,No,9467
New Hampshire,2020/8/6,146.1426268,23,1,6742,419,No,No,9467
New Hampshire,2020/8/7,146.1426268,37,0,6779,419,No,No,9467
New Hampshire,2020/8/8,146.1426268,39,0,6818,419,No,No,9467
New Hampshire,2020/8/9,146.1426268,13,0,6831,419,No,No,9467
New Hampshire,2020/8/10,146.1426268,9,0,6840,419,No,No,9467
New Hampshire,2020/8/11,146.1426268,21,0,6861,419,No,Yes,9467
New Hampshire,2020/8/12,146.1426268,26,1,6887,420,No,Yes,11047
New Hampshire,2020/8/13,146.1426268,34,2,6921,422,No,Yes,11047
New Hampshire,2020/8/14,146.1426268,43,1,6964,423,No,Yes,11047
New Hampshire,2020/8/15,146.1426268,16,0,6980,423,No,Yes,11047
New Hampshire,2020/8/16,146.1426268,8,0,6988,423,No,Yes,11047
New Hampshire,2020/8/17,146.1426268,16,0,7004,423,No,Yes,11047
New Hampshire,2020/8/18,146.1426268,13,1,7017,424,No,Yes,11047
New Hampshire,2020/8/19,146.1426268,19,3,7036,427,No,Yes,8676
New Hampshire,2020/8/20,146.1426268,14,1,7050,428,No,Yes,8676
New Hampshire,2020/8/21,146.1426268,21,0,7071,428,No,Yes,8676
New Hampshire,2020/8/22,146.1426268,21,1,7092,429,No,Yes,8676
New Hampshire,2020/8/23,146.1426268,15,0,7107,429,No,Yes,8676
New Hampshire,2020/8/24,146.1426268,27,0,7134,429,No,Yes,8676
New Hampshire,2020/8/25,146.1426268,16,0,7150,429,No,Yes,8676
New Hampshire,2020/8/26,146.1426268,9,1,7159,430,No,Yes,8511
New Hampshire,2020/8/27,146.1426268,35,1,7194,431,No,Yes,8511
New Hampshire,2020/8/28,146.1426268,22,1,7216,432,No,Yes,8511
New Hampshire,2020/8/29,146.1426268,30,0,7246,432,No,Yes,8511
New Hampshire,2020/8/30,146.1426268,8,0,7254,432,No,Yes,8511
New Hampshire,2020/8/31,146.1426268,21,0,7275,432,No,Yes,8511
New Hampshire,2020/9/1,146.1426268,22,0,7297,432,No,Yes,8511
New Hampshire,2020/9/2,146.1426268,12,0,7309,432,No,Yes,8901
New Hampshire,2020/9/3,146.1426268,38,0,7347,432,No,Yes,8901
New Hampshire,2020/9/4,146.1426268,21,0,7368,432,No,Yes,8901
New Hampshire,2020/9/5,146.1426268,56,0,7424,432,No,Yes,8901
New Hampshire,2020/9/6,146.1426268,23,1,7447,433,No,Yes,8901
New Hampshire,2020/9/7,146.1426268,29,0,7476,433,No,Yes,8901
New Hampshire,2020/9/8,146.1426268,18,0,7494,433,No,Yes,8901
New Hampshire,2020/9/9,146.1426268,23,0,7517,433,No,Yes,8848
New Hampshire,2020/9/10,146.1426268,56,1,7573,434,No,Yes,8848
New Hampshire,2020/9/11,146.1426268,47,0,7620,434,No,Yes,8848
New Hampshire,2020/9/12,146.1426268,32,1,7652,435,No,Yes,8848
New Hampshire,2020/9/13,146.1426268,44,1,7696,436,No,Yes,8848
New Hampshire,2020/9/14,146.1426268,18,0,7714,436,No,Yes,8848
New Hampshire,2020/9/15,146.1426268,34,2,7748,438,No,Yes,8848
New Hampshire,2020/9/16,146.1426268,32,0,7780,438,No,Yes,8679
New Hampshire,2020/9/17,146.1426268,34,0,7814,438,No,Yes,8679
New Hampshire,2020/9/18,146.1426268,47,0,7861,438,No,Yes,8679
New Hampshire,2020/9/19,146.1426268,59,0,7920,438,No,Yes,8679
New Hampshire,2020/9/20,146.1426268,27,0,7947,438,No,Yes,8679
New Hampshire,2020/9/21,146.1426268,5,0,7952,438,No,Yes,8679
New Hampshire,2020/9/22,146.1426268,38,0,7990,438,No,Yes,8679
New Hampshire,2020/9/23,146.1426268,17,0,8007,438,No,Yes,8805
New Hampshire,2020/9/24,146.1426268,37,0,8044,438,No,Yes,8805
New Hampshire,2020/9/25,146.1426268,41,0,8085,438,No,Yes,8805
New Hampshire,2020/9/26,146.1426268,36,1,8121,439,No,Yes,8805
New Hampshire,2020/9/27,146.1426268,51,0,8172,439,No,Yes,8805
New Hampshire,2020/9/28,146.1426268,36,0,8208,439,No,Yes,8805
New Hampshire,2020/9/29,146.1426268,25,0,8233,439,No,Yes,8805
New Hampshire,2020/9/30,146.1426268,33,0,8266,439,No,Yes,7732
New Hampshire,2020/10/1,146.1426268,51,2,8317,441,No,Yes,7732
New Hampshire,2020/10/2,146.1426268,217,1,8534,442,No,Yes,7732
New Hampshire,2020/10/3,146.1426268,63,0,8597,442,No,Yes,7732
New Hampshire,2020/10/4,146.1426268,48,1,8645,443,No,Yes,7732
New Hampshire,2020/10/5,146.1426268,35,1,8680,444,No,Yes,7732
New Hampshire,2020/10/6,146.1426268,51,2,8731,446,No,Yes,7732
New Hampshire,2020/10/7,146.1426268,69,2,8800,448,No,Yes,8581
New Hampshire,2020/10/8,146.1426268,78,0,8878,448,No,Yes,8581
New Hampshire,2020/10/9,146.1426268,92,2,8970,450,No,Yes,8581
New Hampshire,2020/10/10,146.1426268,122,5,9092,455,No,Yes,8581
New Hampshire,2020/10/11,146.1426268,51,1,9143,456,No,Yes,8581
New Hampshire,2020/10/12,146.1426268,65,0,9208,456,No,Yes,8581
New Hampshire,2020/10/13,146.1426268,71,0,9279,456,No,Yes,8581
New Hampshire,2020/10/14,146.1426268,70,2,9349,458,No,Yes,7964
New Hampshire,2020/10/15,146.1426268,77,5,9426,463,No,Yes,7964
New Hampshire,2020/10/16,146.1426268,88,2,9514,465,No,Yes,7964
New Hampshire,2020/10/17,146.1426268,111,1,9625,466,No,Yes,7964
New Hampshire,2020/10/18,146.1426268,69,1,9694,467,No,Yes,7964
New Hampshire,2020/10/19,146.1426268,52,1,9746,468,No,Yes,7964
New Hampshire,2020/10/20,146.1426268,82,0,9828,468,No,Yes,7964
New Hampshire,2020/10/21,146.1426268,89,1,9917,469,No,Yes,7126
New Hampshire,2020/10/22,146.1426268,77,1,9994,470,No,Yes,7126
New Hampshire,2020/10/23,146.1426268,118,1,10112,471,No,Yes,7126
New Hampshire,2020/10/24,146.1426268,126,2,10238,473,No,Yes,7126
New Hampshire,2020/10/25,146.1426268,90,0,10328,473,No,Yes,7126
New Hampshire,2020/10/26,146.1426268,69,2,10397,475,No,Yes,7126
New Hampshire,2020/10/27,146.1426268,133,0,10530,475,No,Yes,7126
New Hampshire,2020/10/28,146.1426268,111,3,10641,478,No,Yes,7060
New Hampshire,2020/10/29,146.1426268,127,4,10768,482,No,Yes,7060
New Hampshire,2020/10/30,146.1426268,116,0,10884,482,No,Yes,7060
New Hampshire,2020/10/31,146.1426268,200,1,11084,483,No,Yes,7060
New Hampshire,2020/11/1,146.1426268,130,0,11214,483,No,Yes,7060
New Hampshire,2020/11/2,146.1426268,106,0,11320,483,No,Yes,7060
New Hampshire,2020/11/3,146.1426268,128,0,11448,483,No,Yes,7060
New Hampshire,2020/11/4,146.1426268,115,1,11563,484,No,Yes,8764
New Hampshire,2020/11/5,146.1426268,245,2,11808,486,No,Yes,8764
New Hampshire,2020/11/6,146.1426268,204,2,12012,488,No,Yes,8764
New Hampshire,2020/11/7,146.1426268,229,1,12241,489,No,Yes,8764
New Hampshire,2020/11/8,146.1426268,247,0,12488,489,No,Yes,8764
New Hampshire,2020/11/9,146.1426268,211,0,12699,489,No,Yes,8764
New Hampshire,2020/11/10,146.1426268,220,0,12919,489,No,Yes,8764
New Hampshire,2020/11/11,146.1426268,229,3,13148,492,No,Yes,9262
New Hampshire,2020/11/12,146.1426268,322,3,13470,495,No,Yes,9262
New Hampshire,2020/11/13,146.1426268,459,3,13929,498,No,Yes,9262
New Hampshire,2020/11/14,146.1426268,382,1,14311,499,No,Yes,9262
New Hampshire,2020/11/15,146.1426268,360,0,14671,499,No,Yes,9262
New Hampshire,2020/11/16,146.1426268,358,1,15029,500,No,Yes,9262
New Hampshire,2020/11/17,146.1426268,274,2,15303,502,No,Yes,9262
New Hampshire,2020/11/18,146.1426268,446,2,15749,504,No,Yes,11813
New Hampshire,2020/11/19,146.1426268,528,2,16277,506,No,Yes,11813
New Hampshire,2020/11/20,146.1426268,520,1,16797,507,No,Yes,11813
New Hampshire,2020/11/21,146.1426268,484,1,17281,508,No,Yes,11813
New Hampshire,2020/11/22,146.1426268,317,4,17598,512,No,Yes,11813
New Hampshire,2020/11/23,146.1426268,444,0,18042,512,No,Yes,11813
New Hampshire,2020/11/24,146.1426268,340,1,18382,513,No,Yes,11813
New Hampshire,2020/11/25,146.1426268,394,1,18776,514,No,Yes,7061
New Hampshire,2020/11/26,146.1426268,0,0,18776,514,No,Yes,7061
New Hampshire,2020/11/27,146.1426268,537,3,19313,517,No,Yes,7061
New Hampshire,2020/11/28,146.1426268,689,6,20002,523,No,Yes,7061
New Hampshire,2020/11/29,146.1426268,478,3,20480,526,No,Yes,7061
New Hampshire,2020/11/30,146.1426268,514,0,20994,526,No,Yes,7061
New Hampshire,2020/12/1,146.1426268,772,2,21766,528,No,Yes,7061
New Hampshire,2020/12/2,146.1426268,566,9,22332,537,No,Yes,7656
New Hampshire,2020/12/3,146.1426268,593,7,22925,544,No,Yes,7656
New Hampshire,2020/12/4,146.1426268,765,8,23690,552,No,Yes,7656
New Hampshire,2020/12/5,146.1426268,448,7,24138,559,No,Yes,7656
New Hampshire,2020/12/6,146.1426268,633,5,24771,564,No,Yes,7656
New Hampshire,2020/12/7,146.1426268,1045,2,25816,566,No,Yes,7656
New Hampshire,2020/12/8,146.1426268,807,0,26623,566,No,Yes,7656
New Hampshire,2020/12/9,146.1426268,969,4,27592,570,No,Yes,7568
New Hampshire,2020/12/10,146.1426268,681,14,28273,584,No,Yes,7568
New Hampshire,2020/12/11,146.1426268,1187,6,29460,590,No,Yes,7568
New Hampshire,2020/12/12,146.1426268,784,10,30244,600,No,Yes,7568
New Hampshire,2020/12/13,146.1426268,712,3,30956,603,No,Yes,7568
New Hampshire,2020/12/14,146.1426268,919,1,31875,604,No,Yes,7568
New Hampshire,2020/12/15,146.1426268,670,0,32545,604,No,Yes,7568
New Hampshire,2020/12/16,146.1426268,888,21,33433,625,No,Yes,7543
New Hampshire,2020/12/17,146.1426268,831,4,34264,629,No,Yes,7543
New Hampshire,2020/12/18,146.1426268,696,9,34960,638,No,Yes,7543
New Hampshire,2020/12/19,146.1426268,649,12,35609,650,No,Yes,7543
New Hampshire,2020/12/20,146.1426268,933,6,36542,656,No,Yes,7543
New Hampshire,2020/12/21,146.1426268,846,0,37388,656,No,Yes,7543
New Hampshire,2020/12/22,146.1426268,620,0,38008,656,No,Yes,7543
New Hampshire,2020/12/23,146.1426268,504,21,38512,677,No,Yes,5506
New Hampshire,2020/12/24,146.1426268,390,13,38902,690,No,Yes,5506
New Hampshire,2020/12/25,146.1426268,0,0,38902,690,No,Yes,5506
New Hampshire,2020/12/26,146.1426268,1031,11,39933,701,No,Yes,5506
New Hampshire,2020/12/27,146.1426268,876,7,40809,708,No,Yes,5506
New Hampshire,2020/12/28,146.1426268,861,7,41670,715,No,Yes,5506
New Hampshire,2020/12/29,146.1426268,1027,20,42697,735,No,Yes,5506
New Hampshire,2020/12/30,146.1426268,545,6,43242,741,No,Yes,10986
New Hampshire,2020/12/31,146.1426268,786,18,44028,759,No,Yes,10986
New Hampshire,2021/1/1,146.1426268,0,0,44028,759,No,Yes,10986
New Hampshire,2021/1/2,146.1426268,1156,10,45184,769,No,Yes,10986
New Hampshire,2021/1/3,146.1426268,1266,11,46450,780,No,Yes,10986
New Hampshire,2021/1/4,146.1426268,878,1,47328,781,No,Yes,10986
New Hampshire,2021/1/5,146.1426268,664,11,47992,792,No,Yes,10986
New Hampshire,2021/1/6,146.1426268,846,24,48838,816,No,Yes,14084
New Hampshire,2021/1/7,146.1426268,423,11,49261,827,No,Yes,14084
New Hampshire,2021/1/8,146.1426268,891,19,50152,846,No,Yes,14084
New Hampshire,2021/1/9,146.1426268,719,16,50871,862,No,Yes,14084
New Hampshire,2021/1/10,146.1426268,729,7,51600,869,No,Yes,14084
New Hampshire,2021/1/11,146.1426268,707,0,52307,869,No,Yes,14084
New Hampshire,2021/1/12,146.1426268,841,9,53148,878,No,Yes,14084
New Hampshire,2021/1/13,146.1426268,977,7,54125,885,No,Yes,11980
New Hampshire,2021/1/14,146.1426268,653,12,54778,897,No,Yes,11980
New Hampshire,2021/1/15,146.1426268,722,11,55500,908,No,Yes,11980
New Hampshire,2021/1/16,146.1426268,445,19,55945,927,No,Yes,11980
New Hampshire,2021/1/17,146.1426268,919,6,56864,933,No,Yes,11980
New Hampshire,2021/1/18,146.1426268,1000,0,57864,933,No,Yes,11980
New Hampshire,2021/1/19,146.1426268,845,5,58709,938,No,Yes,11980
New Hampshire,2021/1/20,146.1426268,728,12,59437,950,No,Yes,11615
New Hampshire,2021/1/21,146.1426268,857,12,60294,962,No,Yes,11615
New Hampshire,2021/1/22,146.1426268,657,9,60951,971,No,Yes,11615
New Hampshire,2021/1/23,146.1426268,625,10,61576,981,No,Yes,11615
New Hampshire,2021/1/24,146.1426268,761,6,62337,987,No,Yes,11615
New Hampshire,2021/1/25,146.1426268,431,3,62768,990,No,Yes,11615
New Hampshire,2021/1/26,146.1426268,404,4,63172,994,No,Yes,11615
New Hampshire,2021/1/27,146.1426268,391,12,63563,1006,No,Yes,12664
New Hampshire,2021/1/28,146.1426268,695,16,64258,1022,No,Yes,12664
New Hampshire,2021/1/29,146.1426268,580,14,64838,1036,No,Yes,12664
New Hampshire,2021/1/30,146.1426268,524,6,65362,1042,No,Yes,12664
New Hampshire,2021/1/31,146.1426268,333,15,65695,1057,No,Yes,12664
New Hampshire,2021/2/1,146.1426268,363,2,66058,1059,No,Yes,12664
New Hampshire,2021/2/2,146.1426268,326,7,66384,1066,No,Yes,12664
New Hampshire,2021/2/3,146.1426268,337,10,66721,1076,No,Yes,13464
New Hampshire,2021/2/4,146.1426268,396,9,67117,1085,No,Yes,13464
New Hampshire,2021/2/5,146.1426268,478,6,67595,1091,No,Yes,13464
New Hampshire,2021/2/6,146.1426268,466,7,68061,1098,No,Yes,13464
New Hampshire,2021/2/7,146.1426268,318,6,68379,1104,No,Yes,13464
New Hampshire,2021/2/8,146.1426268,120,2,68499,1106,No,Yes,13464
New Hampshire,2021/2/9,146.1426268,419,3,68918,1109,No,Yes,13464
New Hampshire,2021/2/10,146.1426268,329,7,69247,1116,No,Yes,12087
New Hampshire,2021/2/11,146.1426268,365,1,69612,1117,No,Yes,12087
New Hampshire,2021/2/12,146.1426268,460,9,70072,1126,No,Yes,12087
New Hampshire,2021/2/13,146.1426268,433,4,70505,1130,No,Yes,12087
New Hampshire,2021/2/14,146.1426268,280,3,70785,1133,No,Yes,12087
New Hampshire,2021/2/15,146.1426268,232,2,71017,1135,No,Yes,12087
New Hampshire,2021/2/16,146.1426268,198,1,71215,1136,No,Yes,12087
New Hampshire,2021/2/17,146.1426268,750,12,71965,1148,No,Yes,11395
New Hampshire,2021/2/18,146.1426268,434,2,72399,1150,No,Yes,11395
New Hampshire,2021/2/19,146.1426268,368,2,72767,1152,No,Yes,11395
New Hampshire,2021/2/20,146.1426268,394,1,73161,1153,No,Yes,11395
New Hampshire,2021/2/21,146.1426268,252,1,73413,1154,No,Yes,11395
New Hampshire,2021/2/22,146.1426268,252,0,73665,1154,No,Yes,11395
New Hampshire,2021/2/23,146.1426268,258,1,73923,1155,No,Yes,11395
New Hampshire,2021/2/24,146.1426268,335,2,74258,1157,No,Yes,11395
New Hampshire,2021/2/25,146.1426268,310,6,74568,1163,No,Yes,11395
New Hampshire,2021/2/26,146.1426268,325,4,74893,1167,No,Yes,11395
New Hampshire,2021/2/27,146.1426268,273,3,75166,1170,No,Yes,11395
New Hampshire,2021/2/28,146.1426268,258,0,75424,1170,No,Yes,11395
New Hampshire,2021/3/1,146.1426268,164,0,75588,1170,No,Yes,11395
New Hampshire,2021/3/2,146.1426268,215,0,75803,1170,No,Yes,11395
New Hampshire,2021/3/3,146.1426268,187,5,75990,1175,No,Yes,11395
New Hampshire,2021/3/4,146.1426268,188,3,76178,1178,No,Yes,11395
New Jersey,2020/3/1,1133.51072,0,0,0,0,No,No,1575
New Jersey,2020/3/2,1133.51072,0,0,0,0,No,No,1575
New Jersey,2020/3/3,1133.51072,0,0,0,0,No,No,1575
New Jersey,2020/3/4,1133.51072,1,0,1,0,No,No,1663
New Jersey,2020/3/5,1133.51072,1,0,2,0,No,No,1663
New Jersey,2020/3/6,1133.51072,2,0,4,0,No,No,1663
New Jersey,2020/3/7,1133.51072,0,0,4,0,No,No,1663
New Jersey,2020/3/8,1133.51072,2,0,6,0,No,No,1663
New Jersey,2020/3/9,1133.51072,5,0,11,0,No,No,1663
New Jersey,2020/3/10,1133.51072,4,1,15,1,No,No,1663
New Jersey,2020/3/11,1133.51072,8,0,23,1,No,No,1819
New Jersey,2020/3/12,1133.51072,6,0,29,1,No,No,1819
New Jersey,2020/3/13,1133.51072,21,0,50,1,No,No,1819
New Jersey,2020/3/14,1133.51072,25,1,75,2,No,No,1819
New Jersey,2020/3/15,1133.51072,23,0,98,2,No,No,1819
New Jersey,2020/3/16,1133.51072,78,1,176,3,No,No,1819
New Jersey,2020/3/17,1133.51072,92,0,268,3,No,No,1819
New Jersey,2020/3/18,1133.51072,159,2,427,5,No,No,10892
New Jersey,2020/3/19,1133.51072,308,4,735,9,No,No,10892
New Jersey,2020/3/20,1133.51072,161,2,896,11,No,No,10892
New Jersey,2020/3/21,1133.51072,440,5,1336,16,Yes,No,10892
New Jersey,2020/3/22,1133.51072,578,4,1914,20,Yes,No,10892
New Jersey,2020/3/23,1133.51072,930,7,2844,27,Yes,No,10892
New Jersey,2020/3/24,1133.51072,831,17,3675,44,Yes,No,10892
New Jersey,2020/3/25,1133.51072,727,18,4402,62,Yes,No,80984
New Jersey,2020/3/26,1133.51072,2474,20,6876,82,Yes,No,80984
New Jersey,2020/3/27,1133.51072,1949,26,8825,108,Yes,No,80984
New Jersey,2020/3/28,1133.51072,2299,32,11124,140,Yes,No,80984
New Jersey,2020/3/29,1133.51072,2262,21,13386,161,Yes,No,80984
New Jersey,2020/3/30,1133.51072,3250,38,16636,199,Yes,No,80984
New Jersey,2020/3/31,1133.51072,2060,68,18696,267,Yes,No,80984
New Jersey,2020/4/1,1133.51072,3559,88,22255,355,Yes,No,106739
New Jersey,2020/4/2,1133.51072,3335,184,25590,539,Yes,No,106739
New Jersey,2020/4/3,1133.51072,4305,108,29895,647,Yes,No,106739
New Jersey,2020/4/4,1133.51072,4229,200,34124,847,Yes,No,106739
New Jersey,2020/4/5,1133.51072,3381,70,37505,917,Yes,No,106739
New Jersey,2020/4/6,1133.51072,3585,88,41090,1005,Yes,No,106739
New Jersey,2020/4/7,1133.51072,3326,227,44416,1232,Yes,No,106739
New Jersey,2020/4/8,1133.51072,3021,272,47437,1504,Yes,No,77515
New Jersey,2020/4/9,1133.51072,3590,196,51027,1700,Yes,No,77515
New Jersey,2020/4/10,1133.51072,3561,232,54588,1932,Yes,No,77515
New Jersey,2020/4/11,1133.51072,3563,251,58151,2183,Yes,No,77515
New Jersey,2020/4/12,1133.51072,3699,167,61850,2350,Yes,No,77515
New Jersey,2020/4/13,1133.51072,2734,93,64584,2443,Yes,No,77515
New Jersey,2020/4/14,1133.51072,4240,362,68824,2805,Yes,No,77515
New Jersey,2020/4/15,1133.51072,2206,351,71030,3156,Yes,No,66432
New Jersey,2020/4/16,1133.51072,4287,362,75317,3518,Yes,No,66432
New Jersey,2020/4/17,1133.51072,3150,322,78467,3840,Yes,No,66432
New Jersey,2020/4/18,1133.51072,2953,230,81420,4070,Yes,No,66432
New Jersey,2020/4/19,1133.51072,3881,132,85301,4202,Yes,No,66432
New Jersey,2020/4/20,1133.51072,3505,175,88806,4377,Yes,No,66432
New Jersey,2020/4/21,1133.51072,3581,376,92387,4753,Yes,No,66432
New Jersey,2020/4/22,1133.51072,3478,310,95865,5063,Yes,No,74966
New Jersey,2020/4/23,1133.51072,4124,305,99989,5368,Yes,No,74966
New Jersey,2020/4/24,1133.51072,2207,249,102196,5617,Yes,No,74966
New Jersey,2020/4/25,1133.51072,3327,246,105523,5863,Yes,No,74966
New Jersey,2020/4/26,1133.51072,3515,75,109038,5938,Yes,No,74966
New Jersey,2020/4/27,1133.51072,2150,106,111188,6044,Yes,No,74966
New Jersey,2020/4/28,1133.51072,2668,398,113856,6442,Yes,No,74966
New Jersey,2020/4/29,1133.51072,2408,328,116264,6770,Yes,No,28985
New Jersey,2020/4/30,1133.51072,2388,458,118652,7228,Yes,No,28985
New Jersey,2020/5/1,1133.51072,2538,310,121190,7538,Yes,No,28985
New Jersey,2020/5/2,1133.51072,2527,204,123717,7742,Yes,No,28985
New Jersey,2020/5/3,1133.51072,3027,129,126744,7871,Yes,No,28985
New Jersey,2020/5/4,1133.51072,1525,39,128269,7910,Yes,No,28985
New Jersey,2020/5/5,1133.51072,2324,334,130593,8244,Yes,No,28985
New Jersey,2020/5/6,1133.51072,1297,305,131890,8549,Yes,No,26666
New Jersey,2020/5/7,1133.51072,1745,252,133635,8801,Yes,No,26666
New Jersey,2020/5/8,1133.51072,1819,151,135454,8952,Yes,No,26666
New Jersey,2020/5/9,1133.51072,1631,164,137085,9116,Yes,No,26666
New Jersey,2020/5/10,1133.51072,1447,139,138532,9255,Yes,No,26666
New Jersey,2020/5/11,1133.51072,1413,55,139945,9310,Yes,No,26666
New Jersey,2020/5/12,1133.51072,798,198,140743,9508,Yes,No,26666
New Jersey,2020/5/13,1133.51072,817,194,141560,9702,Yes,No,25150
New Jersey,2020/5/14,1133.51072,1144,244,142704,9946,Yes,No,25150
New Jersey,2020/5/15,1133.51072,1201,192,143905,10138,Yes,No,25150
New Jersey,2020/5/16,1133.51072,1184,111,145089,10249,Yes,No,25150
New Jersey,2020/5/17,1133.51072,1245,107,146334,10356,Yes,No,25150
New Jersey,2020/5/18,1133.51072,1705,79,148039,10435,Yes,No,25150
New Jersey,2020/5/19,1133.51072,974,151,149013,10586,Yes,No,25150
New Jersey,2020/5/20,1133.51072,1386,161,150399,10747,Yes,No,27919
New Jersey,2020/5/21,1133.51072,1073,96,151472,10843,Yes,No,27919
New Jersey,2020/5/22,1133.51072,1247,142,152719,10985,Yes,No,27919
New Jersey,2020/5/23,1133.51072,385,96,153104,11081,Yes,No,27919
New Jersey,2020/5/24,1133.51072,1050,52,154154,11133,Yes,No,27919
New Jersey,2020/5/25,1133.51072,938,11,155092,11144,Yes,No,27919
New Jersey,2020/5/26,1133.51072,672,47,155764,11191,Yes,No,27919
New Jersey,2020/5/27,1133.51072,864,148,156628,11339,Yes,No,21335
New Jersey,2020/5/28,1133.51072,1187,62,157815,11401,Yes,No,21335
New Jersey,2020/5/29,1133.51072,1029,130,158844,11531,Yes,No,21335
New Jersey,2020/5/30,1133.51072,764,103,159608,11634,Yes,No,21335
New Jersey,2020/5/31,1133.51072,837,64,160445,11698,Yes,No,21335
New Jersey,2020/6/1,1133.51072,473,23,160918,11721,Yes,No,21335
New Jersey,2020/6/2,1133.51072,627,49,161545,11770,Yes,No,21335
New Jersey,2020/6/3,1133.51072,523,110,162068,11880,Yes,No,19949
New Jersey,2020/6/4,1133.51072,462,90,162530,11970,Yes,No,19949
New Jersey,2020/6/5,1133.51072,806,79,163336,12049,Yes,No,19949
New Jersey,2020/6/6,1133.51072,557,57,163893,12106,Yes,No,19949
New Jersey,2020/6/7,1133.51072,271,70,164164,12176,Yes,No,19949
New Jersey,2020/6/8,1133.51072,333,38,164497,12214,Yes,No,19949
New Jersey,2020/6/9,1133.51072,299,89,164796,12303,Yes,No,19949
New Jersey,2020/6/10,1133.51072,550,74,165346,12377,No,No,18367
New Jersey,2020/6/11,1133.51072,470,66,165816,12443,No,No,18367
New Jersey,2020/6/12,1133.51072,348,46,166164,12489,No,No,18367
New Jersey,2020/6/13,1133.51072,441,100,166605,12589,No,No,18367
New Jersey,2020/6/14,1133.51072,276,36,166881,12625,No,No,18367
New Jersey,2020/6/15,1133.51072,222,51,167103,12676,No,No,18367
New Jersey,2020/6/16,1133.51072,323,51,167426,12727,No,No,18367
New Jersey,2020/6/17,1133.51072,277,42,167703,12769,No,No,18671
New Jersey,2020/6/18,1133.51072,404,31,168107,12800,No,No,18671
New Jersey,2020/6/19,1133.51072,389,35,168496,12835,No,No,18671
New Jersey,2020/6/20,1133.51072,338,22,168834,12857,No,No,18671
New Jersey,2020/6/21,1133.51072,308,13,169142,12870,No,No,18671
New Jersey,2020/6/22,1133.51072,273,25,169415,12895,No,No,18671
New Jersey,2020/6/23,1133.51072,319,54,169734,12949,No,No,18671
New Jersey,2020/6/24,1133.51072,158,46,169892,12995,No,No,18338
New Jersey,2020/6/25,1133.51072,2158,1877,172050,14872,No,No,18338
New Jersey,2020/6/26,1133.51072,388,42,172438,14914,No,No,18338
New Jersey,2020/6/27,1133.51072,289,34,172727,14948,No,No,18338
New Jersey,2020/6/28,1133.51072,309,27,173036,14975,No,No,18338
New Jersey,2020/6/29,1133.51072,90,17,173126,14992,No,No,18338
New Jersey,2020/6/30,1133.51072,395,43,173521,15035,No,No,18338
New Jersey,2020/7/1,1133.51072,261,43,173782,15078,No,No,19056
New Jersey,2020/7/2,1133.51072,430,29,174212,15107,No,No,19056
New Jersey,2020/7/3,1133.51072,386,57,174598,15164,No,No,19056
New Jersey,2020/7/4,1133.51072,291,25,174889,15189,No,No,19056
New Jersey,2020/7/5,1133.51072,369,22,175258,15211,No,No,19056
New Jersey,2020/7/6,1133.51072,209,18,175467,15229,No,No,19056
New Jersey,2020/7/7,1133.51072,267,52,175734,15281,No,No,19056
New Jersey,2020/7/8,1133.51072,252,142,175986,15423,No,Yes,20563
New Jersey,2020/7/9,1133.51072,231,25,176217,15448,No,Yes,20563
New Jersey,2020/7/10,1133.51072,358,31,176575,15479,No,Yes,20563
New Jersey,2020/7/11,1133.51072,331,46,176906,15525,No,Yes,20563
New Jersey,2020/7/12,1133.51072,339,0,177245,15525,No,Yes,20563
New Jersey,2020/7/13,1133.51072,224,35,177469,15560,No,Yes,20563
New Jersey,2020/7/14,1133.51072,393,22,177862,15582,No,Yes,20563
New Jersey,2020/7/15,1133.51072,390,52,178252,15634,No,Yes,23676
New Jersey,2020/7/16,1133.51072,223,31,178475,15665,No,Yes,23676
New Jersey,2020/7/17,1133.51072,50,19,178525,15684,No,Yes,23676
New Jersey,2020/7/18,1133.51072,263,15,178788,15699,No,Yes,23676
New Jersey,2020/7/19,1133.51072,-31,7,178757,15706,No,Yes,23676
New Jersey,2020/7/20,1133.51072,180,9,178937,15715,No,Yes,23676
New Jersey,2020/7/21,1133.51072,293,22,179230,15737,No,Yes,23676
New Jersey,2020/7/22,1133.51072,335,-30,179565,15707,No,Yes,17437
New Jersey,2020/7/23,1133.51072,242,23,179807,15730,No,Yes,17437
New Jersey,2020/7/24,1133.51072,458,35,180265,15765,No,Yes,17437
New Jersey,2020/7/25,1133.51072,513,11,180778,15776,No,Yes,17437
New Jersey,2020/7/26,1133.51072,505,11,181283,15787,No,Yes,17437
New Jersey,2020/7/27,1133.51072,449,17,181732,15804,No,Yes,17437
New Jersey,2020/7/28,1133.51072,483,21,182215,15825,No,Yes,17437
New Jersey,2020/7/29,1133.51072,426,-27,182641,15798,No,Yes,11690
New Jersey,2020/7/30,1133.51072,204,11,182845,15809,No,Yes,11690
New Jersey,2020/7/31,1133.51072,690,10,183535,15819,No,Yes,11690
New Jersey,2020/8/1,1133.51072,369,11,183904,15830,No,Yes,11690
New Jersey,2020/8/2,1133.51072,321,6,184225,15836,No,Yes,11690
New Jersey,2020/8/3,1133.51072,264,10,184489,15846,No,Yes,11690
New Jersey,2020/8/4,1133.51072,356,11,184845,15857,No,Yes,11690
New Jersey,2020/8/5,1133.51072,335,-15,185180,15842,No,Yes,9467
New Jersey,2020/8/6,1133.51072,374,7,185554,15849,No,Yes,9467
New Jersey,2020/8/7,1133.51072,360,11,185914,15860,No,Yes,9467
New Jersey,2020/8/8,1133.51072,368,9,186282,15869,No,Yes,9467
New Jersey,2020/8/9,1133.51072,344,5,186626,15874,No,Yes,9467
New Jersey,2020/8/10,1133.51072,258,4,186884,15878,No,Yes,9467
New Jersey,2020/8/11,1133.51072,444,12,187328,15890,No,Yes,9467
New Jersey,2020/8/12,1133.51072,449,-5,187777,15885,No,Yes,11047
New Jersey,2020/8/13,1133.51072,656,8,188433,15893,No,Yes,11047
New Jersey,2020/8/14,1133.51072,570,10,189003,15903,No,Yes,11047
New Jersey,2020/8/15,1133.51072,278,7,189281,15910,No,Yes,11047
New Jersey,2020/8/16,1133.51072,13,2,189294,15912,No,Yes,11047
New Jersey,2020/8/17,1133.51072,312,4,189606,15916,No,Yes,11047
New Jersey,2020/8/18,1133.51072,331,9,189937,15925,No,Yes,11047
New Jersey,2020/8/19,1133.51072,319,1,190256,15926,No,Yes,8676
New Jersey,2020/8/20,1133.51072,100,6,190356,15932,No,Yes,8676
New Jersey,2020/8/21,1133.51072,290,9,190646,15941,No,Yes,8676
New Jersey,2020/8/22,1133.51072,529,2,191175,15943,No,Yes,8676
New Jersey,2020/8/23,1133.51072,148,3,191323,15946,No,Yes,8676
New Jersey,2020/8/24,1133.51072,225,0,191548,15946,No,Yes,8676
New Jersey,2020/8/25,1133.51072,302,7,191850,15953,No,Yes,8676
New Jersey,2020/8/26,1133.51072,236,-39,192086,15914,No,Yes,8511
New Jersey,2020/8/27,1133.51072,307,7,192393,15921,No,Yes,8511
New Jersey,2020/8/28,1133.51072,358,9,192751,15930,No,Yes,8511
New Jersey,2020/8/29,1133.51072,349,3,193100,15933,No,Yes,8511
New Jersey,2020/8/30,1133.51072,291,4,193391,15937,No,Yes,8511
New Jersey,2020/8/31,1133.51072,349,8,193740,15945,No,Yes,8511
New Jersey,2020/9/1,1133.51072,330,5,194070,15950,No,Yes,8511
New Jersey,2020/9/2,1133.51072,308,14,194378,15964,No,Yes,8901
New Jersey,2020/9/3,1133.51072,378,7,194756,15971,No,Yes,8901
New Jersey,2020/9/4,1133.51072,449,7,195205,15978,No,Yes,8901
New Jersey,2020/9/5,1133.51072,325,7,195530,15985,No,Yes,8901
New Jersey,2020/9/6,1133.51072,311,4,195841,15989,No,Yes,8901
New Jersey,2020/9/7,1133.51072,332,2,196173,15991,No,Yes,8901
New Jersey,2020/9/8,1133.51072,277,5,196450,15996,No,Yes,8901
New Jersey,2020/9/9,1133.51072,329,13,196779,16009,No,Yes,8848
New Jersey,2020/9/10,1133.51072,424,5,197203,16014,No,Yes,8848
New Jersey,2020/9/11,1133.51072,474,9,197677,16023,No,Yes,8848
New Jersey,2020/9/12,1133.51072,449,4,198126,16027,No,Yes,8848
New Jersey,2020/9/13,1133.51072,297,4,198423,16031,No,Yes,8848
New Jersey,2020/9/14,1133.51072,334,3,198757,16034,No,Yes,8848
New Jersey,2020/9/15,1133.51072,436,9,199193,16043,No,Yes,8848
New Jersey,2020/9/16,1133.51072,390,11,199583,16054,No,Yes,8679
New Jersey,2020/9/17,1133.51072,569,3,200152,16057,No,Yes,8679
New Jersey,2020/9/18,1133.51072,487,4,200639,16061,No,Yes,8679
New Jersey,2020/9/19,1133.51072,461,3,201100,16064,No,Yes,8679
New Jersey,2020/9/20,1133.51072,453,3,201553,16067,No,Yes,8679
New Jersey,2020/9/21,1133.51072,392,2,201945,16069,No,Yes,8679
New Jersey,2020/9/22,1133.51072,426,7,202371,16076,No,Yes,8679
New Jersey,2020/9/23,1133.51072,408,6,202779,16082,No,Yes,8805
New Jersey,2020/9/24,1133.51072,564,9,203343,16091,No,Yes,8805
New Jersey,2020/9/25,1133.51072,548,6,203891,16097,No,Yes,8805
New Jersey,2020/9/26,1133.51072,750,6,204641,16103,No,Yes,8805
New Jersey,2020/9/27,1133.51072,698,3,205339,16106,No,Yes,8805
New Jersey,2020/9/28,1133.51072,559,1,205898,16107,No,Yes,8805
New Jersey,2020/9/29,1133.51072,456,10,206354,16117,No,Yes,8805
New Jersey,2020/9/30,1133.51072,708,5,207062,16122,No,Yes,7732
New Jersey,2020/10/1,1133.51072,614,5,207676,16127,No,Yes,7732
New Jersey,2020/10/2,1133.51072,740,4,208416,16131,No,Yes,7732
New Jersey,2020/10/3,1133.51072,947,4,209363,16135,No,Yes,7732
New Jersey,2020/10/4,1133.51072,626,1,209989,16136,No,Yes,7732
New Jersey,2020/10/5,1133.51072,511,2,210500,16138,No,Yes,7732
New Jersey,2020/10/6,1133.51072,629,9,211129,16147,No,Yes,7732
New Jersey,2020/10/7,1133.51072,509,5,211638,16152,No,Yes,8581
New Jersey,2020/10/8,1133.51072,1298,9,212936,16161,No,Yes,8581
New Jersey,2020/10/9,1133.51072,865,3,213801,16164,No,Yes,8581
New Jersey,2020/10/10,1133.51072,864,7,214665,16171,No,Yes,8581
New Jersey,2020/10/11,1133.51072,751,3,215416,16174,No,Yes,8581
New Jersey,2020/10/12,1133.51072,469,1,215885,16175,No,Yes,8581
New Jersey,2020/10/13,1133.51072,988,7,216873,16182,No,Yes,8581
New Jersey,2020/10/14,1133.51072,939,9,217812,16191,No,Yes,7964
New Jersey,2020/10/15,1133.51072,971,6,218783,16197,No,Yes,7964
New Jersey,2020/10/16,1133.51072,810,5,219593,16202,No,Yes,7964
New Jersey,2020/10/17,1133.51072,934,2,220527,16204,No,Yes,7964
New Jersey,2020/10/18,1133.51072,1275,7,221802,16211,No,Yes,7964
New Jersey,2020/10/19,1133.51072,1192,3,222994,16214,No,Yes,7964
New Jersey,2020/10/20,1133.51072,988,13,223982,16227,No,Yes,7964
New Jersey,2020/10/21,1133.51072,1030,18,225012,16245,No,Yes,7126
New Jersey,2020/10/22,1133.51072,1162,18,226174,16263,No,Yes,7126
New Jersey,2020/10/23,1133.51072,1045,10,227219,16273,No,Yes,7126
New Jersey,2020/10/24,1133.51072,1909,8,229128,16281,No,Yes,7126
New Jersey,2020/10/25,1133.51072,1129,4,230257,16285,No,Yes,7126
New Jersey,2020/10/26,1133.51072,1216,7,231473,16292,No,Yes,7126
New Jersey,2020/10/27,1133.51072,1647,14,233120,16306,No,Yes,7126
New Jersey,2020/10/28,1133.51072,1670,18,234790,16324,No,Yes,7060
New Jersey,2020/10/29,1133.51072,1550,8,236340,16332,No,Yes,7060
New Jersey,2020/10/30,1133.51072,1976,7,238316,16339,No,Yes,7060
New Jersey,2020/10/31,1133.51072,1363,11,239679,16350,No,Yes,7060
New Jersey,2020/11/1,1133.51072,1743,4,241422,16354,No,Yes,7060
New Jersey,2020/11/2,1133.51072,1368,3,242790,16357,No,Yes,7060
New Jersey,2020/11/3,1133.51072,1824,14,244614,16371,No,Yes,7060
New Jersey,2020/11/4,1133.51072,2443,20,247057,16391,No,Yes,8764
New Jersey,2020/11/5,1133.51072,1962,12,249019,16403,No,Yes,8764
New Jersey,2020/11/6,1133.51072,2161,13,251180,16416,No,Yes,8764
New Jersey,2020/11/7,1133.51072,3202,9,254382,16425,No,Yes,8764
New Jersey,2020/11/8,1133.51072,2013,4,256395,16429,No,Yes,8764
New Jersey,2020/11/9,1133.51072,2058,11,258453,16440,No,Yes,8764
New Jersey,2020/11/10,1133.51072,3777,21,262230,16461,No,Yes,8764
New Jersey,2020/11/11,1133.51072,3065,15,265295,16476,No,Yes,9262
New Jersey,2020/11/12,1133.51072,3492,19,268787,16495,No,Yes,9262
New Jersey,2020/11/13,1133.51072,3397,27,272184,16522,No,Yes,9262
New Jersey,2020/11/14,1133.51072,4353,26,276537,16548,No,Yes,9262
New Jersey,2020/11/15,1133.51072,4538,18,281075,16566,No,Yes,9262
New Jersey,2020/11/16,1133.51072,2219,14,283294,16580,No,Yes,9262
New Jersey,2020/11/17,1133.51072,4026,38,287320,16618,No,Yes,9262
New Jersey,2020/11/18,1133.51072,4054,37,291374,16655,No,Yes,11813
New Jersey,2020/11/19,1133.51072,4182,34,295556,16689,No,Yes,11813
New Jersey,2020/11/20,1133.51072,3626,23,299182,16712,No,Yes,11813
New Jersey,2020/11/21,1133.51072,4669,34,303851,16746,No,Yes,11813
New Jersey,2020/11/22,1133.51072,3968,15,307819,16761,No,Yes,11813
New Jersey,2020/11/23,1133.51072,3581,11,311400,16772,No,Yes,11813
New Jersey,2020/11/24,1133.51072,4275,47,315675,16819,No,Yes,11813
New Jersey,2020/11/25,1133.51072,4059,67,319734,16886,No,Yes,7061
New Jersey,2020/11/26,1133.51072,4473,39,324207,16925,No,Yes,7061
New Jersey,2020/11/27,1133.51072,4095,17,328302,16942,No,Yes,7061
New Jersey,2020/11/28,1133.51072,3802,23,332104,16965,No,Yes,7061
New Jersey,2020/11/29,1133.51072,3839,13,335943,16978,No,Yes,7061
New Jersey,2020/11/30,1133.51072,3190,15,339133,16993,No,Yes,7061
New Jersey,2020/12/1,1133.51072,4606,90,343739,17083,No,Yes,7061
New Jersey,2020/12/2,1133.51072,4303,62,348042,17145,No,Yes,7656
New Jersey,2020/12/3,1133.51072,4793,64,352835,17209,No,Yes,7656
New Jersey,2020/12/4,1133.51072,5663,46,358498,17255,No,Yes,7656
New Jersey,2020/12/5,1133.51072,5324,51,363822,17306,No,Yes,7656
New Jersey,2020/12/6,1133.51072,6030,15,369852,17321,No,Yes,7656
New Jersey,2020/12/7,1133.51072,3563,15,373415,17336,No,Yes,7656
New Jersey,2020/12/8,1133.51072,5476,90,378891,17426,No,Yes,7656
New Jersey,2020/12/9,1133.51072,4463,116,383354,17542,No,Yes,7568
New Jersey,2020/12/10,1133.51072,5120,66,388474,17608,No,Yes,7568
New Jersey,2020/12/11,1133.51072,3650,54,392124,17662,No,Yes,7568
New Jersey,2020/12/12,1133.51072,6240,70,398364,17732,No,Yes,7568
New Jersey,2020/12/13,1133.51072,4154,19,402518,17751,No,Yes,7568
New Jersey,2020/12/14,1133.51072,4798,24,407316,17775,No,Yes,7568
New Jersey,2020/12/15,1133.51072,3966,97,411282,17872,No,Yes,7568
New Jersey,2020/12/16,1133.51072,5701,131,416983,18003,No,Yes,7543
New Jersey,2020/12/17,1133.51072,4255,77,421238,18080,No,Yes,7543
New Jersey,2020/12/18,1133.51072,3896,44,425134,18124,No,Yes,7543
New Jersey,2020/12/19,1133.51072,4191,49,429325,18173,No,Yes,7543
New Jersey,2020/12/20,1133.51072,5175,21,434500,18194,No,Yes,7543
New Jersey,2020/12/21,1133.51072,3171,29,437671,18223,No,Yes,7543
New Jersey,2020/12/22,1133.51072,4603,103,442274,18326,No,Yes,7543
New Jersey,2020/12/23,1133.51072,4809,140,447083,18466,No,Yes,5506
New Jersey,2020/12/24,1133.51072,4704,78,451787,18544,No,Yes,5506
New Jersey,2020/12/25,1133.51072,5060,51,456847,18595,No,Yes,5506
New Jersey,2020/12/26,1133.51072,3999,18,460846,18613,No,Yes,5506
New Jersey,2020/12/27,1133.51072,2320,17,463166,18630,No,Yes,5506
New Jersey,2020/12/28,1133.51072,2744,21,465910,18651,No,Yes,5506
New Jersey,2020/12/29,1133.51072,3657,126,469567,18777,No,Yes,5506
New Jersey,2020/12/30,1133.51072,4718,175,474285,18952,No,Yes,10986
New Jersey,2020/12/31,1133.51072,5096,90,479381,19042,No,Yes,10986
New Jersey,2021/1/1,1133.51072,5501,118,484882,19160,No,Yes,10986
New Jersey,2021/1/2,1133.51072,5511,27,490393,19187,No,Yes,10986
New Jersey,2021/1/3,1133.51072,3670,21,494063,19208,No,Yes,10986
New Jersey,2021/1/4,1133.51072,51092,36,545155,19244,No,Yes,10986
New Jersey,2021/1/5,1133.51072,6264,138,551419,19382,No,Yes,10986
New Jersey,2021/1/6,1133.51072,5852,141,557271,19523,No,Yes,14084
New Jersey,2021/1/7,1133.51072,7479,123,564750,19646,No,Yes,14084
New Jersey,2021/1/8,1133.51072,7021,110,571771,19756,No,Yes,14084
New Jersey,2021/1/9,1133.51072,7411,98,579182,19854,No,Yes,14084
New Jersey,2021/1/10,1133.51072,5646,32,584828,19886,No,Yes,14084
New Jersey,2021/1/11,1133.51072,5337,46,590165,19932,No,Yes,14084
New Jersey,2021/1/12,1133.51072,4586,107,594751,20039,No,Yes,14084
New Jersey,2021/1/13,1133.51072,7878,127,602629,20166,No,Yes,11980
New Jersey,2021/1/14,1133.51072,7092,87,609721,20253,No,Yes,11980
New Jersey,2021/1/15,1133.51072,6365,67,616086,20320,No,Yes,11980
New Jersey,2021/1/16,1133.51072,5999,94,622085,20414,No,Yes,11980
New Jersey,2021/1/17,1133.51072,5136,25,627221,20439,No,Yes,11980
New Jersey,2021/1/18,1133.51072,3853,19,631074,20458,No,Yes,11980
New Jersey,2021/1/19,1133.51072,4627,54,635701,20512,No,Yes,11980
New Jersey,2021/1/20,1133.51072,5439,155,641140,20667,No,Yes,11615
New Jersey,2021/1/21,1133.51072,5048,93,646188,20760,No,Yes,11615
New Jersey,2021/1/22,1133.51072,4200,115,650388,20875,No,Yes,11615
New Jersey,2021/1/23,1133.51072,7148,59,657536,20934,No,Yes,11615
New Jersey,2021/1/24,1133.51072,5272,17,662808,20951,No,Yes,11615
New Jersey,2021/1/25,1133.51072,4143,21,666951,20972,No,Yes,11615
New Jersey,2021/1/26,1133.51072,4776,133,671727,21105,No,Yes,11615
New Jersey,2021/1/27,1133.51072,4810,129,676537,21234,No,Yes,12664
New Jersey,2021/1/28,1133.51072,4746,67,681283,21301,No,Yes,12664
New Jersey,2021/1/29,1133.51072,5986,82,687269,21383,No,Yes,12664
New Jersey,2021/1/30,1133.51072,5274,72,692543,21455,No,Yes,12664
New Jersey,2021/1/31,1133.51072,4288,29,696831,21484,No,Yes,12664
New Jersey,2021/2/1,1133.51072,3515,29,700346,21513,No,Yes,12664
New Jersey,2021/2/2,1133.51072,3150,71,703496,21584,No,Yes,12664
New Jersey,2021/2/3,1133.51072,2311,109,705807,21693,No,Yes,13464
New Jersey,2021/2/4,1133.51072,3289,100,709096,21793,No,Yes,13464
New Jersey,2021/2/5,1133.51072,4228,93,713324,21886,No,Yes,13464
New Jersey,2021/2/6,1133.51072,4510,78,717834,21964,No,Yes,13464
New Jersey,2021/2/7,1133.51072,4332,25,722166,21989,No,Yes,13464
New Jersey,2021/2/8,1133.51072,2561,22,724727,22011,No,Yes,13464
New Jersey,2021/2/9,1133.51072,3577,92,728304,22103,No,Yes,13464
New Jersey,2021/2/10,1133.51072,4370,88,732674,22191,No,Yes,12087
New Jersey,2021/2/11,1133.51072,3656,138,736330,22329,No,Yes,12087
New Jersey,2021/2/12,1133.51072,3732,64,740062,22393,No,Yes,12087
New Jersey,2021/2/13,1133.51072,3757,47,743819,22440,No,Yes,12087
New Jersey,2021/2/14,1133.51072,2168,14,745987,22454,No,Yes,12087
New Jersey,2021/2/15,1133.51072,1445,12,747432,22466,No,Yes,12087
New Jersey,2021/2/16,1133.51072,3633,31,751065,22497,No,Yes,12087
New Jersey,2021/2/17,1133.51072,4109,92,755174,22589,No,Yes,11395
New Jersey,2021/2/18,1133.51072,3276,132,758450,22721,No,Yes,11395
New Jersey,2021/2/19,1133.51072,3046,63,761496,22784,No,Yes,11395
New Jersey,2021/2/20,1133.51072,2878,50,764374,22834,No,Yes,11395
New Jersey,2021/2/21,1133.51072,2031,24,766405,22858,No,Yes,11395
New Jersey,2021/2/22,1133.51072,2704,16,769109,22874,No,Yes,11395
New Jersey,2021/2/23,1133.51072,3158,104,772267,22978,No,Yes,11395
New Jersey,2021/2/24,1133.51072,3118,57,775385,23035,No,Yes,11395
New Jersey,2021/2/25,1133.51072,3575,70,778960,23105,No,Yes,11395
New Jersey,2021/2/26,1133.51072,3869,87,782829,23192,No,Yes,11395
New Jersey,2021/2/27,1133.51072,4135,46,786964,23238,No,Yes,11395
New Jersey,2021/2/28,1133.51072,2390,14,789354,23252,No,Yes,11395
New Jersey,2021/3/1,1133.51072,3142,21,792496,23273,No,Yes,11395
New Jersey,2021/3/2,1133.51072,3289,48,795785,23321,No,Yes,11395
New Jersey,2021/3/3,1133.51072,3691,62,799476,23383,No,Yes,11395
New Jersey,2021/3/4,1133.51072,3193,108,802669,23491,No,Yes,11395
New Mexico,2020/3/1,17.23430539,0,0,0,0,No,No,1575
New Mexico,2020/3/2,17.23430539,0,0,0,0,No,No,1575
New Mexico,2020/3/3,17.23430539,0,0,0,0,No,No,1575
New Mexico,2020/3/4,17.23430539,0,0,0,0,No,No,1663
New Mexico,2020/3/5,17.23430539,0,0,0,0,No,No,1663
New Mexico,2020/3/6,17.23430539,0,0,0,0,No,No,1663
New Mexico,2020/3/7,17.23430539,0,0,0,0,No,No,1663
New Mexico,2020/3/8,17.23430539,0,0,0,0,No,No,1663
New Mexico,2020/3/9,17.23430539,0,0,0,0,No,No,1663
New Mexico,2020/3/10,17.23430539,0,0,0,0,No,No,1663
New Mexico,2020/3/11,17.23430539,4,0,4,0,No,No,1819
New Mexico,2020/3/12,17.23430539,2,0,6,0,No,No,1819
New Mexico,2020/3/13,17.23430539,4,0,10,0,No,No,1819
New Mexico,2020/3/14,17.23430539,3,0,13,0,No,No,1819
New Mexico,2020/3/15,17.23430539,4,0,17,0,No,No,1819
New Mexico,2020/3/16,17.23430539,4,0,21,0,No,No,1819
New Mexico,2020/3/17,17.23430539,2,0,23,0,No,No,1819
New Mexico,2020/3/18,17.23430539,5,0,28,0,No,No,10892
New Mexico,2020/3/19,17.23430539,7,0,35,0,No,No,10892
New Mexico,2020/3/20,17.23430539,8,0,43,0,No,No,10892
New Mexico,2020/3/21,17.23430539,14,0,57,0,No,No,10892
New Mexico,2020/3/22,17.23430539,8,0,65,0,No,No,10892
New Mexico,2020/3/23,17.23430539,18,0,83,0,No,No,10892
New Mexico,2020/3/24,17.23430539,17,0,100,0,Yes,No,10892
New Mexico,2020/3/25,17.23430539,13,1,113,1,Yes,No,80984
New Mexico,2020/3/26,17.23430539,23,0,136,1,Yes,No,80984
New Mexico,2020/3/27,17.23430539,55,0,191,1,Yes,No,80984
New Mexico,2020/3/28,17.23430539,19,1,210,2,Yes,No,80984
New Mexico,2020/3/29,17.23430539,27,0,237,2,Yes,No,80984
New Mexico,2020/3/30,17.23430539,45,2,282,4,Yes,No,80984
New Mexico,2020/3/31,17.23430539,33,1,315,5,Yes,No,80984
New Mexico,2020/4/1,17.23430539,48,1,363,6,Yes,No,106739
New Mexico,2020/4/2,17.23430539,40,1,403,7,Yes,No,106739
New Mexico,2020/4/3,17.23430539,92,3,495,10,Yes,No,106739
New Mexico,2020/4/4,17.23430539,49,1,544,11,Yes,No,106739
New Mexico,2020/4/5,17.23430539,80,1,624,12,Yes,No,106739
New Mexico,2020/4/6,17.23430539,62,0,686,12,Yes,No,106739
New Mexico,2020/4/7,17.23430539,108,1,794,13,Yes,No,106739
New Mexico,2020/4/8,17.23430539,71,3,865,16,Yes,No,77515
New Mexico,2020/4/9,17.23430539,124,1,989,17,Yes,No,77515
New Mexico,2020/4/10,17.23430539,101,2,1090,19,Yes,No,77515
New Mexico,2020/4/11,17.23430539,84,1,1174,20,Yes,No,77515
New Mexico,2020/4/12,17.23430539,71,6,1245,26,Yes,No,77515
New Mexico,2020/4/13,17.23430539,100,5,1345,31,Yes,No,77515
New Mexico,2020/4/14,17.23430539,62,5,1407,36,Yes,No,77515
New Mexico,2020/4/15,17.23430539,77,0,1484,36,Yes,No,66432
New Mexico,2020/4/16,17.23430539,113,8,1597,44,Yes,No,66432
New Mexico,2020/4/17,17.23430539,114,7,1711,51,Yes,No,66432
New Mexico,2020/4/18,17.23430539,87,2,1798,53,Yes,No,66432
New Mexico,2020/4/19,17.23430539,47,2,1845,55,Yes,No,66432
New Mexico,2020/4/20,17.23430539,126,3,1971,58,Yes,No,66432
New Mexico,2020/4/21,17.23430539,101,7,2072,65,Yes,No,66432
New Mexico,2020/4/22,17.23430539,138,6,2210,71,Yes,No,74966
New Mexico,2020/4/23,17.23430539,169,7,2379,78,Yes,No,74966
New Mexico,2020/4/24,17.23430539,145,6,2524,84,Yes,No,74966
New Mexico,2020/4/25,17.23430539,138,9,2662,93,Yes,No,74966
New Mexico,2020/4/26,17.23430539,66,6,2728,99,Yes,No,74966
New Mexico,2020/4/27,17.23430539,97,5,2825,104,Yes,No,74966
New Mexico,2020/4/28,17.23430539,150,6,2975,110,Yes,No,74966
New Mexico,2020/4/29,17.23430539,238,2,3213,112,Yes,No,28985
New Mexico,2020/4/30,17.23430539,198,11,3411,123,Yes,No,28985
New Mexico,2020/5/1,17.23430539,102,8,3513,131,Yes,No,28985
New Mexico,2020/5/2,17.23430539,219,8,3732,139,Yes,No,28985
New Mexico,2020/5/3,17.23430539,118,12,3850,151,Yes,No,28985
New Mexico,2020/5/4,17.23430539,180,5,4030,156,Yes,No,28985
New Mexico,2020/5/5,17.23430539,107,6,4137,162,Yes,No,28985
New Mexico,2020/5/6,17.23430539,153,7,4290,169,Yes,No,26666
New Mexico,2020/5/7,17.23430539,202,3,4492,172,Yes,No,26666
New Mexico,2020/5/8,17.23430539,181,9,4673,181,Yes,No,26666
New Mexico,2020/5/9,17.23430539,105,10,4778,191,Yes,No,26666
New Mexico,2020/5/10,17.23430539,85,9,4863,200,Yes,No,26666
New Mexico,2020/5/11,17.23430539,206,8,5069,208,Yes,No,26666
New Mexico,2020/5/12,17.23430539,143,11,5212,219,Yes,No,26666
New Mexico,2020/5/13,17.23430539,152,12,5364,231,Yes,No,25150
New Mexico,2020/5/14,17.23430539,139,11,5503,242,Yes,No,25150
New Mexico,2020/5/15,17.23430539,159,11,5662,253,Yes,No,25150
New Mexico,2020/5/16,17.23430539,185,6,5847,259,Yes,No,25150
New Mexico,2020/5/17,17.23430539,91,6,5938,265,Yes,No,25150
New Mexico,2020/5/18,17.23430539,158,5,6096,270,Yes,No,25150
New Mexico,2020/5/19,17.23430539,96,6,6192,276,Yes,No,25150
New Mexico,2020/5/20,17.23430539,146,7,6338,283,Yes,No,27919
New Mexico,2020/5/21,17.23430539,134,11,6472,294,Yes,No,27919
New Mexico,2020/5/22,17.23430539,153,8,6625,302,Yes,No,27919
New Mexico,2020/5/23,17.23430539,170,6,6795,308,Yes,No,27919
New Mexico,2020/5/24,17.23430539,148,9,6943,317,Yes,No,27919
New Mexico,2020/5/25,17.23430539,83,3,7026,320,Yes,No,27919
New Mexico,2020/5/26,17.23430539,104,5,7130,325,Yes,No,27919
New Mexico,2020/5/27,17.23430539,122,4,7252,329,Yes,No,21335
New Mexico,2020/5/28,17.23430539,112,6,7364,335,Yes,No,21335
New Mexico,2020/5/29,17.23430539,129,9,7493,344,Yes,No,21335
New Mexico,2020/5/30,17.23430539,131,7,7624,351,Yes,No,21335
New Mexico,2020/5/31,17.23430539,65,5,7689,356,Yes,No,21335
New Mexico,2020/6/1,17.23430539,111,6,7800,362,Yes,No,21335
New Mexico,2020/6/2,17.23430539,224,5,8024,367,Yes,No,21335
New Mexico,2020/6/3,17.23430539,116,8,8140,375,Yes,No,19949
New Mexico,2020/6/4,17.23430539,213,8,8353,383,Yes,No,19949
New Mexico,2020/6/5,17.23430539,319,4,8672,387,Yes,No,19949
New Mexico,2020/6/6,17.23430539,128,5,8800,392,Yes,No,19949
New Mexico,2020/6/7,17.23430539,140,4,8940,396,Yes,No,19949
New Mexico,2020/6/8,17.23430539,122,4,9062,400,Yes,No,19949
New Mexico,2020/6/9,17.23430539,43,4,9105,404,Yes,No,19949
New Mexico,2020/6/10,17.23430539,145,6,9250,410,Yes,No,18367
New Mexico,2020/6/11,17.23430539,118,11,9368,421,Yes,No,18367
New Mexico,2020/6/12,17.23430539,158,5,9526,426,Yes,No,18367
New Mexico,2020/6/13,17.23430539,95,5,9621,431,Yes,No,18367
New Mexico,2020/6/14,17.23430539,102,4,9723,435,Yes,No,18367
New Mexico,2020/6/15,17.23430539,122,5,9845,440,Yes,No,18367
New Mexico,2020/6/16,17.23430539,88,7,9933,447,Yes,No,18367
New Mexico,2020/6/17,17.23430539,132,5,10065,452,Yes,No,18671
New Mexico,2020/6/18,17.23430539,88,4,10153,456,Yes,No,18671
New Mexico,2020/6/19,17.23430539,107,8,10260,464,Yes,No,18671
New Mexico,2020/6/20,17.23430539,170,2,10430,466,Yes,No,18671
New Mexico,2020/6/21,17.23430539,135,3,10565,469,Yes,No,18671
New Mexico,2020/6/22,17.23430539,129,0,10694,469,Yes,No,18671
New Mexico,2020/6/23,17.23430539,144,7,10838,476,Yes,No,18671
New Mexico,2020/6/24,17.23430539,152,4,10990,480,Yes,No,18338
New Mexico,2020/6/25,17.23430539,202,5,11192,485,Yes,No,18338
New Mexico,2020/6/26,17.23430539,216,4,11408,489,Yes,No,18338
New Mexico,2020/6/27,17.23430539,211,2,11619,491,Yes,No,18338
New Mexico,2020/6/28,17.23430539,190,1,11809,492,Yes,No,18338
New Mexico,2020/6/29,17.23430539,173,1,11982,493,Yes,No,18338
New Mexico,2020/6/30,17.23430539,165,4,12147,497,Yes,No,18338
New Mexico,2020/7/1,17.23430539,129,3,12276,500,Yes,No,19056
New Mexico,2020/7/2,17.23430539,244,3,12520,503,Yes,No,19056
New Mexico,2020/7/3,17.23430539,256,8,12776,511,Yes,No,19056
New Mexico,2020/7/4,17.23430539,287,2,13063,513,Yes,No,19056
New Mexico,2020/7/5,17.23430539,193,0,13256,513,Yes,No,19056
New Mexico,2020/7/6,17.23430539,251,2,13507,515,Yes,No,19056
New Mexico,2020/7/7,17.23430539,220,4,13727,519,Yes,No,19056
New Mexico,2020/7/8,17.23430539,290,8,14017,527,Yes,No,20563
New Mexico,2020/7/9,17.23430539,234,6,14251,533,Yes,No,20563
New Mexico,2020/7/10,17.23430539,298,6,14549,539,Yes,No,20563
New Mexico,2020/7/11,17.23430539,224,4,14773,543,Yes,No,20563
New Mexico,2020/7/12,17.23430539,255,2,15028,545,Yes,No,20563
New Mexico,2020/7/13,17.23430539,263,3,15291,548,Yes,Yes,20563
New Mexico,2020/7/14,17.23430539,223,3,15514,551,Yes,Yes,20563
New Mexico,2020/7/15,17.23430539,327,6,15841,557,Yes,Yes,23676
New Mexico,2020/7/16,17.23430539,297,5,16138,562,Yes,Yes,23676
New Mexico,2020/7/17,17.23430539,318,3,16456,565,Yes,Yes,23676
New Mexico,2020/7/18,17.23430539,280,4,16736,569,Yes,Yes,23676
New Mexico,2020/7/19,17.23430539,235,2,16971,571,Yes,Yes,23676
New Mexico,2020/7/20,17.23430539,244,7,17215,578,Yes,Yes,23676
New Mexico,2020/7/21,17.23430539,302,10,17517,588,Yes,Yes,23676
New Mexico,2020/7/22,17.23430539,311,3,17828,591,Yes,Yes,17437
New Mexico,2020/7/23,17.23430539,335,5,18163,596,Yes,Yes,17437
New Mexico,2020/7/24,17.23430539,312,5,18475,601,Yes,Yes,17437
New Mexico,2020/7/25,17.23430539,313,6,18788,607,Yes,Yes,17437
New Mexico,2020/7/26,17.23430539,265,7,19053,614,Yes,Yes,17437
New Mexico,2020/7/27,17.23430539,449,5,19502,619,Yes,Yes,17437
New Mexico,2020/7/28,17.23430539,289,7,19791,626,Yes,Yes,17437
New Mexico,2020/7/29,17.23430539,345,6,20136,632,Yes,Yes,11690
New Mexico,2020/7/30,17.23430539,252,3,20388,635,Yes,Yes,11690
New Mexico,2020/7/31,17.23430539,212,7,20600,642,Yes,Yes,11690
New Mexico,2020/8/1,17.23430539,196,9,20796,651,Yes,Yes,11690
New Mexico,2020/8/2,17.23430539,220,3,21016,654,Yes,Yes,11690
New Mexico,2020/8/3,17.23430539,114,1,21130,655,Yes,Yes,11690
New Mexico,2020/8/4,17.23430539,210,3,21340,658,Yes,Yes,11690
New Mexico,2020/8/5,17.23430539,226,9,21566,667,Yes,Yes,9467
New Mexico,2020/8/6,17.23430539,207,2,21773,669,Yes,Yes,9467
New Mexico,2020/8/7,17.23430539,192,6,21965,675,Yes,Yes,9467
New Mexico,2020/8/8,17.23430539,150,6,22115,681,Yes,Yes,9467
New Mexico,2020/8/9,17.23430539,200,4,22315,685,Yes,Yes,9467
New Mexico,2020/8/10,17.23430539,129,5,22444,690,Yes,Yes,9467
New Mexico,2020/8/11,17.23430539,199,3,22643,693,Yes,Yes,9467
New Mexico,2020/8/12,17.23430539,173,2,22816,695,Yes,Yes,11047
New Mexico,2020/8/13,17.23430539,171,2,22987,697,Yes,Yes,11047
New Mexico,2020/8/14,17.23430539,173,6,23160,703,Yes,Yes,11047
New Mexico,2020/8/15,17.23430539,142,8,23302,711,Yes,Yes,11047
New Mexico,2020/8/16,17.23430539,106,3,23408,714,Yes,Yes,11047
New Mexico,2020/8/17,17.23430539,92,4,23500,718,Yes,Yes,11047
New Mexico,2020/8/18,17.23430539,79,5,23579,723,Yes,Yes,11047
New Mexico,2020/8/19,17.23430539,170,6,23749,729,Yes,Yes,8676
New Mexico,2020/8/20,17.23430539,202,5,23951,734,Yes,Yes,8676
New Mexico,2020/8/21,17.23430539,144,5,24095,739,Yes,Yes,8676
New Mexico,2020/8/22,17.23430539,207,4,24302,743,Yes,Yes,8676
New Mexico,2020/8/23,17.23430539,94,2,24396,745,Yes,Yes,8676
New Mexico,2020/8/24,17.23430539,73,2,24469,747,Yes,Yes,8676
New Mexico,2020/8/25,17.23430539,66,3,24535,750,Yes,Yes,8676
New Mexico,2020/8/26,17.23430539,197,5,24732,755,Yes,Yes,8511
New Mexico,2020/8/27,17.23430539,188,9,24920,764,Yes,Yes,8511
New Mexico,2020/8/28,17.23430539,122,3,25042,767,Yes,Yes,8511
New Mexico,2020/8/29,17.23430539,136,2,25178,769,Yes,No,8511
New Mexico,2020/8/30,17.23430539,105,1,25283,770,Yes,No,8511
New Mexico,2020/8/31,17.23430539,69,9,25352,779,Yes,No,8511
New Mexico,2020/9/1,17.23430539,108,8,25460,787,Yes,No,8511
New Mexico,2020/9/2,17.23430539,152,3,25612,790,Yes,No,8901
New Mexico,2020/9/3,17.23430539,200,1,25812,791,Yes,No,8901
New Mexico,2020/9/4,17.23430539,90,3,25902,794,Yes,No,8901
New Mexico,2020/9/5,17.23430539,146,6,26048,800,Yes,No,8901
New Mexico,2020/9/6,17.23430539,59,3,26107,803,Yes,No,8901
New Mexico,2020/9/7,17.23430539,37,4,26144,807,Yes,No,8901
New Mexico,2020/9/8,17.23430539,37,0,26181,807,Yes,No,8901
New Mexico,2020/9/9,17.23430539,87,6,26268,813,Yes,No,8848
New Mexico,2020/9/10,17.23430539,161,3,26429,816,Yes,No,8848
New Mexico,2020/9/11,17.23430539,134,2,26563,818,Yes,No,8848
New Mexico,2020/9/12,17.23430539,98,3,26661,821,Yes,No,8848
New Mexico,2020/9/13,17.23430539,100,2,26761,823,Yes,No,8848
New Mexico,2020/9/14,17.23430539,81,0,26842,823,Yes,No,8848
New Mexico,2020/9/15,17.23430539,81,7,26923,830,Yes,No,8848
New Mexico,2020/9/16,17.23430539,118,2,27041,832,Yes,No,8679
New Mexico,2020/9/17,17.23430539,158,4,27199,836,Yes,No,8679
New Mexico,2020/9/18,17.23430539,151,5,27350,841,Yes,No,8679
New Mexico,2020/9/19,17.23430539,162,6,27512,847,Yes,No,8679
New Mexico,2020/9/20,17.23430539,67,2,27579,849,Yes,No,8679
New Mexico,2020/9/21,17.23430539,104,2,27683,851,Yes,No,8679
New Mexico,2020/9/22,17.23430539,107,3,27790,854,Yes,No,8679
New Mexico,2020/9/23,17.23430539,197,3,27987,857,Yes,No,8805
New Mexico,2020/9/24,17.23430539,237,2,28224,859,Yes,No,8805
New Mexico,2020/9/25,17.23430539,263,6,28487,865,Yes,No,8805
New Mexico,2020/9/26,17.23430539,205,5,28692,870,Yes,No,8805
New Mexico,2020/9/27,17.23430539,152,0,28844,870,Yes,No,8805
New Mexico,2020/9/28,17.23430539,141,3,28985,873,Yes,No,8805
New Mexico,2020/9/29,17.23430539,172,2,29157,875,Yes,No,8805
New Mexico,2020/9/30,17.23430539,278,2,29435,877,Yes,No,7732
New Mexico,2020/10/1,17.23430539,226,5,29661,882,Yes,No,7732
New Mexico,2020/10/2,17.23430539,339,5,30000,887,Yes,No,7732
New Mexico,2020/10/3,17.23430539,296,3,30296,890,Yes,No,7732
New Mexico,2020/10/4,17.23430539,181,2,30477,892,Yes,No,7732
New Mexico,2020/10/5,17.23430539,155,2,30632,894,Yes,No,7732
New Mexico,2020/10/6,17.23430539,315,0,30947,894,Yes,No,7732
New Mexico,2020/10/7,17.23430539,425,2,31372,896,Yes,No,8581
New Mexico,2020/10/8,17.23430539,384,3,31756,899,Yes,No,8581
New Mexico,2020/10/9,17.23430539,485,3,32241,902,Yes,No,8581
New Mexico,2020/10/10,17.23430539,481,5,32722,907,Yes,No,8581
New Mexico,2020/10/11,17.23430539,261,4,32983,911,Yes,No,8581
New Mexico,2020/10/12,17.23430539,379,4,33362,915,Yes,No,8581
New Mexico,2020/10/13,17.23430539,351,3,33713,918,Yes,No,8581
New Mexico,2020/10/14,17.23430539,577,3,34290,921,Yes,No,7964
New Mexico,2020/10/15,17.23430539,668,1,34958,922,Yes,No,7964
New Mexico,2020/10/16,17.23430539,812,6,35770,928,Yes,No,7964
New Mexico,2020/10/17,17.23430539,573,1,36343,929,Yes,No,7964
New Mexico,2020/10/18,17.23430539,445,5,36788,934,Yes,No,7964
New Mexico,2020/10/19,17.23430539,514,1,37302,935,Yes,No,7964
New Mexico,2020/10/20,17.23430539,594,7,37896,942,Yes,No,7964
New Mexico,2020/10/21,17.23430539,819,8,38715,950,Yes,No,7126
New Mexico,2020/10/22,17.23430539,662,3,39377,953,Yes,No,7126
New Mexico,2020/10/23,17.23430539,791,7,40168,960,Yes,No,7126
New Mexico,2020/10/24,17.23430539,872,5,41040,965,Yes,No,7126
New Mexico,2020/10/25,17.23430539,823,2,41863,967,Yes,No,7126
New Mexico,2020/10/26,17.23430539,723,9,42586,976,Yes,No,7126
New Mexico,2020/10/27,17.23430539,583,4,43169,980,Yes,No,7126
New Mexico,2020/10/28,17.23430539,657,11,43826,991,Yes,No,7060
New Mexico,2020/10/29,17.23430539,1078,3,44904,994,Yes,No,7060
New Mexico,2020/10/30,17.23430539,1005,13,45909,1007,Yes,No,7060
New Mexico,2020/10/31,17.23430539,581,11,46490,1018,Yes,No,7060
New Mexico,2020/11/1,17.23430539,742,8,47232,1026,Yes,No,7060
New Mexico,2020/11/2,17.23430539,872,10,48104,1036,Yes,No,7060
New Mexico,2020/11/3,17.23430539,1136,9,49240,1045,Yes,No,7060
New Mexico,2020/11/4,17.23430539,1011,14,50251,1059,Yes,No,8764
New Mexico,2020/11/5,17.23430539,859,23,51110,1082,Yes,No,8764
New Mexico,2020/11/6,17.23430539,1284,6,52394,1088,Yes,No,8764
New Mexico,2020/11/7,17.23430539,1277,16,53671,1104,Yes,No,8764
New Mexico,2020/11/8,17.23430539,1210,14,54881,1118,Yes,No,8764
New Mexico,2020/11/9,17.23430539,1408,12,56289,1130,Yes,No,8764
New Mexico,2020/11/10,17.23430539,1258,14,57547,1144,Yes,No,8764
New Mexico,2020/11/11,17.23430539,1487,14,59034,1158,Yes,No,9262
New Mexico,2020/11/12,17.23430539,1742,18,60776,1176,Yes,No,9262
New Mexico,2020/11/13,17.23430539,1230,22,62006,1198,Yes,No,9262
New Mexico,2020/11/14,17.23430539,1165,10,63171,1208,Yes,No,9262
New Mexico,2020/11/15,17.23430539,1030,7,64201,1215,Yes,No,9262
New Mexico,2020/11/16,17.23430539,1253,21,65454,1236,Yes,No,9262
New Mexico,2020/11/17,17.23430539,2105,28,67559,1264,Yes,No,9262
New Mexico,2020/11/18,17.23430539,2893,26,70452,1290,Yes,No,11813
New Mexico,2020/11/19,17.23430539,3664,12,74116,1302,Yes,No,11813
New Mexico,2020/11/20,17.23430539,2982,25,77098,1327,Yes,No,11813
New Mexico,2020/11/21,17.23430539,2342,25,79440,1352,Yes,No,11813
New Mexico,2020/11/22,17.23430539,2456,33,81896,1385,Yes,No,11813
New Mexico,2020/11/23,17.23430539,2252,17,84148,1402,Yes,No,11813
New Mexico,2020/11/24,17.23430539,2099,28,86247,1430,Yes,No,11813
New Mexico,2020/11/25,17.23430539,1855,21,88102,1451,Yes,No,7061
New Mexico,2020/11/26,17.23430539,1694,18,89796,1469,Yes,No,7061
New Mexico,2020/11/27,17.23430539,2056,35,91852,1504,Yes,No,7061
New Mexico,2020/11/28,17.23430539,2130,23,93982,1527,Yes,No,7061
New Mexico,2020/11/29,17.23430539,1435,13,95417,1540,Yes,No,7061
New Mexico,2020/11/30,17.23430539,1678,28,97095,1568,Yes,No,7061
New Mexico,2020/12/1,17.23430539,2324,21,99419,1589,No,No,7061
New Mexico,2020/12/2,17.23430539,1544,40,100963,1629,No,No,7656
New Mexico,2020/12/3,17.23430539,1910,44,102873,1673,No,No,7656
New Mexico,2020/12/4,17.23430539,2062,33,104935,1706,No,No,7656
New Mexico,2020/12/5,17.23430539,1921,32,106856,1738,No,No,7656
New Mexico,2020/12/6,17.23430539,1232,11,108088,1749,No,No,7656
New Mexico,2020/12/7,17.23430539,1859,7,109947,1756,No,No,7656
New Mexico,2020/12/8,17.23430539,1244,33,111191,1789,No,No,7656
New Mexico,2020/12/9,17.23430539,1759,34,112950,1823,No,No,7568
New Mexico,2020/12/10,17.23430539,1781,23,114731,1846,No,No,7568
New Mexico,2020/12/11,17.23430539,1834,43,116565,1889,No,No,7568
New Mexico,2020/12/12,17.23430539,1793,24,118358,1913,No,No,7568
New Mexico,2020/12/13,17.23430539,1442,44,119800,1957,No,No,7568
New Mexico,2020/12/14,17.23430539,1499,21,121299,1978,No,No,7568
New Mexico,2020/12/15,17.23430539,1258,28,122557,2006,No,No,7568
New Mexico,2020/12/16,17.23430539,1800,43,124357,2049,No,No,7543
New Mexico,2020/12/17,17.23430539,1688,54,126045,2103,No,No,7543
New Mexico,2020/12/18,17.23430539,1455,25,127500,2128,No,No,7543
New Mexico,2020/12/19,17.23430539,1430,27,128930,2155,No,No,7543
New Mexico,2020/12/20,17.23430539,1063,16,129993,2171,No,No,7543
New Mexico,2020/12/21,17.23430539,815,9,130808,2180,No,No,7543
New Mexico,2020/12/22,17.23430539,1267,23,132075,2203,No,No,7543
New Mexico,2020/12/23,17.23430539,1167,40,133242,2243,No,No,5506
New Mexico,2020/12/24,17.23430539,1924,29,135166,2272,No,No,5506
New Mexico,2020/12/25,17.23430539,1456,37,136622,2309,No,No,5506
New Mexico,2020/12/26,17.23430539,605,9,137227,2318,No,No,5506
New Mexico,2020/12/27,17.23430539,741,30,137968,2348,No,No,5506
New Mexico,2020/12/28,17.23430539,691,36,138659,2384,No,No,5506
New Mexico,2020/12/29,17.23430539,1249,21,139908,2405,No,No,5506
New Mexico,2020/12/30,17.23430539,1311,33,141219,2438,No,No,10986
New Mexico,2020/12/31,17.23430539,1678,41,142897,2479,No,No,10986
New Mexico,2021/1/1,17.23430539,1245,25,144142,2504,No,No,10986
New Mexico,2021/1/2,17.23430539,1237,32,145379,2536,No,No,10986
New Mexico,2021/1/3,17.23430539,1015,17,146394,2553,No,No,10986
New Mexico,2021/1/4,17.23430539,921,23,147315,2576,No,No,10986
New Mexico,2021/1/5,17.23430539,1184,20,148499,2596,No,No,10986
New Mexico,2021/1/6,17.23430539,1485,47,149984,2643,No,No,14084
New Mexico,2021/1/7,17.23430539,1835,39,151819,2682,No,No,14084
New Mexico,2021/1/8,17.23430539,1637,30,153456,2712,No,No,14084
New Mexico,2021/1/9,17.23430539,1498,22,154954,2734,No,No,14084
New Mexico,2021/1/10,17.23430539,1203,17,156157,2751,No,No,14084
New Mexico,2021/1/11,17.23430539,930,15,157087,2766,No,No,14084
New Mexico,2021/1/12,17.23430539,887,30,157974,2796,No,No,14084
New Mexico,2021/1/13,17.23430539,1145,13,159119,2809,No,No,11980
New Mexico,2021/1/14,17.23430539,1424,29,160543,2838,No,No,11980
New Mexico,2021/1/15,17.23430539,1262,38,161805,2876,No,No,11980
New Mexico,2021/1/16,17.23430539,1088,36,162893,2912,No,No,11980
New Mexico,2021/1/17,17.23430539,744,22,163637,2934,No,No,11980
New Mexico,2021/1/18,17.23430539,626,26,164263,2960,No,No,11980
New Mexico,2021/1/19,17.23430539,691,17,164954,2977,No,No,11980
New Mexico,2021/1/20,17.23430539,881,34,165835,3011,No,No,11615
New Mexico,2021/1/21,17.23430539,988,35,166823,3046,No,No,11615
New Mexico,2021/1/22,17.23430539,908,33,167731,3079,No,No,11615
New Mexico,2021/1/23,17.23430539,848,38,168579,3117,No,No,11615
New Mexico,2021/1/24,17.23430539,626,30,169205,3147,No,No,11615
New Mexico,2021/1/25,17.23430539,491,12,169696,3159,No,No,11615
New Mexico,2021/1/26,17.23430539,600,14,170296,3173,No,No,11615
New Mexico,2021/1/27,17.23430539,751,27,171047,3200,No,No,12664
New Mexico,2021/1/28,17.23430539,672,28,171719,3228,No,No,12664
New Mexico,2021/1/29,17.23430539,1079,22,172798,3250,No,No,12664
New Mexico,2021/1/30,17.23430539,741,17,173539,3267,No,No,12664
New Mexico,2021/1/31,17.23430539,525,18,174064,3285,No,No,12664
New Mexico,2021/2/1,17.23430539,486,12,174550,3297,No,No,12664
New Mexico,2021/2/2,17.23430539,432,15,174982,3312,No,No,12664
New Mexico,2021/2/3,17.23430539,670,28,175652,3340,No,No,13464
New Mexico,2021/2/4,17.23430539,559,17,176211,3357,No,No,13464
New Mexico,2021/2/5,17.23430539,582,23,176793,3380,No,No,13464
New Mexico,2021/2/6,17.23430539,421,8,177214,3388,No,No,13464
New Mexico,2021/2/7,17.23430539,342,13,177556,3401,No,No,13464
New Mexico,2021/2/8,17.23430539,311,13,177867,3414,No,No,13464
New Mexico,2021/2/9,17.23430539,413,18,178280,3432,No,No,13464
New Mexico,2021/2/10,17.23430539,510,31,178790,3463,No,No,12087
New Mexico,2021/2/11,17.23430539,533,18,179323,3481,No,No,12087
New Mexico,2021/2/12,17.23430539,401,23,179724,3504,No,No,12087
New Mexico,2021/2/13,17.23430539,565,14,180289,3518,No,No,12087
New Mexico,2021/2/14,17.23430539,282,13,180571,3531,No,No,12087
New Mexico,2021/2/15,17.23430539,190,9,180761,3540,No,No,12087
New Mexico,2021/2/16,17.23430539,300,12,181061,3552,No,No,12087
New Mexico,2021/2/17,17.23430539,271,12,181332,3564,No,No,11395
New Mexico,2021/2/18,17.23430539,407,18,181739,3582,No,No,11395
New Mexico,2021/2/19,17.23430539,311,19,182050,3601,No,No,11395
New Mexico,2021/2/20,17.23430539,425,11,182475,3612,No,No,11395
New Mexico,2021/2/21,17.23430539,314,14,182789,3626,No,No,11395
New Mexico,2021/2/22,17.23430539,234,11,183023,3637,No,No,11395
New Mexico,2021/2/23,17.23430539,312,9,183335,3646,No,No,11395
New Mexico,2021/2/24,17.23430539,446,14,183781,3660,No,No,11395
New Mexico,2021/2/25,17.23430539,299,13,184080,3673,No,No,11395
New Mexico,2021/2/26,17.23430539,656,14,184736,3687,No,No,11395
New Mexico,2021/2/27,17.23430539,152,15,184888,3702,No,No,11395
New Mexico,2021/2/28,17.23430539,244,14,185132,3716,No,No,11395
New Mexico,2021/3/1,17.23430539,165,15,185297,3731,No,No,11395
New Mexico,2021/3/2,17.23430539,245,11,185542,3742,No,No,11395
New Mexico,2021/3/3,17.23430539,356,13,185898,3755,No,No,11395
New Mexico,2021/3/4,17.23430539,258,16,186156,3771,No,No,11395
New York,2020/3/1,392.3987615,1,0,1,0,No,No,1575
New York,2020/3/2,392.3987615,0,0,1,0,No,No,1575
New York,2020/3/3,392.3987615,1,0,2,0,No,No,1575
New York,2020/3/4,392.3987615,9,0,11,0,No,No,1663
New York,2020/3/5,392.3987615,11,0,22,0,No,No,1663
New York,2020/3/6,392.3987615,22,0,44,0,No,No,1663
New York,2020/3/7,392.3987615,45,0,89,0,No,No,1663
New York,2020/3/8,392.3987615,17,0,106,0,No,No,1663
New York,2020/3/9,392.3987615,36,0,142,0,No,No,1663
New York,2020/3/10,392.3987615,31,0,173,0,No,No,1663
New York,2020/3/11,392.3987615,44,0,217,0,No,No,1819
New York,2020/3/12,392.3987615,109,0,326,0,No,No,1819
New York,2020/3/13,392.3987615,95,0,421,0,No,No,1819
New York,2020/3/14,392.3987615,189,2,610,2,No,No,1819
New York,2020/3/15,392.3987615,122,4,732,6,No,No,1819
New York,2020/3/16,392.3987615,218,4,950,10,No,No,1819
New York,2020/3/17,392.3987615,425,8,1375,18,No,No,1819
New York,2020/3/18,392.3987615,1012,14,2387,32,No,No,10892
New York,2020/3/19,392.3987615,1774,7,4161,39,No,No,10892
New York,2020/3/20,392.3987615,2952,29,7113,68,Yes,No,10892
New York,2020/3/21,392.3987615,3258,27,10371,95,Yes,No,10892
New York,2020/3/22,392.3987615,4817,47,15188,142,Yes,No,10892
New York,2020/3/23,392.3987615,5711,41,20899,183,Yes,No,10892
New York,2020/3/24,392.3987615,4805,81,25704,264,Yes,No,10892
New York,2020/3/25,392.3987615,7413,117,33117,381,Yes,No,80984
New York,2020/3/26,392.3987615,5941,121,39058,502,Yes,No,80984
New York,2020/3/27,392.3987615,5688,143,44746,645,Yes,No,80984
New York,2020/3/28,392.3987615,8771,290,53517,935,Yes,No,80984
New York,2020/3/29,392.3987615,6266,245,59783,1180,Yes,No,80984
New York,2020/3/30,392.3987615,7721,332,67504,1512,Yes,No,80984
New York,2020/3/31,392.3987615,8707,417,76211,1929,Yes,No,80984
New York,2020/4/1,392.3987615,8153,486,84364,2415,Yes,No,106739
New York,2020/4/2,392.3987615,8996,548,93360,2963,Yes,No,106739
New York,2020/4/3,392.3987615,10329,753,103689,3716,Yes,No,106739
New York,2020/4/4,392.3987615,12274,819,115963,4535,Yes,No,106739
New York,2020/4/5,392.3987615,8122,800,124085,5335,Yes,No,106739
New York,2020/4/6,392.3987615,9304,814,133389,6149,Yes,No,106739
New York,2020/4/7,392.3987615,8314,1036,141703,7185,Yes,No,106739
New York,2020/4/8,392.3987615,9568,953,151271,8138,Yes,No,77515
New York,2020/4/9,392.3987615,10765,1028,162036,9166,Yes,No,77515
New York,2020/4/10,392.3987615,10794,996,172830,10162,Yes,No,77515
New York,2020/4/11,392.3987615,10160,997,182990,11159,Yes,No,77515
New York,2020/4/12,392.3987615,8435,957,191425,12116,Yes,No,77515
New York,2020/4/13,392.3987615,6548,882,197973,12998,Yes,No,77515
New York,2020/4/14,392.3987615,7402,1003,205375,14001,Yes,No,77515
New York,2020/4/15,392.3987615,11755,936,217130,14937,Yes,Yes,66432
New York,2020/4/16,392.3987615,8631,732,225761,15669,Yes,Yes,66432
New York,2020/4/17,392.3987615,7532,804,233293,16473,Yes,Yes,66432
New York,2020/4/18,392.3987615,7249,668,240542,17141,Yes,Yes,66432
New York,2020/4/19,392.3987615,6199,652,246741,17793,Yes,Yes,66432
New York,2020/4/20,392.3987615,4867,619,251608,18412,Yes,Yes,66432
New York,2020/4/21,392.3987615,4324,628,255932,19040,Yes,Yes,66432
New York,2020/4/22,392.3987615,5659,607,261591,19647,Yes,Yes,74966
New York,2020/4/23,392.3987615,6341,565,267932,20212,Yes,Yes,74966
New York,2020/4/24,392.3987615,8286,547,276218,20759,Yes,Yes,74966
New York,2020/4/25,392.3987615,10683,567,286901,21326,Yes,Yes,74966
New York,2020/4/26,392.3987615,6013,478,292914,21804,Yes,Yes,74966
New York,2020/4/27,392.3987615,4077,463,296991,22267,Yes,Yes,74966
New York,2020/4/28,392.3987615,3285,510,300276,22777,Yes,Yes,74966
New York,2020/4/29,392.3987615,4718,510,304994,23287,Yes,Yes,28985
New York,2020/4/30,392.3987615,4702,329,309696,23616,Yes,Yes,28985
New York,2020/5/1,392.3987615,3879,225,313575,23841,Yes,Yes,28985
New York,2020/5/2,392.3987615,4559,194,318134,24035,Yes,Yes,28985
New York,2020/5/3,392.3987615,3699,541,321833,24576,Yes,Yes,28985
New York,2020/5/4,392.3987615,2524,212,324357,24788,Yes,Yes,28985
New York,2020/5/5,392.3987615,2302,240,326659,25028,Yes,Yes,28985
New York,2020/5/6,392.3987615,2746,928,329405,25956,Yes,Yes,26666
New York,2020/5/7,392.3987615,3526,250,332931,26206,Yes,Yes,26666
New York,2020/5/8,392.3987615,2873,152,335804,26358,Yes,Yes,26666
New York,2020/5/9,392.3987615,2715,226,338519,26584,Yes,Yes,26666
New York,2020/5/10,392.3987615,2138,214,340657,26798,Yes,Yes,26666
New York,2020/5/11,392.3987615,1610,205,342267,27003,Yes,Yes,26666
New York,2020/5/12,392.3987615,1438,279,343705,27282,Yes,Yes,26666
New York,2020/5/13,392.3987615,2123,166,345828,27448,Yes,Yes,25150
New York,2020/5/14,392.3987615,2364,169,348192,27617,Yes,Yes,25150
New York,2020/5/15,392.3987615,2759,138,350951,27755,Yes,Yes,25150
New York,2020/5/16,392.3987615,2185,198,353136,27953,Yes,Yes,25150
New York,2020/5/17,392.3987615,1901,215,355037,28168,Yes,Yes,25150
New York,2020/5/18,392.3987615,1241,134,356278,28302,Yes,Yes,25150
New York,2020/5/19,392.3987615,1479,135,357757,28437,Yes,Yes,25150
New York,2020/5/20,392.3987615,1478,103,359235,28540,Yes,Yes,27919
New York,2020/5/21,392.3987615,2078,123,361313,28663,Yes,Yes,27919
New York,2020/5/22,392.3987615,1678,139,362991,28802,Yes,Yes,27919
New York,2020/5/23,392.3987615,1754,98,364745,28900,Yes,Yes,27919
New York,2020/5/24,392.3987615,1601,146,366346,29046,Yes,Yes,27919
New York,2020/5/25,392.3987615,1279,92,367625,29138,Yes,Yes,27919
New York,2020/5/26,392.3987615,1044,103,368669,29241,Yes,Yes,27919
New York,2020/5/27,392.3987615,1132,98,369801,29339,Yes,Yes,21335
New York,2020/5/28,392.3987615,1758,99,371559,29438,Yes,Yes,21335
New York,2020/5/29,392.3987615,1549,97,373108,29535,Yes,Yes,21335
New York,2020/5/30,392.3987615,1363,77,374471,29612,Yes,Yes,21335
New York,2020/5/31,392.3987615,1104,87,375575,29699,Yes,Yes,21335
New York,2020/6/1,392.3987615,945,67,376520,29766,Yes,Yes,21335
New York,2020/6/2,392.3987615,1361,81,377881,29847,Yes,Yes,21335
New York,2020/6/3,392.3987615,1043,71,378924,29918,Yes,Yes,19949
New York,2020/6/4,392.3987615,1053,93,379977,30011,Yes,Yes,19949
New York,2020/6/5,392.3987615,1042,55,381019,30066,Yes,Yes,19949
New York,2020/6/6,392.3987615,1083,57,382102,30123,Yes,Yes,19949
New York,2020/6/7,392.3987615,777,60,382879,30183,Yes,Yes,19949
New York,2020/6/8,392.3987615,712,56,383591,30239,Yes,Yes,19949
New York,2020/6/9,392.3987615,690,70,384281,30309,Yes,Yes,19949
New York,2020/6/10,392.3987615,664,67,384945,30376,Yes,Yes,18367
New York,2020/6/11,392.3987615,724,55,385669,30431,Yes,Yes,18367
New York,2020/6/12,392.3987615,821,80,386490,30511,Yes,Yes,18367
New York,2020/6/13,392.3987615,912,54,387402,30565,Yes,Yes,18367
New York,2020/6/14,392.3987615,694,40,388096,30605,Yes,Yes,18367
New York,2020/6/15,392.3987615,623,40,388719,30645,Yes,Yes,18367
New York,2020/6/16,392.3987615,630,38,389349,30683,Yes,Yes,18367
New York,2020/6/17,392.3987615,561,39,389910,30722,Yes,Yes,18671
New York,2020/6/18,392.3987615,626,45,390536,30767,Yes,Yes,18671
New York,2020/6/19,392.3987615,794,49,391330,30816,Yes,Yes,18671
New York,2020/6/20,392.3987615,707,23,392037,30839,Yes,Yes,18671
New York,2020/6/21,392.3987615,665,45,392702,30884,Yes,Yes,18671
New York,2020/6/22,392.3987615,555,50,393257,30934,Yes,Yes,18671
New York,2020/6/23,392.3987615,598,36,393855,30970,Yes,Yes,18671
New York,2020/6/24,392.3987615,575,31,394430,31001,Yes,Yes,18338
New York,2020/6/25,392.3987615,738,28,395168,31029,Yes,Yes,18338
New York,2020/6/26,392.3987615,804,46,395972,31075,Yes,Yes,18338
New York,2020/6/27,392.3987615,697,30,396669,31105,Yes,Yes,18338
New York,2020/6/28,392.3987615,624,32,397293,31137,No,Yes,18338
New York,2020/6/29,392.3987615,391,6,397684,31143,No,Yes,18338
New York,2020/6/30,392.3987615,458,633,398142,31776,No,Yes,18338
New York,2020/7/1,392.3987615,628,15,398770,31791,No,Yes,19056
New York,2020/7/2,392.3987615,872,23,399642,31814,No,Yes,19056
New York,2020/7/3,392.3987615,919,22,400561,31836,No,Yes,19056
New York,2020/7/4,392.3987615,725,24,401286,31860,No,Yes,19056
New York,2020/7/5,392.3987615,536,35,401822,31895,No,Yes,19056
New York,2020/7/6,392.3987615,516,16,402338,31911,No,Yes,19056
New York,2020/7/7,392.3987615,590,23,402928,31934,No,Yes,19056
New York,2020/7/8,392.3987615,691,11,403619,31945,No,Yes,20563
New York,2020/7/9,392.3987615,588,34,404207,31979,No,Yes,20563
New York,2020/7/10,392.3987615,790,25,404997,32004,No,Yes,20563
New York,2020/7/11,392.3987615,727,15,405724,32019,No,Yes,20563
New York,2020/7/12,392.3987615,679,10,406403,32029,No,Yes,20563
New York,2020/7/13,392.3987615,559,46,406962,32075,No,Yes,20563
New York,2020/7/14,392.3987615,913,17,407875,32092,No,Yes,20563
New York,2020/7/15,392.3987615,834,23,408709,32115,No,Yes,23676
New York,2020/7/16,392.3987615,767,18,409476,32133,No,Yes,23676
New York,2020/7/17,392.3987615,778,14,410254,32147,No,Yes,23676
New York,2020/7/18,392.3987615,752,20,411006,32167,No,Yes,23676
New York,2020/7/19,392.3987615,509,20,411515,32187,No,Yes,23676
New York,2020/7/20,392.3987615,519,16,412034,32203,No,Yes,23676
New York,2020/7/21,392.3987615,855,15,412889,32218,No,Yes,23676
New York,2020/7/22,392.3987615,706,10,413595,32228,No,Yes,17437
New York,2020/7/23,392.3987615,810,42,414405,32270,No,Yes,17437
New York,2020/7/24,392.3987615,758,8,415163,32278,No,Yes,17437
New York,2020/7/25,392.3987615,748,17,415911,32295,No,Yes,17437
New York,2020/7/26,392.3987615,532,10,416443,32305,No,Yes,17437
New York,2020/7/27,392.3987615,613,17,417056,32322,No,Yes,17437
New York,2020/7/28,392.3987615,535,11,417591,32333,No,Yes,17437
New York,2020/7/29,392.3987615,711,9,418302,32342,No,Yes,11690
New York,2020/7/30,392.3987615,779,20,419081,32362,No,Yes,11690
New York,2020/7/31,392.3987615,642,10,419723,32372,No,Yes,11690
New York,2020/8/1,392.3987615,754,18,420477,32390,No,Yes,11690
New York,2020/8/2,392.3987615,531,11,421008,32401,No,Yes,11690
New York,2020/8/3,392.3987615,542,12,421550,32413,No,Yes,11690
New York,2020/8/4,392.3987615,746,9,422296,32422,No,Yes,11690
New York,2020/8/5,392.3987615,639,9,422935,32431,No,Yes,9467
New York,2020/8/6,392.3987615,694,-102,423629,32329,No,Yes,9467
New York,2020/8/7,392.3987615,720,7,424349,32336,No,Yes,9467
New York,2020/8/8,392.3987615,706,9,425055,32345,No,Yes,9467
New York,2020/8/9,392.3987615,513,9,425568,32354,No,Yes,9467
New York,2020/8/10,392.3987615,478,7,426046,32361,No,Yes,9467
New York,2020/8/11,392.3987615,667,11,426713,32372,No,Yes,9467
New York,2020/8/12,392.3987615,706,12,427419,32384,No,Yes,11047
New York,2020/8/13,392.3987615,736,15,428155,32399,No,Yes,11047
New York,2020/8/14,392.3987615,724,8,428879,32407,No,Yes,11047
New York,2020/8/15,392.3987615,738,7,429617,32414,No,Yes,11047
New York,2020/8/16,392.3987615,609,10,430226,32424,No,Yes,11047
New York,2020/8/17,392.3987615,410,11,430636,32435,No,Yes,11047
New York,2020/8/18,392.3987615,662,11,431298,32446,No,Yes,11047
New York,2020/8/19,392.3987615,626,5,431924,32451,No,Yes,8676
New York,2020/8/20,392.3987615,599,0,432523,32451,No,Yes,8676
New York,2020/8/21,392.3987615,707,5,433230,32456,No,Yes,8676
New York,2020/8/22,392.3987615,651,8,433881,32464,No,Yes,8676
New York,2020/8/23,392.3987615,581,18,434462,32482,No,Yes,8676
New York,2020/8/24,392.3987615,404,7,434866,32489,No,Yes,8676
New York,2020/8/25,392.3987615,629,6,435495,32495,No,Yes,8676
New York,2020/8/26,392.3987615,568,4,436063,32499,No,Yes,8511
New York,2020/8/27,392.3987615,789,8,436852,32507,No,Yes,8511
New York,2020/8/28,392.3987615,635,8,437487,32515,No,Yes,8511
New York,2020/8/29,392.3987615,635,7,438122,32522,No,Yes,8511
New York,2020/8/30,392.3987615,709,12,438831,32534,No,Yes,8511
New York,2020/8/31,392.3987615,649,7,439480,32541,No,Yes,8511
New York,2020/9/1,392.3987615,757,10,440237,32551,No,Yes,8511
New York,2020/9/2,392.3987615,710,8,440947,32559,No,Yes,8901
New York,2020/9/3,392.3987615,888,8,441835,32567,No,Yes,8901
New York,2020/9/4,392.3987615,863,6,442698,32573,No,Yes,8901
New York,2020/9/5,392.3987615,799,6,443497,32579,No,Yes,8901
New York,2020/9/6,392.3987615,729,6,444226,32585,No,Yes,8901
New York,2020/9/7,392.3987615,525,15,444751,32600,No,Yes,8901
New York,2020/9/8,392.3987615,557,12,445308,32612,No,Yes,8901
New York,2020/9/9,392.3987615,573,-1,445881,32611,No,Yes,8848
New York,2020/9/10,392.3987615,756,7,446637,32618,No,Yes,8848
New York,2020/9/11,392.3987615,861,1,447498,32619,No,Yes,8848
New York,2020/9/12,392.3987615,849,6,448347,32625,No,Yes,8848
New York,2020/9/13,392.3987615,725,4,449072,32629,No,Yes,8848
New York,2020/9/14,392.3987615,586,10,449658,32639,No,Yes,8848
New York,2020/9/15,392.3987615,767,16,450425,32655,No,Yes,8848
New York,2020/9/16,392.3987615,653,7,451078,32662,No,Yes,8679
New York,2020/9/17,392.3987615,893,7,451971,32669,No,Yes,8679
New York,2020/9/18,392.3987615,793,13,452764,32682,No,Yes,8679
New York,2020/9/19,392.3987615,983,-3,453747,32679,No,Yes,8679
New York,2020/9/20,392.3987615,865,7,454612,32686,No,Yes,8679
New York,2020/9/21,392.3987615,575,5,455187,32691,No,Yes,8679
New York,2020/9/22,392.3987615,751,-1,455938,32690,No,Yes,8679
New York,2020/9/23,392.3987615,666,1,456604,32691,No,Yes,8805
New York,2020/9/24,392.3987615,953,5,457557,32696,No,Yes,8805
New York,2020/9/25,392.3987615,909,12,458466,32708,No,Yes,8805
New York,2020/9/26,392.3987615,1006,5,459472,32713,No,Yes,8805
New York,2020/9/27,392.3987615,868,9,460340,32722,No,Yes,8805
New York,2020/9/28,392.3987615,836,15,461176,32737,No,Yes,8805
New York,2020/9/29,392.3987615,1188,6,462364,32743,No,Yes,8805
New York,2020/9/30,392.3987615,1005,14,463369,32757,No,Yes,7732
New York,2020/10/1,392.3987615,1383,11,464752,32768,No,Yes,7732
New York,2020/10/2,392.3987615,1601,21,466353,32789,No,Yes,7732
New York,2020/10/3,392.3987615,1728,5,468081,32794,No,Yes,7732
New York,2020/10/4,392.3987615,1226,19,469307,32813,No,Yes,7732
New York,2020/10/5,392.3987615,937,14,470244,32827,No,Yes,7732
New York,2020/10/6,392.3987615,1394,9,471638,32836,No,Yes,7732
New York,2020/10/7,392.3987615,1356,14,472994,32850,No,Yes,8581
New York,2020/10/8,392.3987615,1835,9,474829,32859,No,Yes,8581
New York,2020/10/9,392.3987615,1593,8,476422,32867,No,Yes,8581
New York,2020/10/10,392.3987615,1448,8,477870,32875,No,Yes,8581
New York,2020/10/11,392.3987615,1143,4,479013,32879,No,Yes,8581
New York,2020/10/12,392.3987615,1032,17,480045,32896,No,Yes,8581
New York,2020/10/13,392.3987615,1391,9,481436,32905,No,Yes,8581
New York,2020/10/14,392.3987615,1235,11,482671,32916,No,Yes,7964
New York,2020/10/15,392.3987615,1464,19,484135,32935,No,Yes,7964
New York,2020/10/16,392.3987615,1703,9,485838,32944,No,Yes,7964
New York,2020/10/17,392.3987615,1788,15,487626,32959,No,Yes,7964
New York,2020/10/18,392.3987615,1390,13,489016,32972,No,Yes,7964
New York,2020/10/19,392.3987615,999,18,490015,32990,No,Yes,7964
New York,2020/10/20,392.3987615,1201,8,491216,32998,No,Yes,7964
New York,2020/10/21,392.3987615,2029,7,493245,33005,No,Yes,7126
New York,2020/10/22,392.3987615,1629,17,494874,33022,No,Yes,7126
New York,2020/10/23,392.3987615,1636,16,496510,33038,No,Yes,7126
New York,2020/10/24,392.3987615,2058,11,498568,33049,No,Yes,7126
New York,2020/10/25,392.3987615,1633,10,500201,33059,No,Yes,7126
New York,2020/10/26,392.3987615,1192,14,501393,33073,No,Yes,7126
New York,2020/10/27,392.3987615,1994,19,503387,33092,No,Yes,7126
New York,2020/10/28,392.3987615,2029,15,505416,33107,No,Yes,7060
New York,2020/10/29,392.3987615,2497,21,507913,33128,No,Yes,7060
New York,2020/10/30,392.3987615,2258,15,510171,33143,No,Yes,7060
New York,2020/10/31,392.3987615,2052,9,512223,33152,No,Yes,7060
New York,2020/11/1,392.3987615,2259,22,514482,33174,No,Yes,7060
New York,2020/11/2,392.3987615,1632,13,516114,33187,No,Yes,7060
New York,2020/11/3,392.3987615,2317,11,518431,33198,No,Yes,7060
New York,2020/11/4,392.3987615,2126,24,520557,33222,No,Yes,8764
New York,2020/11/5,392.3987615,3002,25,523559,33247,No,Yes,8764
New York,2020/11/6,392.3987615,3208,20,526767,33267,No,Yes,8764
New York,2020/11/7,392.3987615,3587,20,530354,33287,No,Yes,8764
New York,2020/11/8,392.3987615,3430,27,533784,33314,No,Yes,8764
New York,2020/11/9,392.3987615,3149,29,536933,33343,No,Yes,8764
New York,2020/11/10,392.3987615,3964,30,540897,33373,No,Yes,8764
New York,2020/11/11,392.3987615,4821,25,545718,33398,No,Yes,9262
New York,2020/11/12,392.3987615,4798,26,550516,33424,No,Yes,9262
New York,2020/11/13,392.3987615,5401,28,555917,33452,No,Yes,9262
New York,2020/11/14,392.3987615,5391,25,561308,33477,No,Yes,9262
New York,2020/11/15,392.3987615,3644,31,564952,33508,No,Yes,9262
New York,2020/11/16,392.3987615,3498,32,568450,33540,No,Yes,9262
New York,2020/11/17,392.3987615,5094,36,573544,33576,No,Yes,9262
New York,2020/11/18,392.3987615,5282,31,578826,33607,No,Yes,11813
New York,2020/11/19,392.3987615,5302,41,584128,33648,No,Yes,11813
New York,2020/11/20,392.3987615,5477,48,589605,33696,No,Yes,11813
New York,2020/11/21,392.3987615,5976,41,595581,33737,No,Yes,11813
New York,2020/11/22,392.3987615,5386,30,600967,33767,No,Yes,11813
New York,2020/11/23,392.3987615,5911,37,606878,33804,No,Yes,11813
New York,2020/11/24,392.3987615,4878,43,611756,33847,No,Yes,11813
New York,2020/11/25,392.3987615,6267,43,618023,33890,No,Yes,7061
New York,2020/11/26,392.3987615,6938,69,624961,33959,No,Yes,7061
New York,2020/11/27,392.3987615,8179,45,633140,34004,No,Yes,7061
New York,2020/11/28,392.3987615,6060,45,639200,34049,No,Yes,7061
New York,2020/11/29,392.3987615,6732,52,645932,34101,No,Yes,7061
New York,2020/11/30,392.3987615,6816,49,652748,34150,No,Yes,7061
New York,2020/12/1,392.3987615,7293,72,660041,34222,No,Yes,7061
New York,2020/12/2,392.3987615,8975,64,669016,34286,No,Yes,7656
New York,2020/12/3,392.3987615,9853,60,678869,34346,No,Yes,7656
New York,2020/12/4,392.3987615,11274,63,690143,34409,No,Yes,7656
New York,2020/12/5,392.3987615,10759,79,700902,34488,No,Yes,7656
New York,2020/12/6,392.3987615,9710,64,710612,34552,No,Yes,7656
New York,2020/12/7,392.3987615,8379,85,718991,34637,No,Yes,7656
New York,2020/12/8,392.3987615,9019,86,728010,34723,No,Yes,7656
New York,2020/12/9,392.3987615,10937,76,738947,34799,No,Yes,7568
New York,2020/12/10,392.3987615,10257,85,749204,34884,No,Yes,7568
New York,2020/12/11,392.3987615,10561,99,759765,34983,No,Yes,7568
New York,2020/12/12,392.3987615,11039,91,770804,35074,No,Yes,7568
New York,2020/12/13,392.3987615,10027,124,780831,35198,No,Yes,7568
New York,2020/12/14,392.3987615,8984,90,789815,35288,No,Yes,7568
New York,2020/12/15,392.3987615,9736,137,799551,35425,No,Yes,7568
New York,2020/12/16,392.3987615,9378,97,808929,35522,No,Yes,7543
New York,2020/12/17,392.3987615,10498,125,819427,35647,No,Yes,7543
New York,2020/12/18,392.3987615,12606,128,832033,35775,No,Yes,7543
New York,2020/12/19,392.3987615,9913,122,841946,35897,No,Yes,7543
New York,2020/12/20,392.3987615,9454,120,851400,36017,No,Yes,7543
New York,2020/12/21,392.3987615,9456,130,860856,36147,No,Yes,7543
New York,2020/12/22,392.3987615,10299,153,871155,36300,No,Yes,7543
New York,2020/12/23,392.3987615,11740,154,882895,36454,No,Yes,5506
New York,2020/12/24,392.3987615,13347,150,896242,36604,No,Yes,5506
New York,2020/12/25,392.3987615,12881,135,909123,36739,No,Yes,5506
New York,2020/12/26,392.3987615,11048,131,920171,36870,No,Yes,5506
New York,2020/12/27,392.3987615,8205,130,928376,37000,No,Yes,5506
New York,2020/12/28,392.3987615,10334,118,938710,37118,No,Yes,5506
New York,2020/12/29,392.3987615,12020,138,950730,37256,No,Yes,5506
New York,2020/12/30,392.3987615,12917,156,963647,37412,No,Yes,10986
New York,2020/12/31,392.3987615,15393,145,979040,37557,No,Yes,10986
New York,2021/1/1,392.3987615,17033,176,996073,37733,No,Yes,10986
New York,2021/1/2,392.3987615,15849,121,1011922,37854,No,Yes,10986
New York,2021/1/3,392.3987615,12232,147,1024154,38001,No,Yes,10986
New York,2021/1/4,392.3987615,11242,166,1035396,38167,No,Yes,10986
New York,2021/1/5,392.3987615,13142,148,1048538,38315,No,Yes,10986
New York,2021/1/6,392.3987615,16016,171,1064554,38486,No,Yes,14084
New York,2021/1/7,392.3987615,17588,197,1082142,38683,No,Yes,14084
New York,2021/1/8,392.3987615,19560,163,1101702,38846,No,Yes,14084
New York,2021/1/9,392.3987615,17839,195,1119541,39041,No,Yes,14084
New York,2021/1/10,392.3987615,16308,167,1135849,39208,No,Yes,14084
New York,2021/1/11,392.3987615,14179,196,1150028,39404,No,Yes,14084
New York,2021/1/12,392.3987615,14791,184,1164819,39588,No,Yes,14084
New York,2021/1/13,392.3987615,14704,172,1179523,39760,No,Yes,11980
New York,2021/1/14,392.3987615,14187,237,1193710,39997,No,Yes,11980
New York,2021/1/15,392.3987615,19469,206,1213179,40203,No,Yes,11980
New York,2021/1/16,392.3987615,15945,173,1229124,40376,No,Yes,11980
New York,2021/1/17,392.3987615,13694,194,1242818,40570,No,Yes,11980
New York,2021/1/18,392.3987615,13410,183,1256228,40753,No,Yes,11980
New York,2021/1/19,392.3987615,12721,180,1268949,40933,No,Yes,11980
New York,2021/1/20,392.3987615,11119,215,1280068,41148,No,Yes,11615
New York,2021/1/21,392.3987615,13908,200,1293976,41348,No,Yes,11615
New York,2021/1/22,392.3987615,15684,182,1309660,41530,No,Yes,11615
New York,2021/1/23,392.3987615,13909,164,1323569,41694,No,Yes,11615
New York,2021/1/24,392.3987615,12383,195,1335952,41889,No,Yes,11615
New York,2021/1/25,392.3987615,11972,201,1347924,42090,No,Yes,11615
New York,2021/1/26,392.3987615,11040,183,1358964,42273,No,Yes,11615
New York,2021/1/27,392.3987615,10365,161,1369329,42434,No,Yes,12664
New York,2021/1/28,392.3987615,13783,205,1383112,42639,No,Yes,12664
New York,2021/1/29,392.3987615,12951,186,1396063,42825,No,Yes,12664
New York,2021/1/30,392.3987615,12892,171,1408955,42996,No,Yes,12664
New York,2021/1/31,392.3987615,11209,182,1420164,43178,No,Yes,12664
New York,2021/2/1,392.3987615,8932,176,1429096,43354,No,Yes,12664
New York,2021/2/2,392.3987615,7949,170,1437045,43524,No,Yes,12664
New York,2021/2/3,392.3987615,7154,163,1444199,43687,No,Yes,13464
New York,2021/2/4,392.3987615,6970,155,1451169,43842,No,Yes,13464
New York,2021/2/5,392.3987615,7897,170,1459066,44012,No,Yes,13464
New York,2021/2/6,392.3987615,11492,198,1470558,44210,No,Yes,13464
New York,2021/2/7,392.3987615,9923,177,1480481,44387,No,Yes,13464
New York,2021/2/8,392.3987615,8972,125,1489453,44512,No,Yes,13464
New York,2021/2/9,392.3987615,8279,171,1497732,44683,No,Yes,13464
New York,2021/2/10,392.3987615,6584,168,1504316,44851,No,Yes,12087
New York,2021/2/11,392.3987615,10011,141,1514327,44992,No,Yes,12087
New York,2021/2/12,392.3987615,8715,146,1523042,45138,No,Yes,12087
New York,2021/2/13,392.3987615,8755,157,1531797,45295,No,Yes,12087
New York,2021/2/14,392.3987615,8330,136,1540127,45431,No,Yes,12087
New York,2021/2/15,392.3987615,6538,121,1546665,45552,No,Yes,12087
New York,2021/2/16,392.3987615,6709,131,1553374,45683,No,Yes,12087
New York,2021/2/17,392.3987615,5925,124,1559299,45807,No,Yes,11395
New York,2021/2/18,392.3987615,9582,150,1568881,45957,No,Yes,11395
New York,2021/2/19,392.3987615,8573,162,1577454,46119,No,Yes,11395
New York,2021/2/20,392.3987615,8238,114,1585692,46233,No,Yes,11395
New York,2021/2/21,392.3987615,6237,113,1591929,46346,No,Yes,11395
New York,2021/2/22,392.3987615,6297,108,1598226,46454,No,Yes,11395
New York,2021/2/23,392.3987615,6923,108,1605149,46562,No,Yes,11395
New York,2021/2/24,392.3987615,6139,118,1611288,46680,No,Yes,11395
New York,2021/2/25,392.3987615,8893,110,1620181,46790,No,Yes,11395
New York,2021/2/26,392.3987615,8074,124,1628255,46914,No,Yes,11395
New York,2021/2/27,392.3987615,8042,111,1636297,47025,No,Yes,11395
New York,2021/2/28,392.3987615,7827,118,1644124,47143,No,Yes,11395
New York,2021/3/1,392.3987615,6436,104,1650560,47247,No,Yes,11395
New York,2021/3/2,392.3987615,6381,98,1656941,47345,No,Yes,11395
New York,2021/3/3,392.3987615,6564,119,1663505,47464,No,Yes,11395
New York,2021/3/4,392.3987615,7468,101,1670973,47565,No,Yes,11395
North Carolina,2020/3/1,199.4463165,0,0,0,0,No,No,1575
North Carolina,2020/3/2,199.4463165,0,0,0,0,No,No,1575
North Carolina,2020/3/3,199.4463165,1,0,1,0,No,No,1575
North Carolina,2020/3/4,199.4463165,0,0,1,0,No,No,1663
North Carolina,2020/3/5,199.4463165,0,0,1,0,No,No,1663
North Carolina,2020/3/6,199.4463165,1,0,2,0,No,No,1663
North Carolina,2020/3/7,199.4463165,0,0,2,0,No,No,1663
North Carolina,2020/3/8,199.4463165,0,0,2,0,No,No,1663
North Carolina,2020/3/9,199.4463165,5,0,7,0,No,No,1663
North Carolina,2020/3/10,199.4463165,0,0,7,0,No,No,1663
North Carolina,2020/3/11,199.4463165,1,0,8,0,No,No,1819
North Carolina,2020/3/12,199.4463165,8,0,16,0,No,No,1819
North Carolina,2020/3/13,199.4463165,2,0,18,0,No,No,1819
North Carolina,2020/3/14,199.4463165,7,0,25,0,No,No,1819
North Carolina,2020/3/15,199.4463165,7,0,32,0,No,No,1819
North Carolina,2020/3/16,199.4463165,2,0,34,0,No,No,1819
North Carolina,2020/3/17,199.4463165,8,0,42,0,No,No,1819
North Carolina,2020/3/18,199.4463165,24,0,66,0,No,No,10892
North Carolina,2020/3/19,199.4463165,38,0,104,0,No,No,10892
North Carolina,2020/3/20,199.4463165,40,0,144,0,No,No,10892
North Carolina,2020/3/21,199.4463165,40,0,184,0,No,No,10892
North Carolina,2020/3/22,199.4463165,85,0,269,0,No,No,10892
North Carolina,2020/3/23,199.4463165,33,0,302,0,No,No,10892
North Carolina,2020/3/24,199.4463165,95,0,397,0,No,No,10892
North Carolina,2020/3/25,199.4463165,165,1,562,1,No,No,80984
North Carolina,2020/3/26,199.4463165,77,1,639,2,No,No,80984
North Carolina,2020/3/27,199.4463165,145,1,784,3,No,No,80984
North Carolina,2020/3/28,199.4463165,188,1,972,4,No,No,80984
North Carolina,2020/3/29,199.4463165,194,2,1166,6,No,No,80984
North Carolina,2020/3/30,199.4463165,137,0,1303,6,Yes,No,80984
North Carolina,2020/3/31,199.4463165,224,4,1527,10,Yes,No,80984
North Carolina,2020/4/1,199.4463165,64,1,1591,11,Yes,No,106739
North Carolina,2020/4/2,199.4463165,267,6,1858,17,Yes,No,106739
North Carolina,2020/4/3,199.4463165,235,6,2093,23,Yes,No,106739
North Carolina,2020/4/4,199.4463165,309,7,2402,30,Yes,No,106739
North Carolina,2020/4/5,199.4463165,183,7,2585,37,Yes,No,106739
North Carolina,2020/4/6,199.4463165,285,5,2870,42,Yes,No,106739
North Carolina,2020/4/7,199.4463165,350,8,3220,50,Yes,No,106739
North Carolina,2020/4/8,199.4463165,203,11,3423,61,Yes,No,77515
North Carolina,2020/4/9,199.4463165,228,13,3651,74,Yes,No,77515
North Carolina,2020/4/10,199.4463165,255,4,3906,78,Yes,No,77515
North Carolina,2020/4/11,199.4463165,404,8,4310,86,Yes,No,77515
North Carolina,2020/4/12,199.4463165,210,0,4520,86,Yes,No,77515
North Carolina,2020/4/13,199.4463165,268,5,4788,91,Yes,No,77515
North Carolina,2020/4/14,199.4463165,204,25,4992,116,Yes,No,77515
North Carolina,2020/4/15,199.4463165,131,12,5123,128,Yes,No,66432
North Carolina,2020/4/16,199.4463165,340,12,5463,140,Yes,No,66432
North Carolina,2020/4/17,199.4463165,396,19,5859,159,Yes,No,66432
North Carolina,2020/4/18,199.4463165,281,16,6140,175,Yes,No,66432
North Carolina,2020/4/19,199.4463165,353,8,6493,183,Yes,No,66432
North Carolina,2020/4/20,199.4463165,271,4,6764,187,Yes,No,66432
North Carolina,2020/4/21,199.4463165,187,30,6951,217,Yes,No,66432
North Carolina,2020/4/22,199.4463165,269,25,7220,242,Yes,No,74966
North Carolina,2020/4/23,199.4463165,388,11,7608,253,Yes,No,74966
North Carolina,2020/4/24,199.4463165,444,17,8052,270,Yes,No,74966
North Carolina,2020/4/25,199.4463165,496,34,8548,304,Yes,No,74966
North Carolina,2020/4/26,199.4463165,282,5,8830,309,Yes,No,74966
North Carolina,2020/4/27,199.4463165,205,22,9035,331,Yes,No,74966
North Carolina,2020/4/28,199.4463165,533,22,9568,353,Yes,No,74966
North Carolina,2020/4/29,199.4463165,379,13,9947,366,Yes,No,28985
North Carolina,2020/4/30,199.4463165,560,19,10507,385,Yes,No,28985
North Carolina,2020/5/1,199.4463165,415,20,10922,405,Yes,No,28985
North Carolina,2020/5/2,199.4463165,592,23,11514,428,Yes,No,28985
North Carolina,2020/5/3,199.4463165,154,8,11668,436,Yes,No,28985
North Carolina,2020/5/4,199.4463165,203,18,11871,454,Yes,No,28985
North Carolina,2020/5/5,199.4463165,412,23,12283,477,Yes,No,28985
North Carolina,2020/5/6,199.4463165,500,20,12783,497,Yes,No,26666
North Carolina,2020/5/7,199.4463165,648,24,13431,521,Yes,No,26666
North Carolina,2020/5/8,199.4463165,448,16,13879,537,Yes,No,26666
North Carolina,2020/5/9,199.4463165,508,17,14387,554,Yes,No,26666
North Carolina,2020/5/10,199.4463165,396,7,14783,561,Yes,No,26666
North Carolina,2020/5/11,199.4463165,286,10,15069,571,Yes,No,26666
North Carolina,2020/5/12,199.4463165,333,26,15402,597,Yes,No,26666
North Carolina,2020/5/13,199.4463165,448,18,15850,615,Yes,No,25150
North Carolina,2020/5/14,199.4463165,743,17,16593,632,Yes,No,25150
North Carolina,2020/5/15,199.4463165,597,28,17190,660,Yes,No,25150
North Carolina,2020/5/16,199.4463165,819,11,18009,671,Yes,No,25150
North Carolina,2020/5/17,199.4463165,528,8,18537,679,Yes,No,25150
North Carolina,2020/5/18,199.4463165,584,5,19121,684,Yes,No,25150
North Carolina,2020/5/19,199.4463165,641,27,19762,711,Yes,No,25150
North Carolina,2020/5/20,199.4463165,459,10,20221,721,Yes,No,27919
North Carolina,2020/5/21,199.4463165,713,13,20934,734,Yes,No,27919
North Carolina,2020/5/22,199.4463165,727,20,21661,754,Yes,No,27919
North Carolina,2020/5/23,199.4463165,1070,9,22731,763,No,No,27919
North Carolina,2020/5/24,199.4463165,500,8,23231,771,No,No,27919
North Carolina,2020/5/25,199.4463165,766,9,23997,780,No,No,27919
North Carolina,2020/5/26,199.4463165,191,9,24188,789,No,No,27919
North Carolina,2020/5/27,199.4463165,599,38,24787,827,No,No,21335
North Carolina,2020/5/28,199.4463165,829,32,25616,859,No,No,21335
North Carolina,2020/5/29,199.4463165,1119,29,26735,888,No,No,21335
North Carolina,2020/5/30,199.4463165,1026,15,27761,903,No,No,21335
North Carolina,2020/5/31,199.4463165,925,8,28686,911,No,No,21335
North Carolina,2020/6/1,199.4463165,682,12,29368,923,No,No,21335
North Carolina,2020/6/2,199.4463165,684,27,30052,950,No,No,21335
North Carolina,2020/6/3,199.4463165,961,21,31013,971,No,No,19949
North Carolina,2020/6/4,199.4463165,1263,22,32276,993,No,No,19949
North Carolina,2020/6/5,199.4463165,1141,8,33417,1001,No,No,19949
North Carolina,2020/6/6,199.4463165,1392,19,34809,1020,No,No,19949
North Carolina,2020/6/7,199.4463165,854,4,35663,1024,No,No,19949
North Carolina,2020/6/8,199.4463165,918,17,36581,1041,No,No,19949
North Carolina,2020/6/9,199.4463165,812,28,37393,1069,No,No,19949
North Carolina,2020/6/10,199.4463165,912,27,38305,1096,No,No,18367
North Carolina,2020/6/11,199.4463165,1430,18,39735,1114,No,No,18367
North Carolina,2020/6/12,199.4463165,1732,14,41467,1128,No,No,18367
North Carolina,2020/6/13,199.4463165,1444,7,42911,1135,No,No,18367
North Carolina,2020/6/14,199.4463165,1288,4,44199,1139,No,No,18367
North Carolina,2020/6/15,199.4463165,1058,17,45257,1156,No,No,18367
North Carolina,2020/6/16,199.4463165,848,29,46105,1185,No,No,18367
North Carolina,2020/6/17,199.4463165,1037,13,47142,1198,No,No,18671
North Carolina,2020/6/18,199.4463165,1284,11,48426,1209,No,No,18671
North Carolina,2020/6/19,199.4463165,1588,14,50014,1223,No,No,18671
North Carolina,2020/6/20,199.4463165,1626,16,51640,1239,No,No,18671
North Carolina,2020/6/21,199.4463165,1214,6,52854,1245,No,No,18671
North Carolina,2020/6/22,199.4463165,986,5,53840,1250,No,No,18671
North Carolina,2020/6/23,199.4463165,986,26,54826,1276,No,No,18671
North Carolina,2020/6/24,199.4463165,1437,19,56263,1295,No,No,18338
North Carolina,2020/6/25,199.4463165,1277,10,57540,1305,No,No,18338
North Carolina,2020/6/26,199.4463165,1717,14,59257,1319,No,Yes,18338
North Carolina,2020/6/27,199.4463165,1452,15,60709,1334,No,Yes,18338
North Carolina,2020/6/28,199.4463165,1469,4,62178,1338,No,Yes,18338
North Carolina,2020/6/29,199.4463165,1514,3,63692,1341,No,Yes,18338
North Carolina,2020/6/30,199.4463165,1372,21,65064,1362,No,Yes,18338
North Carolina,2020/7/1,199.4463165,1751,27,66815,1389,No,Yes,19056
North Carolina,2020/7/2,199.4463165,1697,13,68512,1402,No,Yes,19056
North Carolina,2020/7/3,199.4463165,1939,11,70451,1413,No,Yes,19056
North Carolina,2020/7/4,199.4463165,1284,1,71735,1414,No,Yes,19056
North Carolina,2020/7/5,199.4463165,1361,0,73096,1414,No,Yes,19056
North Carolina,2020/7/6,199.4463165,1837,10,74933,1424,No,Yes,19056
North Carolina,2020/7/7,199.4463165,1255,22,76188,1446,No,Yes,19056
North Carolina,2020/7/8,199.4463165,1473,24,77661,1470,No,Yes,20563
North Carolina,2020/7/9,199.4463165,1903,17,79564,1487,No,Yes,20563
North Carolina,2020/7/10,199.4463165,2173,16,81737,1503,No,Yes,20563
North Carolina,2020/7/11,199.4463165,2259,17,83996,1520,No,Yes,20563
North Carolina,2020/7/12,199.4463165,1835,12,85831,1532,No,Yes,20563
North Carolina,2020/7/13,199.4463165,1822,15,87653,1547,No,Yes,20563
North Carolina,2020/7/14,199.4463165,2114,35,89767,1582,No,Yes,20563
North Carolina,2020/7/15,199.4463165,1806,16,91573,1598,No,Yes,23676
North Carolina,2020/7/16,199.4463165,2084,19,93657,1617,No,Yes,23676
North Carolina,2020/7/17,199.4463165,1976,21,95633,1638,No,Yes,23676
North Carolina,2020/7/18,199.4463165,2434,15,98067,1653,No,Yes,23676
North Carolina,2020/7/19,199.4463165,1774,8,99841,1661,No,Yes,23676
North Carolina,2020/7/20,199.4463165,1335,15,101176,1676,No,Yes,23676
North Carolina,2020/7/21,199.4463165,1871,26,103047,1702,No,Yes,23676
North Carolina,2020/7/22,199.4463165,2091,27,105138,1729,No,Yes,17437
North Carolina,2020/7/23,199.4463165,1912,25,107050,1754,No,Yes,17437
North Carolina,2020/7/24,199.4463165,2156,15,109206,1769,No,Yes,17437
North Carolina,2020/7/25,199.4463165,2076,32,111282,1801,No,Yes,17437
North Carolina,2020/7/26,199.4463165,1520,6,112802,1807,No,Yes,17437
North Carolina,2020/7/27,199.4463165,1810,8,114612,1815,No,Yes,17437
North Carolina,2020/7/28,199.4463165,1688,32,116300,1847,No,Yes,17437
North Carolina,2020/7/29,199.4463165,1727,42,118027,1889,No,Yes,11690
North Carolina,2020/7/30,199.4463165,2364,40,120391,1929,No,Yes,11690
North Carolina,2020/7/31,199.4463165,1979,18,122370,1947,No,Yes,11690
North Carolina,2020/8/1,199.4463165,1645,42,124015,1989,No,Yes,11690
North Carolina,2020/8/2,199.4463165,1266,7,125281,1996,No,Yes,11690
North Carolina,2020/8/3,199.4463165,1467,17,126748,2013,No,Yes,11690
North Carolina,2020/8/4,199.4463165,1488,25,128236,2038,No,Yes,11690
North Carolina,2020/8/5,199.4463165,1218,41,129454,2079,No,Yes,9467
North Carolina,2020/8/6,199.4463165,2024,43,131478,2122,No,Yes,9467
North Carolina,2020/8/7,199.4463165,1555,38,133033,2160,No,Yes,9467
North Carolina,2020/8/8,199.4463165,1882,24,134915,2184,No,Yes,9467
North Carolina,2020/8/9,199.4463165,1335,11,136250,2195,No,Yes,9467
North Carolina,2020/8/10,199.4463165,756,3,137006,2198,No,Yes,9467
North Carolina,2020/8/11,199.4463165,1068,40,138074,2238,No,Yes,9467
North Carolina,2020/8/12,199.4463165,1339,39,139413,2277,No,Yes,11047
North Carolina,2020/8/13,199.4463165,1593,36,141006,2313,No,Yes,11047
North Carolina,2020/8/14,199.4463165,1538,31,142544,2344,No,Yes,11047
North Carolina,2020/8/15,199.4463165,1412,26,143956,2370,No,Yes,11047
North Carolina,2020/8/16,199.4463165,1155,2,145111,2372,No,Yes,11047
North Carolina,2020/8/17,199.4463165,831,12,145942,2384,No,Yes,11047
North Carolina,2020/8/18,199.4463165,1199,41,147141,2425,No,Yes,11047
North Carolina,2020/8/19,199.4463165,1350,39,148491,2464,No,Yes,8676
North Carolina,2020/8/20,199.4463165,1931,32,150422,2496,No,Yes,8676
North Carolina,2020/8/21,199.4463165,1922,26,152344,2522,No,Yes,8676
North Carolina,2020/8/22,199.4463165,1622,24,153966,2546,No,Yes,8676
North Carolina,2020/8/23,199.4463165,1424,14,155390,2560,No,Yes,8676
North Carolina,2020/8/24,199.4463165,1537,7,156927,2567,No,Yes,8676
North Carolina,2020/8/25,199.4463165,1258,40,158185,2607,No,Yes,8676
North Carolina,2020/8/26,199.4463165,1523,27,159708,2634,No,Yes,8511
North Carolina,2020/8/27,199.4463165,2007,20,161715,2654,No,Yes,8511
North Carolina,2020/8/28,199.4463165,1439,22,163154,2676,No,Yes,8511
North Carolina,2020/8/29,199.4463165,2379,32,165533,2708,No,Yes,8511
North Carolina,2020/8/30,199.4463165,977,13,166510,2721,No,Yes,8511
North Carolina,2020/8/31,199.4463165,1479,12,167989,2733,No,Yes,8511
North Carolina,2020/9/1,199.4463165,1977,36,169966,2769,No,Yes,8511
North Carolina,2020/9/2,199.4463165,1174,37,171140,2806,No,Yes,8901
North Carolina,2020/9/3,199.4463165,1651,23,172791,2829,No,Yes,8901
North Carolina,2020/9/4,199.4463165,2057,39,174848,2868,No,Yes,8901
North Carolina,2020/9/5,199.4463165,1276,45,176124,2913,No,Yes,8901
North Carolina,2020/9/6,199.4463165,1017,7,177141,2920,No,Yes,8901
North Carolina,2020/9/7,199.4463165,1071,0,178212,2920,No,Yes,8901
North Carolina,2020/9/8,199.4463165,938,22,179150,2942,No,Yes,8901
North Carolina,2020/9/9,199.4463165,911,48,180061,2990,No,Yes,8848
North Carolina,2020/9/10,199.4463165,1274,26,181335,3016,No,Yes,8848
North Carolina,2020/9/11,199.4463165,1599,34,182934,3050,No,Yes,8848
North Carolina,2020/9/12,199.4463165,1371,23,184305,3073,No,Yes,8848
North Carolina,2020/9/13,199.4463165,1020,7,185325,3080,No,Yes,8848
North Carolina,2020/9/14,199.4463165,1122,14,186447,3094,No,Yes,8848
North Carolina,2020/9/15,199.4463165,1039,41,187486,3135,No,Yes,8848
North Carolina,2020/9/16,199.4463165,1314,41,188800,3176,No,Yes,8679
North Carolina,2020/9/17,199.4463165,1507,32,190307,3208,No,Yes,8679
North Carolina,2020/9/18,199.4463165,1365,24,191672,3232,No,Yes,8679
North Carolina,2020/9/19,199.4463165,1079,28,192751,3260,No,Yes,8679
North Carolina,2020/9/20,199.4463165,1227,10,193978,3270,No,Yes,8679
North Carolina,2020/9/21,199.4463165,1115,13,195093,3283,No,Yes,8679
North Carolina,2020/9/22,199.4463165,1165,37,196258,3320,No,Yes,8679
North Carolina,2020/9/23,199.4463165,1173,25,197431,3345,No,Yes,8805
North Carolina,2020/9/24,199.4463165,1805,35,199236,3380,No,Yes,8805
North Carolina,2020/9/25,199.4463165,5422,47,204658,3427,No,Yes,8805
North Carolina,2020/9/26,199.4463165,1583,31,206241,3458,No,Yes,8805
North Carolina,2020/9/27,199.4463165,1166,2,207407,3460,No,Yes,8805
North Carolina,2020/9/28,199.4463165,1090,9,208497,3469,No,Yes,8805
North Carolina,2020/9/29,199.4463165,887,42,209384,3511,No,Yes,8805
North Carolina,2020/9/30,199.4463165,1620,54,211004,3565,No,Yes,7732
North Carolina,2020/10/1,199.4463165,2214,36,213218,3601,No,Yes,7732
North Carolina,2020/10/2,199.4463165,1817,27,215035,3628,No,Yes,7732
North Carolina,2020/10/3,199.4463165,2014,19,217049,3647,No,No,7732
North Carolina,2020/10/4,199.4463165,592,6,217641,3653,No,No,7732
North Carolina,2020/10/5,199.4463165,2404,3,220045,3656,No,No,7732
North Carolina,2020/10/6,199.4463165,1393,35,221438,3691,No,No,7732
North Carolina,2020/10/7,199.4463165,1911,25,223349,3716,No,No,8581
North Carolina,2020/10/8,199.4463165,2389,28,225738,3744,No,No,8581
North Carolina,2020/10/9,199.4463165,2018,24,227756,3768,No,No,8581
North Carolina,2020/10/10,199.4463165,2203,18,229959,3786,No,No,8581
North Carolina,2020/10/11,199.4463165,1605,5,231564,3791,No,No,8581
North Carolina,2020/10/12,199.4463165,1495,8,233059,3799,No,No,8581
North Carolina,2020/10/13,199.4463165,1783,50,234842,3849,No,No,8581
North Carolina,2020/10/14,199.4463165,1970,33,236812,3882,No,No,7964
North Carolina,2020/10/15,199.4463165,2526,17,239338,3899,No,No,7964
North Carolina,2020/10/16,199.4463165,2694,39,242032,3938,No,No,7964
North Carolina,2020/10/17,199.4463165,1988,17,244020,3955,No,No,7964
North Carolina,2020/10/18,199.4463165,2096,6,246116,3961,No,No,7964
North Carolina,2020/10/19,199.4463165,1435,8,247551,3969,No,No,7964
North Carolina,2020/10/20,199.4463165,1607,49,249158,4018,No,No,7964
North Carolina,2020/10/21,199.4463165,1852,45,251010,4063,No,No,7126
North Carolina,2020/10/22,199.4463165,2408,47,253418,4110,No,No,7126
North Carolina,2020/10/23,199.4463165,2116,30,255534,4140,No,No,7126
North Carolina,2020/10/24,199.4463165,2905,30,258439,4170,No,No,7126
North Carolina,2020/10/25,199.4463165,1689,13,260128,4183,No,No,7126
North Carolina,2020/10/26,199.4463165,2031,17,262159,4200,No,No,7126
North Carolina,2020/10/27,199.4463165,2175,36,264334,4236,No,No,7126
North Carolina,2020/10/28,199.4463165,2232,39,266566,4275,No,No,7060
North Carolina,2020/10/29,199.4463165,2853,32,269419,4307,No,No,7060
North Carolina,2020/10/30,199.4463165,2812,47,272231,4354,No,No,7060
North Carolina,2020/10/31,199.4463165,2574,46,274805,4400,No,No,7060
North Carolina,2020/11/1,199.4463165,1901,5,276706,4405,No,No,7060
North Carolina,2020/11/2,199.4463165,1771,8,278477,4413,No,No,7060
North Carolina,2020/11/3,199.4463165,2180,68,280657,4481,No,No,7060
North Carolina,2020/11/4,199.4463165,2623,54,283280,4535,No,No,8764
North Carolina,2020/11/5,199.4463165,2930,37,286210,4572,No,No,8764
North Carolina,2020/11/6,199.4463165,2914,36,289124,4608,No,No,8764
North Carolina,2020/11/7,199.4463165,2439,21,291563,4629,No,No,8764
North Carolina,2020/11/8,199.4463165,1868,1,293431,4630,No,No,8764
North Carolina,2020/11/9,199.4463165,1674,8,295105,4638,No,No,8764
North Carolina,2020/11/10,199.4463165,2984,47,298089,4685,No,No,8764
North Carolina,2020/11/11,199.4463165,2636,38,300725,4723,No,No,9262
North Carolina,2020/11/12,199.4463165,3206,7,303931,4730,No,No,9262
North Carolina,2020/11/13,199.4463165,2567,19,306498,4749,No,No,9262
North Carolina,2020/11/14,199.4463165,3205,34,309703,4783,No,No,9262
North Carolina,2020/11/15,199.4463165,2703,47,312406,4830,No,No,9262
North Carolina,2020/11/16,199.4463165,2908,13,315314,4843,No,No,9262
North Carolina,2020/11/17,199.4463165,3223,38,318537,4881,No,No,9262
North Carolina,2020/11/18,199.4463165,3721,46,322258,4927,No,No,11813
North Carolina,2020/11/19,199.4463165,3400,41,325658,4968,No,No,11813
North Carolina,2020/11/20,199.4463165,4363,44,330021,5012,No,No,11813
North Carolina,2020/11/21,199.4463165,3053,23,333074,5035,No,No,11813
North Carolina,2020/11/22,199.4463165,3909,27,336983,5062,No,No,11813
North Carolina,2020/11/23,199.4463165,2689,14,339672,5076,No,No,11813
North Carolina,2020/11/24,199.4463165,3894,38,343566,5114,No,No,11813
North Carolina,2020/11/25,199.4463165,4536,63,348102,5177,No,No,7061
North Carolina,2020/11/26,199.4463165,46,0,348148,5177,No,No,7061
North Carolina,2020/11/27,199.4463165,7516,63,355664,5240,No,No,7061
North Carolina,2020/11/28,199.4463165,2990,9,358654,5249,No,No,7061
North Carolina,2020/11/29,199.4463165,3470,30,362124,5279,No,No,7061
North Carolina,2020/11/30,199.4463165,2844,17,364968,5296,No,No,7061
North Carolina,2020/12/1,199.4463165,3647,26,368615,5322,No,No,7061
North Carolina,2020/12/2,199.4463165,3910,84,372525,5406,No,No,7656
North Carolina,2020/12/3,199.4463165,5845,48,378370,5454,No,No,7656
North Carolina,2020/12/4,199.4463165,5795,51,384165,5505,No,No,7656
North Carolina,2020/12/5,199.4463165,4595,42,388760,5547,No,No,7656
North Carolina,2020/12/6,199.4463165,6260,31,395020,5578,No,No,7656
North Carolina,2020/12/7,199.4463165,4776,20,399796,5598,No,No,7656
North Carolina,2020/12/8,199.4463165,4724,44,404520,5642,No,No,7656
North Carolina,2020/12/9,199.4463165,7620,62,412140,5704,No,No,7568
North Carolina,2020/12/10,199.4463165,5811,48,417951,5752,No,No,7568
North Carolina,2020/12/11,199.4463165,7040,39,424991,5791,No,No,7568
North Carolina,2020/12/12,199.4463165,5334,40,430325,5831,No,No,7568
North Carolina,2020/12/13,199.4463165,6330,24,436655,5855,No,No,7568
North Carolina,2020/12/14,199.4463165,5066,44,441721,5899,No,No,7568
North Carolina,2020/12/15,199.4463165,5582,27,447303,5926,No,No,7568
North Carolina,2020/12/16,199.4463165,6325,104,453628,6030,No,No,7543
North Carolina,2020/12/17,199.4463165,5111,90,458739,6120,No,No,7543
North Carolina,2020/12/18,199.4463165,9456,52,468195,6172,No,No,7543
North Carolina,2020/12/19,199.4463165,5496,50,473691,6222,No,No,7543
North Carolina,2020/12/20,199.4463165,6184,37,479875,6259,No,No,7543
North Carolina,2020/12/21,199.4463165,4638,26,484513,6285,No,No,7543
North Carolina,2020/12/22,199.4463165,6729,57,491242,6342,No,No,7543
North Carolina,2020/12/23,199.4463165,6627,76,497869,6418,No,No,5506
North Carolina,2020/12/24,199.4463165,136,2,498005,6420,No,No,5506
North Carolina,2020/12/25,199.4463165,0,0,498005,6420,No,No,5506
North Carolina,2020/12/26,199.4463165,16719,154,514724,6574,No,No,5506
North Carolina,2020/12/27,199.4463165,2725,18,517449,6592,No,No,5506
North Carolina,2020/12/28,199.4463165,4541,9,521990,6601,No,No,5506
North Carolina,2020/12/29,199.4463165,4449,29,526439,6630,No,No,5506
North Carolina,2020/12/30,199.4463165,8681,150,535120,6780,No,No,10986
North Carolina,2020/12/31,199.4463165,5950,31,541070,6811,No,No,10986
North Carolina,2021/1/1,199.4463165,2906,8,543976,6819,No,No,10986
North Carolina,2021/1/2,199.4463165,15966,114,559942,6933,No,No,10986
North Carolina,2021/1/3,199.4463165,5318,30,565260,6963,No,No,10986
North Carolina,2021/1/4,199.4463165,6758,37,572018,7000,No,No,10986
North Carolina,2021/1/5,199.4463165,6291,80,578309,7080,No,No,10986
North Carolina,2021/1/6,199.4463165,6385,69,584694,7149,No,No,14084
North Carolina,2021/1/7,199.4463165,10614,113,595308,7262,No,No,14084
North Carolina,2021/1/8,199.4463165,9879,121,605187,7383,No,No,14084
North Carolina,2021/1/9,199.4463165,9528,85,614715,7468,No,No,14084
North Carolina,2021/1/10,199.4463165,8788,141,623503,7609,No,No,14084
North Carolina,2021/1/11,199.4463165,9491,26,632994,7635,No,No,14084
North Carolina,2021/1/12,199.4463165,5336,52,638330,7687,No,No,14084
North Carolina,2021/1/13,199.4463165,5190,109,643520,7796,No,No,11980
North Carolina,2021/1/14,199.4463165,8013,92,651533,7888,No,No,11980
North Carolina,2021/1/15,199.4463165,9973,108,661506,7996,No,No,11980
North Carolina,2021/1/16,199.4463165,7778,64,669284,8060,No,No,11980
North Carolina,2021/1/17,199.4463165,5988,65,675272,8125,No,No,11980
North Carolina,2021/1/18,199.4463165,1043,6,676315,8131,No,No,11980
North Carolina,2021/1/19,199.4463165,8182,65,684497,8196,No,No,11980
North Carolina,2021/1/20,199.4463165,9198,71,693695,8267,No,No,11615
North Carolina,2021/1/21,199.4463165,5639,130,699334,8397,No,No,11615
North Carolina,2021/1/22,199.4463165,9597,114,708931,8511,No,No,11615
North Carolina,2021/1/23,199.4463165,6352,112,715283,8623,No,No,11615
North Carolina,2021/1/24,199.4463165,5297,116,720580,8739,No,No,11615
North Carolina,2021/1/25,199.4463165,4596,38,725176,8777,No,No,11615
North Carolina,2021/1/26,199.4463165,5531,62,730707,8839,No,No,11615
North Carolina,2021/1/27,199.4463165,4835,120,735542,8959,No,No,12664
North Carolina,2021/1/28,199.4463165,6041,140,741583,9099,No,No,12664
North Carolina,2021/1/29,199.4463165,7908,114,749491,9213,No,No,12664
North Carolina,2021/1/30,199.4463165,626,2,750117,9215,No,No,12664
North Carolina,2021/1/31,199.4463165,9838,166,759955,9381,No,No,12664
North Carolina,2021/2/1,199.4463165,3403,16,763358,9397,No,No,12664
North Carolina,2021/2/2,199.4463165,5676,80,769034,9477,No,No,12664
North Carolina,2021/2/3,199.4463165,10693,148,779727,9625,No,No,13464
North Carolina,2021/2/4,199.4463165,6755,142,786482,9767,No,No,13464
North Carolina,2021/2/5,199.4463165,4975,113,791457,9880,No,No,13464
North Carolina,2021/2/6,199.4463165,4102,82,795559,9962,No,No,13464
North Carolina,2021/2/7,199.4463165,4368,55,799927,10017,No,No,13464
North Carolina,2021/2/8,199.4463165,2893,13,802820,10030,No,No,13464
North Carolina,2021/2/9,199.4463165,4152,58,806972,10088,No,No,13464
North Carolina,2021/2/10,199.4463165,3623,138,810595,10226,No,No,12087
North Carolina,2021/2/11,199.4463165,4587,110,815182,10336,No,No,12087
North Carolina,2021/2/12,199.4463165,4060,72,819242,10408,No,No,12087
North Carolina,2021/2/13,199.4463165,3539,74,822781,10482,No,No,12087
North Carolina,2021/2/14,199.4463165,2791,42,825572,10524,No,No,12087
North Carolina,2021/2/15,199.4463165,3199,21,828771,10545,No,No,12087
North Carolina,2021/2/16,199.4463165,2338,66,831109,10611,No,No,12087
North Carolina,2021/2/17,199.4463165,2947,101,834056,10712,No,No,11395
North Carolina,2021/2/18,199.4463165,4041,92,838097,10804,No,No,11395
North Carolina,2021/2/19,199.4463165,3234,59,841331,10863,No,No,11395
North Carolina,2021/2/20,199.4463165,3189,67,844520,10930,No,No,11395
North Carolina,2021/2/21,199.4463165,2080,27,846600,10957,No,No,11395
North Carolina,2021/2/22,199.4463165,2725,19,849325,10976,No,No,11395
North Carolina,2021/2/23,199.4463165,1592,31,850917,11007,No,No,11395
North Carolina,2021/2/24,199.4463165,3254,93,854171,11100,No,No,11395
North Carolina,2021/2/25,199.4463165,3386,62,857557,11162,No,No,11395
North Carolina,2021/2/26,199.4463165,2754,54,860311,11216,No,No,11395
North Carolina,2021/2/27,199.4463165,2324,24,862635,11240,No,No,11395
North Carolina,2021/2/28,199.4463165,0,1,862635,11241,No,No,11395
North Carolina,2021/3/1,199.4463165,3353,45,865988,11286,No,No,11395
North Carolina,2021/3/2,199.4463165,1878,34,867866,11320,No,No,11395
North Carolina,2021/3/3,199.4463165,2133,69,869999,11389,No,No,11395
North Carolina,2021/3/4,199.4463165,2679,45,872678,11434,No,No,11395
North Dakota,2020/3/1,10.78415057,0,0,0,0,No,No,1575
North Dakota,2020/3/2,10.78415057,0,0,0,0,No,No,1575
North Dakota,2020/3/3,10.78415057,0,0,0,0,No,No,1575
North Dakota,2020/3/4,10.78415057,0,0,0,0,No,No,1663
North Dakota,2020/3/5,10.78415057,0,0,0,0,No,No,1663
North Dakota,2020/3/6,10.78415057,0,0,0,0,No,No,1663
North Dakota,2020/3/7,10.78415057,0,0,0,0,No,No,1663
North Dakota,2020/3/8,10.78415057,0,0,0,0,No,No,1663
North Dakota,2020/3/9,10.78415057,0,0,0,0,No,No,1663
North Dakota,2020/3/10,10.78415057,0,0,0,0,No,No,1663
North Dakota,2020/3/11,10.78415057,1,0,1,0,No,No,1819
North Dakota,2020/3/12,10.78415057,0,0,1,0,No,No,1819
North Dakota,2020/3/13,10.78415057,0,0,1,0,No,No,1819
North Dakota,2020/3/14,10.78415057,0,0,1,0,No,No,1819
North Dakota,2020/3/15,10.78415057,0,0,1,0,No,No,1819
North Dakota,2020/3/16,10.78415057,0,0,1,0,No,No,1819
North Dakota,2020/3/17,10.78415057,4,0,5,0,No,No,1819
North Dakota,2020/3/18,10.78415057,2,0,7,0,No,No,10892
North Dakota,2020/3/19,10.78415057,12,0,19,0,No,No,10892
North Dakota,2020/3/20,10.78415057,8,0,27,0,No,No,10892
North Dakota,2020/3/21,10.78415057,1,0,28,0,No,No,10892
North Dakota,2020/3/22,10.78415057,2,0,30,0,No,No,10892
North Dakota,2020/3/23,10.78415057,2,0,32,0,No,No,10892
North Dakota,2020/3/24,10.78415057,5,0,37,0,No,No,10892
North Dakota,2020/3/25,10.78415057,8,0,45,0,No,No,80984
North Dakota,2020/3/26,10.78415057,13,0,58,0,No,No,80984
North Dakota,2020/3/27,10.78415057,10,1,68,1,No,No,80984
North Dakota,2020/3/28,10.78415057,25,0,93,1,No,No,80984
North Dakota,2020/3/29,10.78415057,4,0,97,1,No,No,80984
North Dakota,2020/3/30,10.78415057,12,2,109,3,No,No,80984
North Dakota,2020/3/31,10.78415057,17,0,126,3,No,No,80984
North Dakota,2020/4/1,10.78415057,21,0,147,3,No,No,106739
North Dakota,2020/4/2,10.78415057,12,0,159,3,No,No,106739
North Dakota,2020/4/3,10.78415057,14,0,173,3,No,No,106739
North Dakota,2020/4/4,10.78415057,13,0,186,3,No,No,106739
North Dakota,2020/4/5,10.78415057,21,0,207,3,No,No,106739
North Dakota,2020/4/6,10.78415057,18,0,225,3,No,No,106739
North Dakota,2020/4/7,10.78415057,12,1,237,4,No,No,106739
North Dakota,2020/4/8,10.78415057,14,0,251,4,No,No,77515
North Dakota,2020/4/9,10.78415057,18,1,269,5,No,No,77515
North Dakota,2020/4/10,10.78415057,9,2,278,7,No,No,77515
North Dakota,2020/4/11,10.78415057,15,0,293,7,No,No,77515
North Dakota,2020/4/12,10.78415057,15,1,308,8,No,No,77515
North Dakota,2020/4/13,10.78415057,23,1,331,9,No,No,77515
North Dakota,2020/4/14,10.78415057,10,0,341,9,No,No,77515
North Dakota,2020/4/15,10.78415057,24,0,365,9,No,No,66432
North Dakota,2020/4/16,10.78415057,28,0,393,9,No,No,66432
North Dakota,2020/4/17,10.78415057,46,0,439,9,No,No,66432
North Dakota,2020/4/18,10.78415057,89,0,528,9,No,No,66432
North Dakota,2020/4/19,10.78415057,57,1,585,10,No,No,66432
North Dakota,2020/4/20,10.78415057,42,3,627,13,No,No,66432
North Dakota,2020/4/21,10.78415057,17,0,644,13,No,No,66432
North Dakota,2020/4/22,10.78415057,35,1,679,14,No,No,74966
North Dakota,2020/4/23,10.78415057,30,1,709,15,No,No,74966
North Dakota,2020/4/24,10.78415057,39,0,748,15,No,No,74966
North Dakota,2020/4/25,10.78415057,55,1,803,16,No,No,74966
North Dakota,2020/4/26,10.78415057,64,1,867,17,No,No,74966
North Dakota,2020/4/27,10.78415057,75,2,942,19,No,No,74966
North Dakota,2020/4/28,10.78415057,49,0,991,19,No,No,74966
North Dakota,2020/4/29,10.78415057,42,0,1033,19,No,No,28985
North Dakota,2020/4/30,10.78415057,34,0,1067,19,No,No,28985
North Dakota,2020/5/1,10.78415057,40,4,1107,23,No,No,28985
North Dakota,2020/5/2,10.78415057,46,1,1153,24,No,No,28985
North Dakota,2020/5/3,10.78415057,38,1,1191,25,No,No,28985
North Dakota,2020/5/4,10.78415057,34,0,1225,25,No,No,28985
North Dakota,2020/5/5,10.78415057,41,0,1266,25,No,No,28985
North Dakota,2020/5/6,10.78415057,57,6,1323,31,No,No,26666
North Dakota,2020/5/7,10.78415057,48,0,1371,31,No,No,26666
North Dakota,2020/5/8,10.78415057,54,2,1425,33,No,No,26666
North Dakota,2020/5/9,10.78415057,39,2,1464,35,No,No,26666
North Dakota,2020/5/10,10.78415057,27,0,1491,35,No,No,26666
North Dakota,2020/5/11,10.78415057,27,1,1518,36,No,No,26666
North Dakota,2020/5/12,10.78415057,53,2,1571,38,No,No,26666
North Dakota,2020/5/13,10.78415057,76,2,1647,40,No,No,25150
North Dakota,2020/5/14,10.78415057,65,0,1712,40,No,No,25150
North Dakota,2020/5/15,10.78415057,49,2,1761,42,No,No,25150
North Dakota,2020/5/16,10.78415057,87,0,1848,42,No,No,25150
North Dakota,2020/5/17,10.78415057,52,1,1900,43,No,No,25150
North Dakota,2020/5/18,10.78415057,31,1,1931,44,No,No,25150
North Dakota,2020/5/19,10.78415057,63,1,1994,45,No,No,25150
North Dakota,2020/5/20,10.78415057,101,4,2095,49,No,No,27919
North Dakota,2020/5/21,10.78415057,134,2,2229,51,No,No,27919
North Dakota,2020/5/22,10.78415057,88,1,2317,52,No,No,27919
North Dakota,2020/5/23,10.78415057,48,0,2365,52,No,No,27919
North Dakota,2020/5/24,10.78415057,53,1,2418,53,No,No,27919
North Dakota,2020/5/25,10.78415057,39,1,2457,54,No,No,27919
North Dakota,2020/5/26,10.78415057,-35,0,2422,54,No,No,27919
North Dakota,2020/5/27,10.78415057,20,5,2442,59,No,No,21335
North Dakota,2020/5/28,10.78415057,42,1,2484,60,No,No,21335
North Dakota,2020/5/29,10.78415057,39,2,2523,62,No,No,21335
North Dakota,2020/5/30,10.78415057,34,1,2557,63,No,No,21335
North Dakota,2020/5/31,10.78415057,23,1,2580,64,No,No,21335
North Dakota,2020/6/1,10.78415057,48,0,2628,64,No,No,21335
North Dakota,2020/6/2,10.78415057,21,4,2649,68,No,No,21335
North Dakota,2020/6/3,10.78415057,33,1,2682,69,No,No,19949
North Dakota,2020/6/4,10.78415057,27,0,2709,69,No,No,19949
North Dakota,2020/6/5,10.78415057,39,5,2748,74,No,No,19949
North Dakota,2020/6/6,10.78415057,71,1,2819,75,No,No,19949
North Dakota,2020/6/7,10.78415057,45,0,2864,75,No,No,19949
North Dakota,2020/6/8,10.78415057,19,0,2883,75,No,No,19949
North Dakota,2020/6/9,10.78415057,21,0,2904,75,No,No,19949
North Dakota,2020/6/10,10.78415057,40,1,2944,76,No,No,18367
North Dakota,2020/6/11,10.78415057,39,1,2983,77,No,No,18367
North Dakota,2020/6/12,10.78415057,36,0,3019,77,No,No,18367
North Dakota,2020/6/13,10.78415057,42,0,3061,77,No,No,18367
North Dakota,2020/6/14,10.78415057,22,0,3083,77,No,No,18367
North Dakota,2020/6/15,10.78415057,21,0,3104,77,No,No,18367
North Dakota,2020/6/16,10.78415057,23,0,3127,77,No,No,18367
North Dakota,2020/6/17,10.78415057,43,1,3170,78,No,No,18671
North Dakota,2020/6/18,10.78415057,29,3,3199,81,No,No,18671
North Dakota,2020/6/19,10.78415057,33,1,3232,82,No,No,18671
North Dakota,2020/6/20,10.78415057,25,0,3257,82,No,No,18671
North Dakota,2020/6/21,10.78415057,37,1,3294,83,No,No,18671
North Dakota,2020/6/22,10.78415057,25,0,3319,83,No,No,18671
North Dakota,2020/6/23,10.78415057,7,1,3326,84,No,No,18671
North Dakota,2020/6/24,10.78415057,44,2,3370,86,No,No,18338
North Dakota,2020/6/25,10.78415057,32,1,3402,87,No,No,18338
North Dakota,2020/6/26,10.78415057,28,0,3430,87,No,No,18338
North Dakota,2020/6/27,10.78415057,37,0,3467,87,No,No,18338
North Dakota,2020/6/28,10.78415057,37,1,3504,88,No,No,18338
North Dakota,2020/6/29,10.78415057,44,0,3548,88,No,No,18338
North Dakota,2020/6/30,10.78415057,37,0,3585,88,No,No,18338
North Dakota,2020/7/1,10.78415057,39,1,3624,89,No,No,19056
North Dakota,2020/7/2,10.78415057,42,0,3666,89,No,No,19056
North Dakota,2020/7/3,10.78415057,65,0,3731,89,No,No,19056
North Dakota,2020/7/4,10.78415057,57,0,3788,89,No,No,19056
North Dakota,2020/7/5,10.78415057,37,0,3825,89,No,No,19056
North Dakota,2020/7/6,10.78415057,33,0,3858,89,No,No,19056
North Dakota,2020/7/7,10.78415057,45,0,3903,89,No,No,19056
North Dakota,2020/7/8,10.78415057,72,0,3975,89,No,No,20563
North Dakota,2020/7/9,10.78415057,99,0,4074,89,No,No,20563
North Dakota,2020/7/10,10.78415057,84,0,4158,89,No,No,20563
North Dakota,2020/7/11,10.78415057,89,2,4247,91,No,No,20563
North Dakota,2020/7/12,10.78415057,91,0,4338,91,No,No,20563
North Dakota,2020/7/13,10.78415057,108,0,4446,91,No,No,20563
North Dakota,2020/7/14,10.78415057,51,1,4497,92,No,No,20563
North Dakota,2020/7/15,10.78415057,72,0,4569,92,No,No,23676
North Dakota,2020/7/16,10.78415057,103,1,4672,93,No,No,23676
North Dakota,2020/7/17,10.78415057,124,1,4796,94,No,No,23676
North Dakota,2020/7/18,10.78415057,115,0,4911,94,No,No,23676
North Dakota,2020/7/19,10.78415057,112,2,5023,96,No,No,23676
North Dakota,2020/7/20,10.78415057,107,1,5130,97,No,No,23676
North Dakota,2020/7/21,10.78415057,81,1,5211,98,No,No,23676
North Dakota,2020/7/22,10.78415057,160,2,5371,100,No,No,17437
North Dakota,2020/7/23,10.78415057,126,1,5497,101,No,No,17437
North Dakota,2020/7/24,10.78415057,121,2,5618,103,No,No,17437
North Dakota,2020/7/25,10.78415057,122,0,5740,103,No,No,17437
North Dakota,2020/7/26,10.78415057,140,0,5880,103,No,No,17437
North Dakota,2020/7/27,10.78415057,110,0,5990,103,No,No,17437
North Dakota,2020/7/28,10.78415057,155,1,6145,104,No,No,17437
North Dakota,2020/7/29,10.78415057,86,2,6231,106,No,No,11690
North Dakota,2020/7/30,10.78415057,74,1,6305,107,No,No,11690
North Dakota,2020/7/31,10.78415057,168,0,6473,107,No,No,11690
North Dakota,2020/8/1,10.78415057,133,0,6606,107,No,No,11690
North Dakota,2020/8/2,10.78415057,58,2,6664,109,No,No,11690
North Dakota,2020/8/3,10.78415057,125,0,6789,109,No,No,11690
North Dakota,2020/8/4,10.78415057,148,2,6937,111,No,No,11690
North Dakota,2020/8/5,10.78415057,124,1,7061,112,No,No,9467
North Dakota,2020/8/6,10.78415057,120,1,7181,113,No,No,9467
North Dakota,2020/8/7,10.78415057,150,1,7331,114,No,No,9467
North Dakota,2020/8/8,10.78415057,181,2,7512,116,No,No,9467
North Dakota,2020/8/9,10.78415057,88,0,7600,116,No,No,9467
North Dakota,2020/8/10,10.78415057,117,1,7717,117,No,No,9467
North Dakota,2020/8/11,10.78415057,172,5,7889,122,No,No,9467
North Dakota,2020/8/12,10.78415057,85,2,7974,124,No,No,11047
North Dakota,2020/8/13,10.78415057,201,0,8175,124,No,No,11047
North Dakota,2020/8/14,10.78415057,151,1,8326,125,No,No,11047
North Dakota,2020/8/15,10.78415057,122,0,8448,125,No,No,11047
North Dakota,2020/8/16,10.78415057,143,4,8591,129,No,No,11047
North Dakota,2020/8/17,10.78415057,60,1,8651,130,No,No,11047
North Dakota,2020/8/18,10.78415057,135,2,8786,132,No,No,11047
North Dakota,2020/8/19,10.78415057,186,2,8972,134,No,No,8676
North Dakota,2020/8/20,10.78415057,274,0,9246,134,No,No,8676
North Dakota,2020/8/21,10.78415057,232,2,9478,136,No,No,8676
North Dakota,2020/8/22,10.78415057,262,3,9740,139,No,No,8676
North Dakota,2020/8/23,10.78415057,140,1,9880,140,No,No,8676
North Dakota,2020/8/24,10.78415057,124,1,10004,141,No,No,8676
North Dakota,2020/8/25,10.78415057,229,1,10233,142,No,No,8676
North Dakota,2020/8/26,10.78415057,238,0,10471,142,No,No,8511
North Dakota,2020/8/27,10.78415057,333,1,10804,143,No,No,8511
North Dakota,2020/8/28,10.78415057,310,0,11114,143,No,No,8511
North Dakota,2020/8/29,10.78415057,374,2,11488,145,No,No,8511
North Dakota,2020/8/30,10.78415057,218,1,11706,146,No,No,8511
North Dakota,2020/8/31,10.78415057,114,1,11820,147,No,No,8511
North Dakota,2020/9/1,10.78415057,184,2,12004,149,No,No,8511
North Dakota,2020/9/2,10.78415057,267,3,12271,152,No,No,8901
North Dakota,2020/9/3,10.78415057,362,2,12633,154,No,No,8901
North Dakota,2020/9/4,10.78415057,344,0,12977,154,No,No,8901
North Dakota,2020/9/5,10.78415057,361,5,13338,159,No,No,8901
North Dakota,2020/9/6,10.78415057,297,1,13635,160,No,No,8901
North Dakota,2020/9/7,10.78415057,170,0,13805,160,No,No,8901
North Dakota,2020/9/8,10.78415057,71,0,13876,160,No,No,8901
North Dakota,2020/9/9,10.78415057,238,1,14114,161,No,No,8848
North Dakota,2020/9/10,10.78415057,332,2,14446,163,No,No,8848
North Dakota,2020/9/11,10.78415057,241,4,14687,167,No,No,8848
North Dakota,2020/9/12,10.78415057,467,3,15154,170,No,No,8848
North Dakota,2020/9/13,10.78415057,426,1,15580,171,No,No,8848
North Dakota,2020/9/14,10.78415057,254,2,15834,173,No,No,8848
North Dakota,2020/9/15,10.78415057,233,2,16067,175,No,No,8848
North Dakota,2020/9/16,10.78415057,269,5,16336,180,No,No,8679
North Dakota,2020/9/17,10.78415057,390,5,16726,185,No,No,8679
North Dakota,2020/9/18,10.78415057,507,2,17233,187,No,No,8679
North Dakota,2020/9/19,10.78415057,377,8,17610,195,No,No,8679
North Dakota,2020/9/20,10.78415057,351,0,17961,195,No,No,8679
North Dakota,2020/9/21,10.78415057,286,1,18247,196,No,No,8679
North Dakota,2020/9/22,10.78415057,264,3,18511,199,No,No,8679
North Dakota,2020/9/23,10.78415057,473,7,18984,206,No,No,8805
North Dakota,2020/9/24,10.78415057,470,9,19454,215,No,No,8805
North Dakota,2020/9/25,10.78415057,434,7,19888,222,No,No,8805
North Dakota,2020/9/26,10.78415057,495,8,20383,230,No,No,8805
North Dakota,2020/9/27,10.78415057,344,4,20727,234,No,No,8805
North Dakota,2020/9/28,10.78415057,259,3,20986,237,No,No,8805
North Dakota,2020/9/29,10.78415057,418,5,21404,242,No,No,8805
North Dakota,2020/9/30,10.78415057,445,8,21849,250,No,No,7732
North Dakota,2020/10/1,10.78415057,372,9,22221,259,No,No,7732
North Dakota,2020/10/2,10.78415057,476,8,22697,267,No,No,7732
North Dakota,2020/10/3,10.78415057,440,7,23137,274,No,No,7732
North Dakota,2020/10/4,10.78415057,416,3,23553,277,No,No,7732
North Dakota,2020/10/5,10.78415057,312,3,23865,280,No,No,7732
North Dakota,2020/10/6,10.78415057,503,4,24368,284,No,No,7732
North Dakota,2020/10/7,10.78415057,493,24,24861,308,No,No,8581
North Dakota,2020/10/8,10.78415057,527,6,25388,314,No,No,8581
North Dakota,2020/10/9,10.78415057,656,11,26044,325,No,No,8581
North Dakota,2020/10/10,10.78415057,588,15,26632,340,No,No,8581
North Dakota,2020/10/11,10.78415057,637,3,27269,343,No,No,8581
North Dakota,2020/10/12,10.78415057,473,7,27742,350,No,No,8581
North Dakota,2020/10/13,10.78415057,508,12,28250,362,No,No,8581
North Dakota,2020/10/14,10.78415057,702,8,28952,370,No,No,7964
North Dakota,2020/10/15,10.78415057,706,5,29658,375,No,No,7964
North Dakota,2020/10/16,10.78415057,864,18,30522,393,No,No,7964
North Dakota,2020/10/17,10.78415057,744,11,31266,404,No,No,7964
North Dakota,2020/10/18,10.78415057,717,5,31983,409,No,No,7964
North Dakota,2020/10/19,10.78415057,659,4,32642,413,No,No,7964
North Dakota,2020/10/20,10.78415057,1029,4,33671,417,No,No,7964
North Dakota,2020/10/21,10.78415057,499,10,34170,427,No,No,7126
North Dakota,2020/10/22,10.78415057,887,9,35057,436,No,No,7126
North Dakota,2020/10/23,10.78415057,887,9,35944,445,No,No,7126
North Dakota,2020/10/24,10.78415057,935,8,36879,453,No,No,7126
North Dakota,2020/10/25,10.78415057,845,8,37724,461,No,No,7126
North Dakota,2020/10/26,10.78415057,522,5,38246,466,No,No,7126
North Dakota,2020/10/27,10.78415057,889,15,39135,481,No,No,7126
North Dakota,2020/10/28,10.78415057,777,12,39912,493,No,No,7060
North Dakota,2020/10/29,10.78415057,1223,11,41135,504,No,No,7060
North Dakota,2020/10/30,10.78415057,1353,13,42488,517,No,No,7060
North Dakota,2020/10/31,10.78415057,1433,12,43921,529,No,No,7060
North Dakota,2020/11/1,10.78415057,1127,7,45048,536,No,No,7060
North Dakota,2020/11/2,10.78415057,972,9,46020,545,No,No,7060
North Dakota,2020/11/3,10.78415057,1172,16,47192,561,No,No,7060
North Dakota,2020/11/4,10.78415057,1114,12,48306,573,No,No,8764
North Dakota,2020/11/5,10.78415057,1536,28,49842,601,No,No,8764
North Dakota,2020/11/6,10.78415057,1765,17,51607,618,No,No,8764
North Dakota,2020/11/7,10.78415057,1602,15,53209,633,No,No,8764
North Dakota,2020/11/8,10.78415057,1101,11,54310,644,No,No,8764
North Dakota,2020/11/9,10.78415057,1153,5,55463,649,No,No,8764
North Dakota,2020/11/10,10.78415057,894,30,56357,679,No,No,8764
North Dakota,2020/11/11,10.78415057,1021,12,57378,691,No,No,9262
North Dakota,2020/11/12,10.78415057,1801,12,59179,703,No,No,9262
North Dakota,2020/11/13,10.78415057,1429,10,60608,713,No,No,9262
North Dakota,2020/11/14,10.78415057,2270,19,62878,732,No,No,9262
North Dakota,2020/11/15,10.78415057,924,10,63802,742,No,No,9262
North Dakota,2020/11/16,10.78415057,1089,7,64891,749,No,No,9262
North Dakota,2020/11/17,10.78415057,1082,26,65973,775,No,No,9262
North Dakota,2020/11/18,10.78415057,1263,16,67236,791,No,No,11813
North Dakota,2020/11/19,10.78415057,1382,10,68618,801,No,No,11813
North Dakota,2020/11/20,10.78415057,1404,23,70022,824,No,No,11813
North Dakota,2020/11/21,10.78415057,1524,16,71546,840,No,No,11813
North Dakota,2020/11/22,10.78415057,1143,6,72689,846,No,No,11813
North Dakota,2020/11/23,10.78415057,714,6,73403,852,No,No,11813
North Dakota,2020/11/24,10.78415057,1004,37,74407,889,No,No,11813
North Dakota,2020/11/25,10.78415057,1077,4,75484,893,No,No,7061
North Dakota,2020/11/26,10.78415057,964,10,76448,903,No,No,7061
North Dakota,2020/11/27,10.78415057,790,5,77238,908,No,No,7061
North Dakota,2020/11/28,10.78415057,703,13,77941,921,No,No,7061
North Dakota,2020/11/29,10.78415057,723,5,78664,926,No,No,7061
North Dakota,2020/11/30,10.78415057,594,7,79258,933,No,No,7061
North Dakota,2020/12/1,10.78415057,403,27,79661,960,No,No,7061
North Dakota,2020/12/2,10.78415057,480,12,80141,972,No,No,7656
North Dakota,2020/12/3,10.78415057,970,11,81111,983,No,No,7656
North Dakota,2020/12/4,10.78415057,844,12,81955,995,No,No,7656
North Dakota,2020/12/5,10.78415057,555,18,82510,1013,No,No,7656
North Dakota,2020/12/6,10.78415057,477,6,82987,1019,No,No,7656
North Dakota,2020/12/7,10.78415057,361,9,83348,1028,No,No,7656
North Dakota,2020/12/8,10.78415057,2340,36,85688,1064,No,No,7656
North Dakota,2020/12/9,10.78415057,461,17,86149,1081,No,No,7568
North Dakota,2020/12/10,10.78415057,564,28,86713,1109,No,No,7568
North Dakota,2020/12/11,10.78415057,507,27,87220,1136,No,No,7568
North Dakota,2020/12/12,10.78415057,376,22,87596,1158,No,No,7568
North Dakota,2020/12/13,10.78415057,281,0,87877,1158,No,No,7568
North Dakota,2020/12/14,10.78415057,196,5,88073,1163,No,No,7568
North Dakota,2020/12/15,10.78415057,328,13,88401,1176,No,No,7568
North Dakota,2020/12/16,10.78415057,291,25,88692,1201,No,No,7543
North Dakota,2020/12/17,10.78415057,377,9,89069,1210,No,No,7543
North Dakota,2020/12/18,10.78415057,494,21,89563,1231,No,No,7543
North Dakota,2020/12/19,10.78415057,231,6,89794,1237,No,No,7543
North Dakota,2020/12/20,10.78415057,251,0,90045,1237,No,No,7543
North Dakota,2020/12/21,10.78415057,82,2,90127,1239,No,No,7543
North Dakota,2020/12/22,10.78415057,332,5,90459,1244,No,No,7543
North Dakota,2020/12/23,10.78415057,270,5,90729,1249,No,No,5506
North Dakota,2020/12/24,10.78415057,226,18,90955,1267,No,No,5506
North Dakota,2020/12/25,10.78415057,274,4,91229,1271,No,No,5506
North Dakota,2020/12/26,10.78415057,133,0,91362,1271,No,No,5506
North Dakota,2020/12/27,10.78415057,110,2,91472,1273,No,No,5506
North Dakota,2020/12/28,10.78415057,93,4,91565,1277,No,No,5506
North Dakota,2020/12/29,10.78415057,271,6,91836,1283,No,No,5506
North Dakota,2020/12/30,10.78415057,372,6,92208,1289,No,No,10986
North Dakota,2020/12/31,10.78415057,294,10,92502,1299,No,No,10986
North Dakota,2021/1/1,10.78415057,275,17,92777,1316,No,No,10986
North Dakota,2021/1/2,10.78415057,121,1,92898,1317,No,No,10986
North Dakota,2021/1/3,10.78415057,150,0,93048,1317,No,No,10986
North Dakota,2021/1/4,10.78415057,199,2,93247,1319,No,No,10986
North Dakota,2021/1/5,10.78415057,254,17,93501,1336,No,No,10986
North Dakota,2021/1/6,10.78415057,338,5,93839,1341,No,No,14084
North Dakota,2021/1/7,10.78415057,324,7,94163,1348,No,No,14084
North Dakota,2021/1/8,10.78415057,283,12,94446,1360,No,No,14084
North Dakota,2021/1/9,10.78415057,120,0,94566,1360,No,No,14084
North Dakota,2021/1/10,10.78415057,158,0,94724,1360,No,No,14084
North Dakota,2021/1/11,10.78415057,114,0,94838,1360,No,No,14084
North Dakota,2021/1/12,10.78415057,138,3,94976,1363,No,No,14084
North Dakota,2021/1/13,10.78415057,166,1,95142,1364,No,No,11980
North Dakota,2021/1/14,10.78415057,243,8,95385,1372,No,No,11980
North Dakota,2021/1/15,10.78415057,236,23,95621,1395,No,No,11980
North Dakota,2021/1/16,10.78415057,115,8,95736,1403,No,No,11980
North Dakota,2021/1/17,10.78415057,150,3,95886,1406,No,No,11980
North Dakota,2021/1/18,10.78415057,70,0,95956,1406,No,No,11980
North Dakota,2021/1/19,10.78415057,137,2,96093,1408,No,No,11980
North Dakota,2021/1/20,10.78415057,151,1,96244,1409,No,No,11615
North Dakota,2021/1/21,10.78415057,148,13,96392,1422,No,No,11615
North Dakota,2021/1/22,10.78415057,200,6,96592,1428,No,No,11615
North Dakota,2021/1/23,10.78415057,153,8,96745,1436,No,No,11615
North Dakota,2021/1/24,10.78415057,97,0,96842,1436,No,No,11615
North Dakota,2021/1/25,10.78415057,57,0,96899,1436,No,No,11615
North Dakota,2021/1/26,10.78415057,132,4,97031,1440,No,No,11615
North Dakota,2021/1/27,10.78415057,154,1,97185,1441,No,No,12664
North Dakota,2021/1/28,10.78415057,145,1,97330,1442,No,No,12664
North Dakota,2021/1/29,10.78415057,153,2,97483,1444,No,No,12664
North Dakota,2021/1/30,10.78415057,104,3,97587,1447,No,No,12664
North Dakota,2021/1/31,10.78415057,68,0,97655,1447,No,No,12664
North Dakota,2021/2/1,10.78415057,53,0,97708,1447,No,No,12664
North Dakota,2021/2/2,10.78415057,115,0,97823,1447,No,No,12664
North Dakota,2021/2/3,10.78415057,138,0,97961,1447,No,No,13464
North Dakota,2021/2/4,10.78415057,98,0,98059,1447,No,No,13464
North Dakota,2021/2/5,10.78415057,61,4,98120,1451,No,No,13464
North Dakota,2021/2/6,10.78415057,11,2,98131,1453,No,No,13464
North Dakota,2021/2/7,10.78415057,49,0,98180,1453,No,No,13464
North Dakota,2021/2/8,10.78415057,30,1,98210,1454,No,No,13464
North Dakota,2021/2/9,10.78415057,-5,3,98205,1457,No,No,13464
North Dakota,2021/2/10,10.78415057,39,2,98244,1459,No,No,12087
North Dakota,2021/2/11,10.78415057,139,1,98383,1460,No,No,12087
North Dakota,2021/2/12,10.78415057,113,1,98496,1461,No,No,12087
North Dakota,2021/2/13,10.78415057,85,0,98581,1461,No,No,12087
North Dakota,2021/2/14,10.78415057,46,0,98627,1461,No,No,12087
North Dakota,2021/2/15,10.78415057,46,0,98673,1461,No,No,12087
North Dakota,2021/2/16,10.78415057,138,0,98811,1461,No,No,12087
North Dakota,2021/2/17,10.78415057,120,0,98931,1461,No,No,11395
North Dakota,2021/2/18,10.78415057,133,4,99064,1465,No,No,11395
North Dakota,2021/2/19,10.78415057,119,0,99183,1465,No,No,11395
North Dakota,2021/2/20,10.78415057,75,2,99258,1467,No,No,11395
North Dakota,2021/2/21,10.78415057,49,1,99307,1468,No,No,11395
North Dakota,2021/2/22,10.78415057,35,0,99342,1468,No,No,11395
North Dakota,2021/2/23,10.78415057,104,1,99446,1469,No,No,11395
North Dakota,2021/2/24,10.78415057,115,1,99561,1470,No,No,11395
North Dakota,2021/2/25,10.78415057,90,1,99651,1471,No,No,11395
North Dakota,2021/2/26,10.78415057,90,1,99741,1472,No,No,11395
North Dakota,2021/2/27,10.78415057,69,3,99810,1475,No,No,11395
North Dakota,2021/2/28,10.78415057,29,0,99839,1475,No,No,11395
North Dakota,2021/3/1,10.78415057,43,0,99882,1475,No,No,11395
North Dakota,2021/3/2,10.78415057,105,2,99987,1477,No,No,11395
North Dakota,2021/3/3,10.78415057,110,1,100097,1478,No,No,11395
North Dakota,2021/3/4,10.78415057,117,0,100214,1478,No,No,11395
Ohio,2020/3/1,283.5646014,0,0,0,0,No,No,1575
Ohio,2020/3/2,283.5646014,0,0,0,0,No,No,1575
Ohio,2020/3/3,283.5646014,0,0,0,0,No,No,1575
Ohio,2020/3/4,283.5646014,0,0,0,0,No,No,1663
Ohio,2020/3/5,283.5646014,0,0,0,0,No,No,1663
Ohio,2020/3/6,283.5646014,0,0,0,0,No,No,1663
Ohio,2020/3/7,283.5646014,0,0,0,0,No,No,1663
Ohio,2020/3/8,283.5646014,0,0,0,0,No,No,1663
Ohio,2020/3/9,283.5646014,3,0,3,0,No,No,1663
Ohio,2020/3/10,283.5646014,0,0,3,0,No,No,1663
Ohio,2020/3/11,283.5646014,1,0,4,0,No,No,1819
Ohio,2020/3/12,283.5646014,1,0,5,0,No,No,1819
Ohio,2020/3/13,283.5646014,8,0,13,0,No,No,1819
Ohio,2020/3/14,283.5646014,13,0,26,0,No,No,1819
Ohio,2020/3/15,283.5646014,11,0,37,0,No,No,1819
Ohio,2020/3/16,283.5646014,13,0,50,0,No,No,1819
Ohio,2020/3/17,283.5646014,17,0,67,0,No,No,1819
Ohio,2020/3/18,283.5646014,23,0,90,0,No,No,10892
Ohio,2020/3/19,283.5646014,30,0,120,0,No,No,10892
Ohio,2020/3/20,283.5646014,49,1,169,1,No,No,10892
Ohio,2020/3/21,283.5646014,78,2,247,3,No,No,10892
Ohio,2020/3/22,283.5646014,104,0,351,3,No,No,10892
Ohio,2020/3/23,283.5646014,93,3,444,6,Yes,No,10892
Ohio,2020/3/24,283.5646014,120,2,564,8,Yes,No,10892
Ohio,2020/3/25,283.5646014,143,3,707,11,Yes,No,80984
Ohio,2020/3/26,283.5646014,160,4,867,15,Yes,No,80984
Ohio,2020/3/27,283.5646014,277,7,1144,22,Yes,No,80984
Ohio,2020/3/28,283.5646014,262,3,1406,25,Yes,No,80984
Ohio,2020/3/29,283.5646014,259,5,1665,30,Yes,No,80984
Ohio,2020/3/30,283.5646014,268,10,1933,40,Yes,No,80984
Ohio,2020/3/31,283.5646014,266,15,2199,55,Yes,No,80984
Ohio,2020/4/1,283.5646014,349,10,2548,65,Yes,No,106739
Ohio,2020/4/2,283.5646014,355,16,2903,81,Yes,No,106739
Ohio,2020/4/3,283.5646014,409,10,3312,91,Yes,No,106739
Ohio,2020/4/4,283.5646014,427,11,3739,102,Yes,No,106739
Ohio,2020/4/5,283.5646014,304,17,4043,119,Yes,No,106739
Ohio,2020/4/6,283.5646014,407,23,4450,142,Yes,No,106739
Ohio,2020/4/7,283.5646014,333,25,4783,167,Yes,No,106739
Ohio,2020/4/8,283.5646014,366,26,5149,193,Yes,No,77515
Ohio,2020/4/9,283.5646014,364,20,5513,213,Yes,No,77515
Ohio,2020/4/10,283.5646014,366,18,5879,231,Yes,No,77515
Ohio,2020/4/11,283.5646014,372,16,6251,247,Yes,No,77515
Ohio,2020/4/12,283.5646014,354,6,6605,253,Yes,No,77515
Ohio,2020/4/13,283.5646014,370,21,6975,274,Yes,No,77515
Ohio,2020/4/14,283.5646014,305,50,7280,324,Yes,No,77515
Ohio,2020/4/15,283.5646014,511,37,7791,361,Yes,No,66432
Ohio,2020/4/16,283.5646014,623,28,8414,389,Yes,No,66432
Ohio,2020/4/17,283.5646014,693,29,9107,418,Yes,No,66432
Ohio,2020/4/18,283.5646014,1115,33,10222,451,Yes,No,66432
Ohio,2020/4/19,283.5646014,1380,20,11602,471,Yes,No,66432
Ohio,2020/4/20,283.5646014,1317,38,12919,509,Yes,No,66432
Ohio,2020/4/21,283.5646014,806,48,13725,557,Yes,No,66432
Ohio,2020/4/22,283.5646014,392,53,14117,610,Yes,No,74966
Ohio,2020/4/23,283.5646014,577,46,14694,656,Yes,No,74966
Ohio,2020/4/24,283.5646014,475,34,15169,690,Yes,No,74966
Ohio,2020/4/25,283.5646014,418,21,15587,711,Yes,No,74966
Ohio,2020/4/26,283.5646014,376,17,15963,728,Yes,No,74966
Ohio,2020/4/27,283.5646014,362,25,16325,753,Yes,No,74966
Ohio,2020/4/28,283.5646014,444,46,16769,799,Yes,No,74966
Ohio,2020/4/29,283.5646014,534,138,17303,937,Yes,No,28985
Ohio,2020/4/30,283.5646014,724,38,18027,975,Yes,No,28985
Ohio,2020/5/1,283.5646014,716,27,18743,1002,Yes,No,28985
Ohio,2020/5/2,283.5646014,592,19,19335,1021,Yes,No,28985
Ohio,2020/5/3,283.5646014,579,17,19914,1038,Yes,No,28985
Ohio,2020/5/4,283.5646014,560,18,20474,1056,Yes,No,28985
Ohio,2020/5/5,283.5646014,495,79,20969,1135,Yes,No,28985
Ohio,2020/5/6,283.5646014,607,90,21576,1225,Yes,No,26666
Ohio,2020/5/7,283.5646014,555,46,22131,1271,Yes,No,26666
Ohio,2020/5/8,283.5646014,887,35,23018,1306,Yes,No,26666
Ohio,2020/5/9,283.5646014,679,25,23697,1331,Yes,No,26666
Ohio,2020/5/10,283.5646014,389,10,24086,1341,Yes,No,26666
Ohio,2020/5/11,283.5646014,699,16,24785,1357,Yes,No,26666
Ohio,2020/5/12,283.5646014,472,79,25257,1436,Yes,No,26666
Ohio,2020/5/13,283.5646014,470,47,25727,1483,Yes,No,25150
Ohio,2020/5/14,283.5646014,636,51,26363,1534,Yes,No,25150
Ohio,2020/5/15,283.5646014,593,47,26956,1581,Yes,No,25150
Ohio,2020/5/16,283.5646014,520,29,27476,1610,Yes,No,25150
Ohio,2020/5/17,283.5646014,449,15,27925,1625,Yes,No,25150
Ohio,2020/5/18,283.5646014,530,32,28455,1657,Yes,No,25150
Ohio,2020/5/19,283.5646014,498,63,28953,1720,Yes,No,25150
Ohio,2020/5/20,283.5646014,484,61,29437,1781,No,No,27919
Ohio,2020/5/21,283.5646014,731,55,30168,1836,No,No,27919
Ohio,2020/5/22,283.5646014,627,36,30795,1872,No,No,27919
Ohio,2020/5/23,283.5646014,613,84,31408,1956,No,No,27919
Ohio,2020/5/24,283.5646014,503,13,31911,1969,No,No,27919
Ohio,2020/5/25,283.5646014,566,18,32477,1987,No,No,27919
Ohio,2020/5/26,283.5646014,529,15,33006,2002,No,No,27919
Ohio,2020/5/27,283.5646014,433,42,33439,2044,No,No,21335
Ohio,2020/5/28,283.5646014,476,54,33915,2098,No,No,21335
Ohio,2020/5/29,283.5646014,651,33,34566,2131,No,No,21335
Ohio,2020/5/30,283.5646014,468,18,35034,2149,No,No,21335
Ohio,2020/5/31,283.5646014,479,6,35513,2155,No,No,21335
Ohio,2020/6/1,283.5646014,471,51,35984,2206,No,No,21335
Ohio,2020/6/2,283.5646014,366,52,36350,2258,No,No,21335
Ohio,2020/6/3,283.5646014,442,41,36792,2299,No,No,19949
Ohio,2020/6/4,283.5646014,490,40,37282,2339,No,No,19949
Ohio,2020/6/5,283.5646014,476,16,37758,2355,No,No,19949
Ohio,2020/6/6,283.5646014,353,15,38111,2370,No,No,19949
Ohio,2020/6/7,283.5646014,365,7,38476,2377,No,No,19949
Ohio,2020/6/8,283.5646014,361,27,38837,2404,No,No,19949
Ohio,2020/6/9,283.5646014,325,17,39162,2421,No,No,19949
Ohio,2020/6/10,283.5646014,413,36,39575,2457,No,No,18367
Ohio,2020/6/11,283.5646014,429,33,40004,2490,No,No,18367
Ohio,2020/6/12,283.5646014,420,18,40424,2508,No,No,18367
Ohio,2020/6/13,283.5646014,424,46,40848,2554,No,No,18367
Ohio,2020/6/14,283.5646014,300,3,41148,2557,No,No,18367
Ohio,2020/6/15,283.5646014,428,16,41576,2573,No,No,18367
Ohio,2020/6/16,283.5646014,434,24,42010,2597,No,No,18367
Ohio,2020/6/17,283.5646014,412,14,42422,2611,No,No,18671
Ohio,2020/6/18,283.5646014,700,22,43122,2633,No,No,18671
Ohio,2020/6/19,283.5646014,609,34,43731,2667,No,No,18671
Ohio,2020/6/20,283.5646014,531,30,44262,2697,No,No,18671
Ohio,2020/6/21,283.5646014,546,3,44808,2700,No,No,18671
Ohio,2020/6/22,283.5646014,729,4,45537,2704,No,No,18671
Ohio,2020/6/23,283.5646014,590,31,46127,2735,No,No,18671
Ohio,2020/6/24,283.5646014,632,20,46759,2755,No,No,18338
Ohio,2020/6/25,283.5646014,892,17,47651,2772,No,No,18338
Ohio,2020/6/26,283.5646014,987,16,48638,2788,No,No,18338
Ohio,2020/6/27,283.5646014,817,16,49455,2804,No,No,18338
Ohio,2020/6/28,283.5646014,854,3,50309,2807,No,No,18338
Ohio,2020/6/29,283.5646014,737,11,51046,2818,No,No,18338
Ohio,2020/6/30,283.5646014,743,45,51789,2863,No,No,18338
Ohio,2020/7/1,283.5646014,1076,13,52865,2876,No,No,19056
Ohio,2020/7/2,283.5646014,1301,27,54166,2903,No,No,19056
Ohio,2020/7/3,283.5646014,1091,0,55257,2903,No,No,19056
Ohio,2020/7/4,283.5646014,926,4,56183,2907,No,No,19056
Ohio,2020/7/5,283.5646014,968,4,57151,2911,No,No,19056
Ohio,2020/7/6,283.5646014,805,16,57956,2927,No,No,19056
Ohio,2020/7/7,283.5646014,948,43,58904,2970,No,No,19056
Ohio,2020/7/8,283.5646014,1277,21,60181,2991,No,No,20563
Ohio,2020/7/9,283.5646014,1150,15,61331,3006,No,No,20563
Ohio,2020/7/10,283.5646014,1525,26,62856,3032,No,No,20563
Ohio,2020/7/11,283.5646014,1358,4,64214,3036,No,No,20563
Ohio,2020/7/12,283.5646014,1378,22,65592,3058,No,No,20563
Ohio,2020/7/13,283.5646014,1261,6,66853,3064,No,No,20563
Ohio,2020/7/14,283.5646014,1142,5,67995,3069,No,No,20563
Ohio,2020/7/15,283.5646014,1316,6,69311,3075,No,No,23676
Ohio,2020/7/16,283.5646014,1290,28,70601,3103,No,No,23676
Ohio,2020/7/17,283.5646014,1679,9,72280,3112,No,No,23676
Ohio,2020/7/18,283.5646014,1542,20,73822,3132,No,No,23676
Ohio,2020/7/19,283.5646014,1110,42,74932,3174,No,No,23676
Ohio,2020/7/20,283.5646014,1236,15,76168,3189,No,No,23676
Ohio,2020/7/21,283.5646014,1047,30,77215,3219,No,No,23676
Ohio,2020/7/22,283.5646014,1527,16,78742,3235,No,No,17437
Ohio,2020/7/23,283.5646014,1444,21,80186,3256,No,Yes,17437
Ohio,2020/7/24,283.5646014,1560,41,81746,3297,No,Yes,17437
Ohio,2020/7/25,283.5646014,1438,0,83184,3297,No,Yes,17437
Ohio,2020/7/26,283.5646014,889,10,84073,3307,No,Yes,17437
Ohio,2020/7/27,283.5646014,1104,37,85177,3344,No,Yes,17437
Ohio,2020/7/28,283.5646014,1320,38,86497,3382,No,Yes,17437
Ohio,2020/7/29,283.5646014,1396,40,87893,3422,No,Yes,11690
Ohio,2020/7/30,283.5646014,1733,20,89626,3442,No,Yes,11690
Ohio,2020/7/31,283.5646014,1533,47,91159,3489,No,Yes,11690
Ohio,2020/8/1,283.5646014,928,26,92087,3515,No,Yes,11690
Ohio,2020/8/2,283.5646014,944,14,93031,3529,No,Yes,11690
Ohio,2020/8/3,283.5646014,932,10,93963,3539,No,Yes,11690
Ohio,2020/8/4,283.5646014,1143,31,95106,3570,No,Yes,11690
Ohio,2020/8/5,283.5646014,1199,26,96305,3596,No,Yes,9467
Ohio,2020/8/6,283.5646014,1166,22,97471,3618,No,Yes,9467
Ohio,2020/8/7,283.5646014,1204,34,98675,3652,No,Yes,9467
Ohio,2020/8/8,283.5646014,1294,16,99969,3668,No,Yes,9467
Ohio,2020/8/9,283.5646014,879,1,100848,3669,No,Yes,9467
Ohio,2020/8/10,283.5646014,883,4,101731,3673,No,Yes,9467
Ohio,2020/8/11,283.5646014,1095,35,102826,3708,No,Yes,9467
Ohio,2020/8/12,283.5646014,1422,26,104248,3734,No,Yes,11047
Ohio,2020/8/13,283.5646014,1178,21,105426,3755,No,Yes,11047
Ohio,2020/8/14,283.5646014,1131,29,106557,3784,No,Yes,11047
Ohio,2020/8/15,283.5646014,1117,40,107674,3824,No,Yes,11047
Ohio,2020/8/16,283.5646014,613,2,108287,3826,No,Yes,11047
Ohio,2020/8/17,283.5646014,775,6,109062,3832,No,Yes,11047
Ohio,2020/8/18,283.5646014,861,39,109923,3871,No,Yes,11047
Ohio,2020/8/19,283.5646014,958,36,110881,3907,No,Yes,8676
Ohio,2020/8/20,283.5646014,1122,22,112003,3929,No,Yes,8676
Ohio,2020/8/21,283.5646014,1043,26,113046,3955,No,Yes,8676
Ohio,2020/8/22,283.5646014,1119,20,114165,3975,No,Yes,8676
Ohio,2020/8/23,283.5646014,637,3,114802,3978,No,Yes,8676
Ohio,2020/8/24,283.5646014,849,8,115651,3986,No,Yes,8676
Ohio,2020/8/25,283.5646014,844,10,116495,3996,No,Yes,8676
Ohio,2020/8/26,283.5646014,1089,48,117584,4044,No,Yes,8511
Ohio,2020/8/27,283.5646014,1244,32,118828,4076,No,Yes,8511
Ohio,2020/8/28,283.5646014,1296,29,120124,4105,No,Yes,8511
Ohio,2020/8/29,283.5646014,1216,21,121340,4126,No,Yes,8511
Ohio,2020/8/30,283.5646014,922,2,122262,4128,No,Yes,8511
Ohio,2020/8/31,283.5646014,895,10,123157,4138,No,Yes,8511
Ohio,2020/9/1,283.5646014,1453,27,124610,4165,No,Yes,8511
Ohio,2020/9/2,283.5646014,1157,11,125767,4176,No,Yes,8901
Ohio,2020/9/3,283.5646014,1345,50,127112,4226,No,Yes,8901
Ohio,2020/9/4,283.5646014,1332,22,128444,4248,No,Yes,8901
Ohio,2020/9/5,283.5646014,1341,8,129785,4256,No,Yes,8901
Ohio,2020/9/6,283.5646014,773,3,130558,4259,No,Yes,8901
Ohio,2020/9/7,283.5646014,778,17,131336,4276,No,Yes,8901
Ohio,2020/9/8,283.5646014,656,22,131992,4298,No,Yes,8901
Ohio,2020/9/9,283.5646014,973,26,132965,4324,No,Yes,8848
Ohio,2020/9/10,283.5646014,1121,30,134086,4354,No,Yes,8848
Ohio,2020/9/11,283.5646014,1240,49,135326,4403,No,Yes,8848
Ohio,2020/9/12,283.5646014,1242,8,136568,4411,No,Yes,8848
Ohio,2020/9/13,283.5646014,837,4,137405,4415,No,Yes,8848
Ohio,2020/9/14,283.5646014,1079,4,138484,4419,No,Yes,8848
Ohio,2020/9/15,283.5646014,1001,87,139485,4506,No,Yes,8848
Ohio,2020/9/16,283.5646014,1033,49,140518,4555,No,Yes,8679
Ohio,2020/9/17,283.5646014,1067,25,141585,4580,No,Yes,8679
Ohio,2020/9/18,283.5646014,1011,28,142596,4608,No,Yes,8679
Ohio,2020/9/19,283.5646014,951,4,143547,4612,No,Yes,8679
Ohio,2020/9/20,283.5646014,762,3,144309,4615,No,Yes,8679
Ohio,2020/9/21,283.5646014,856,8,145165,4623,No,Yes,8679
Ohio,2020/9/22,283.5646014,685,12,145850,4635,No,Yes,8679
Ohio,2020/9/23,283.5646014,903,52,146753,4687,No,Yes,8805
Ohio,2020/9/24,283.5646014,991,28,147744,4715,No,Yes,8805
Ohio,2020/9/25,283.5646014,1150,19,148894,4734,No,Yes,8805
Ohio,2020/9/26,283.5646014,1115,6,150009,4740,No,Yes,8805
Ohio,2020/9/27,283.5646014,800,1,150809,4741,No,Yes,8805
Ohio,2020/9/28,283.5646014,993,5,151802,4746,No,Yes,8805
Ohio,2020/9/29,283.5646014,1105,37,152907,4783,No,Yes,8805
Ohio,2020/9/30,283.5646014,1080,21,153987,4804,No,Yes,7732
Ohio,2020/10/1,283.5646014,1327,13,155314,4817,No,Yes,7732
Ohio,2020/10/2,283.5646014,1495,88,156809,4905,No,Yes,7732
Ohio,2020/10/3,283.5646014,1157,20,157966,4925,No,Yes,7732
Ohio,2020/10/4,283.5646014,941,0,158907,4925,No,Yes,7732
Ohio,2020/10/5,283.5646014,1057,6,159964,4931,No,Yes,7732
Ohio,2020/10/6,283.5646014,1335,16,161299,4947,No,Yes,7732
Ohio,2020/10/7,283.5646014,1424,23,162723,4970,No,Yes,8581
Ohio,2020/10/8,283.5646014,1539,13,164262,4983,No,Yes,8581
Ohio,2020/10/9,283.5646014,1840,11,166102,4994,No,Yes,8581
Ohio,2020/10/10,283.5646014,1356,3,167458,4997,No,Yes,8581
Ohio,2020/10/11,283.5646014,1291,2,168749,4999,No,Yes,8581
Ohio,2020/10/12,283.5646014,1430,6,170179,5005,No,Yes,8581
Ohio,2020/10/13,283.5646014,1447,12,171626,5017,No,Yes,8581
Ohio,2020/10/14,283.5646014,2039,16,173665,5033,No,Yes,7964
Ohio,2020/10/15,283.5646014,2178,5,175843,5038,No,Yes,7964
Ohio,2020/10/16,283.5646014,2148,16,177991,5054,No,Yes,7964
Ohio,2020/10/17,283.5646014,2234,13,180225,5067,No,Yes,7964
Ohio,2020/10/18,283.5646014,1562,0,181787,5067,No,Yes,7964
Ohio,2020/10/19,283.5646014,1837,8,183624,5075,No,Yes,7964
Ohio,2020/10/20,283.5646014,2015,8,185639,5083,No,Yes,7964
Ohio,2020/10/21,283.5646014,2366,66,188005,5149,No,Yes,7126
Ohio,2020/10/22,283.5646014,2425,12,190430,5161,No,Yes,7126
Ohio,2020/10/23,283.5646014,2518,23,192948,5184,No,Yes,7126
Ohio,2020/10/24,283.5646014,2858,22,195806,5206,No,Yes,7126
Ohio,2020/10/25,283.5646014,2309,0,198115,5206,No,Yes,7126
Ohio,2020/10/26,283.5646014,2116,11,200231,5217,No,Yes,7126
Ohio,2020/10/27,283.5646014,2509,22,202740,5239,No,Yes,7126
Ohio,2020/10/28,283.5646014,2607,17,205347,5256,No,Yes,7060
Ohio,2020/10/29,283.5646014,3590,19,208937,5275,No,Yes,7060
Ohio,2020/10/30,283.5646014,3845,16,212782,5291,No,Yes,7060
Ohio,2020/10/31,283.5646014,2915,10,215697,5301,No,Yes,7060
Ohio,2020/11/1,283.5646014,3303,2,219000,5303,No,Yes,7060
Ohio,2020/11/2,283.5646014,2909,37,221909,5340,No,Yes,7060
Ohio,2020/11/3,283.5646014,4229,33,226138,5373,No,Yes,7060
Ohio,2020/11/4,283.5646014,4071,55,230209,5428,No,Yes,8764
Ohio,2020/11/5,283.5646014,4961,33,235170,5461,No,Yes,8764
Ohio,2020/11/6,283.5646014,5008,33,240178,5494,No,Yes,8764
Ohio,2020/11/7,283.5646014,5549,12,245727,5506,No,Yes,8764
Ohio,2020/11/8,283.5646014,4541,11,250268,5517,No,Yes,8764
Ohio,2020/11/9,283.5646014,4706,7,254974,5524,No,Yes,8764
Ohio,2020/11/10,283.5646014,6508,23,261482,5547,No,Yes,8764
Ohio,2020/11/11,283.5646014,5874,76,267356,5623,No,Yes,9262
Ohio,2020/11/12,283.5646014,7101,35,274457,5658,No,Yes,9262
Ohio,2020/11/13,283.5646014,8071,42,282528,5700,No,Yes,9262
Ohio,2020/11/14,283.5646014,7715,14,290243,5714,No,Yes,9262
Ohio,2020/11/15,283.5646014,7853,8,298096,5722,No,Yes,9262
Ohio,2020/11/16,283.5646014,7268,20,305364,5742,No,Yes,9262
Ohio,2020/11/17,283.5646014,7079,30,312443,5772,No,Yes,9262
Ohio,2020/11/18,283.5646014,6385,55,318828,5827,No,Yes,11813
Ohio,2020/11/19,283.5646014,7787,63,326615,5890,No,Yes,11813
Ohio,2020/11/20,283.5646014,8808,65,335423,5955,No,Yes,11813
Ohio,2020/11/21,283.5646014,7863,29,343286,5984,No,Yes,11813
Ohio,2020/11/22,283.5646014,8133,12,351419,5996,No,Yes,11813
Ohio,2020/11/23,283.5646014,11885,24,363304,6020,No,Yes,11813
Ohio,2020/11/24,283.5646014,8604,98,371908,6118,No,Yes,11813
Ohio,2020/11/25,283.5646014,10835,156,382743,6274,No,Yes,7061
Ohio,2020/11/26,283.5646014,0,0,382743,6274,No,Yes,7061
Ohio,2020/11/27,283.5646014,17065,72,399808,6346,No,Yes,7061
Ohio,2020/11/28,283.5646014,6895,32,406703,6378,No,Yes,7061
Ohio,2020/11/29,283.5646014,7729,21,414432,6399,No,Yes,7061
Ohio,2020/11/30,283.5646014,6631,30,421063,6429,No,Yes,7061
Ohio,2020/12/1,283.5646014,9030,119,430093,6548,No,Yes,7061
Ohio,2020/12/2,283.5646014,7835,123,437928,6671,No,Yes,7656
Ohio,2020/12/3,283.5646014,8931,82,446859,6753,No,Yes,7656
Ohio,2020/12/4,283.5646014,10104,129,456963,6882,No,Yes,7656
Ohio,2020/12/5,283.5646014,10469,65,467432,6947,No,Yes,7656
Ohio,2020/12/6,283.5646014,7592,13,475024,6960,No,Yes,7656
Ohio,2020/12/7,283.5646014,9273,63,484297,7023,No,Yes,7656
Ohio,2020/12/8,283.5646014,25721,80,510018,7103,No,Yes,7656
Ohio,2020/12/9,283.5646014,10094,84,520112,7187,No,Yes,7568
Ohio,2020/12/10,283.5646014,11738,111,531850,7298,No,Yes,7568
Ohio,2020/12/11,283.5646014,10359,128,542209,7426,No,Yes,7568
Ohio,2020/12/12,283.5646014,11252,51,553461,7477,No,Yes,7568
Ohio,2020/12/13,283.5646014,9266,15,562727,7492,No,Yes,7568
Ohio,2020/12/14,283.5646014,7875,59,570602,7551,No,Yes,7568
Ohio,2020/12/15,283.5646014,8755,103,579357,7654,No,Yes,7568
Ohio,2020/12/16,283.5646014,5409,123,584766,7777,No,Yes,7543
Ohio,2020/12/17,283.5646014,11412,117,596178,7894,No,Yes,7543
Ohio,2020/12/18,283.5646014,9684,73,605862,7967,No,Yes,7543
Ohio,2020/12/19,283.5646014,8567,64,614429,8031,No,Yes,7543
Ohio,2020/12/20,283.5646014,8377,16,622806,8047,No,Yes,7543
Ohio,2020/12/21,283.5646014,6548,75,629354,8122,No,Yes,7543
Ohio,2020/12/22,283.5646014,7678,130,637032,8252,No,Yes,7543
Ohio,2020/12/23,283.5646014,7790,109,644822,8361,No,Yes,5506
Ohio,2020/12/24,283.5646014,8828,95,653650,8456,No,Yes,5506
Ohio,2020/12/25,283.5646014,0,0,653650,8456,No,Yes,5506
Ohio,2020/12/26,283.5646014,11018,20,664668,8476,No,Yes,5506
Ohio,2020/12/27,283.5646014,5857,33,670525,8509,No,Yes,5506
Ohio,2020/12/28,283.5646014,4519,62,675044,8571,No,Yes,5506
Ohio,2020/12/29,283.5646014,7526,151,682570,8722,No,Yes,5506
Ohio,2020/12/30,283.5646014,8178,133,690748,8855,No,Yes,10986
Ohio,2020/12/31,283.5646014,9632,107,700380,8962,No,Yes,10986
Ohio,2021/1/1,283.5646014,0,0,700380,8962,No,Yes,10986
Ohio,2021/1/2,283.5646014,14293,55,714673,9017,No,Yes,10986
Ohio,2021/1/3,283.5646014,6808,59,721481,9076,No,Yes,10986
Ohio,2021/1/4,283.5646014,5942,67,727423,9143,No,Yes,10986
Ohio,2021/1/5,283.5646014,7580,104,735003,9247,No,Yes,10986
Ohio,2021/1/6,283.5646014,7814,121,742817,9368,No,Yes,14084
Ohio,2021/1/7,283.5646014,10251,94,753068,9462,No,Yes,14084
Ohio,2021/1/8,283.5646014,9535,82,762603,9544,No,Yes,14084
Ohio,2021/1/9,283.5646014,8374,55,770977,9599,No,Yes,14084
Ohio,2021/1/10,283.5646014,6088,28,777065,9627,No,Yes,14084
Ohio,2021/1/11,283.5646014,7892,75,784957,9702,No,Yes,14084
Ohio,2021/1/12,283.5646014,7981,100,792938,9802,No,Yes,14084
Ohio,2021/1/13,283.5646014,6701,79,799639,9881,No,Yes,11980
Ohio,2021/1/14,283.5646014,7654,109,807293,9990,No,Yes,11980
Ohio,2021/1/15,283.5646014,7149,67,814442,10057,No,Yes,11980
Ohio,2021/1/16,283.5646014,7065,78,821507,10135,No,Yes,11980
Ohio,2021/1/17,283.5646014,5247,65,826754,10200,No,Yes,11980
Ohio,2021/1/18,283.5646014,4312,81,831066,10281,No,Yes,11980
Ohio,2021/1/19,283.5646014,4989,55,836055,10336,No,Yes,11980
Ohio,2021/1/20,283.5646014,6378,73,842433,10409,No,Yes,11615
Ohio,2021/1/21,283.5646014,7271,109,849704,10518,No,Yes,11615
Ohio,2021/1/22,283.5646014,4278,81,853982,10599,No,Yes,11615
Ohio,2021/1/23,283.5646014,5859,81,859841,10680,No,Yes,11615
Ohio,2021/1/24,283.5646014,4481,31,864322,10711,No,Yes,11615
Ohio,2021/1/25,283.5646014,4334,57,868656,10768,No,Yes,11615
Ohio,2021/1/26,283.5646014,4262,88,872918,10856,No,Yes,11615
Ohio,2021/1/27,283.5646014,5366,75,878284,10931,No,Yes,12664
Ohio,2021/1/28,283.5646014,5432,75,883716,11006,No,Yes,12664
Ohio,2021/1/29,283.5646014,4875,67,888591,11073,No,Yes,12664
Ohio,2021/1/30,283.5646014,4190,51,892781,11124,No,Yes,12664
Ohio,2021/1/31,283.5646014,3011,54,895792,11178,No,Yes,12664
Ohio,2021/2/1,283.5646014,3287,55,899079,11233,No,Yes,12664
Ohio,2021/2/2,283.5646014,3657,106,902736,11339,No,Yes,12664
Ohio,2021/2/3,283.5646014,3991,92,906727,11431,No,Yes,13464
Ohio,2021/2/4,283.5646014,4120,79,910847,11510,No,Yes,13464
Ohio,2021/2/5,283.5646014,3683,61,914530,11571,No,Yes,13464
Ohio,2021/2/6,283.5646014,3549,81,918079,11652,No,Yes,13464
Ohio,2021/2/7,283.5646014,2138,7,920217,11659,No,Yes,13464
Ohio,2021/2/8,283.5646014,1926,36,922143,11695,No,Yes,13464
Ohio,2021/2/9,283.5646014,3207,98,925350,11793,No,Yes,13464
Ohio,2021/2/10,283.5646014,3281,63,928631,11856,No,Yes,12087
Ohio,2021/2/11,283.5646014,2806,721,931437,12577,No,Yes,12087
Ohio,2021/2/12,283.5646014,3305,2559,934742,15136,No,Yes,12087
Ohio,2021/2/13,283.5646014,2799,1204,937541,16340,No,Yes,12087
Ohio,2021/2/14,283.5646014,1809,6,939350,16346,No,Yes,12087
Ohio,2021/2/15,283.5646014,1915,48,941265,16394,No,Yes,12087
Ohio,2021/2/16,283.5646014,2026,59,943291,16453,No,Yes,12087
Ohio,2021/2/17,283.5646014,1816,60,945107,16513,No,Yes,11395
Ohio,2021/2/18,283.5646014,2282,98,947389,16611,No,Yes,11395
Ohio,2021/2/19,283.5646014,2306,82,949695,16693,No,Yes,11395
Ohio,2021/2/20,283.5646014,2611,56,952306,16749,No,Yes,11395
Ohio,2021/2/21,283.5646014,1461,67,953767,16816,No,Yes,11395
Ohio,2021/2/22,283.5646014,1611,58,955378,16874,No,Yes,11395
Ohio,2021/2/23,283.5646014,2775,98,958153,16972,No,Yes,11395
Ohio,2021/2/24,283.5646014,1842,76,959995,17048,No,Yes,11395
Ohio,2021/2/25,283.5646014,2409,80,962404,17128,No,Yes,11395
Ohio,2021/2/26,283.5646014,1976,57,964380,17185,No,Yes,11395
Ohio,2021/2/27,283.5646014,1774,54,966154,17239,No,Yes,11395
Ohio,2021/2/28,283.5646014,1268,60,967422,17299,No,Yes,11395
Ohio,2021/3/1,283.5646014,1452,49,968874,17348,No,Yes,11395
Ohio,2021/3/2,283.5646014,1709,-598,970583,16750,No,Yes,11395
Ohio,2021/3/3,283.5646014,2022,0,972605,16750,No,Yes,11395
Ohio,2021/3/4,283.5646014,1875,0,974480,16750,No,Yes,11395
Oklahoma,2020/3/1,56.59364407,0,0,0,0,No,No,1575
Oklahoma,2020/3/2,56.59364407,0,0,0,0,No,No,1575
Oklahoma,2020/3/3,56.59364407,0,0,0,0,No,No,1575
Oklahoma,2020/3/4,56.59364407,0,0,0,0,No,No,1663
Oklahoma,2020/3/5,56.59364407,0,0,0,0,No,No,1663
Oklahoma,2020/3/6,56.59364407,1,0,1,0,No,No,1663
Oklahoma,2020/3/7,56.59364407,0,0,1,0,No,No,1663
Oklahoma,2020/3/8,56.59364407,0,0,1,0,No,No,1663
Oklahoma,2020/3/9,56.59364407,0,0,1,0,No,No,1663
Oklahoma,2020/3/10,56.59364407,1,0,2,0,No,No,1663
Oklahoma,2020/3/11,56.59364407,0,0,2,0,No,No,1819
Oklahoma,2020/3/12,56.59364407,0,0,2,0,No,No,1819
Oklahoma,2020/3/13,56.59364407,1,0,3,0,No,No,1819
Oklahoma,2020/3/14,56.59364407,1,0,4,0,No,No,1819
Oklahoma,2020/3/15,56.59364407,4,0,8,0,No,No,1819
Oklahoma,2020/3/16,56.59364407,2,0,10,0,No,No,1819
Oklahoma,2020/3/17,56.59364407,8,0,18,0,No,No,1819
Oklahoma,2020/3/18,56.59364407,11,0,29,0,No,No,10892
Oklahoma,2020/3/19,56.59364407,15,1,44,1,No,No,10892
Oklahoma,2020/3/20,56.59364407,5,0,49,1,No,No,10892
Oklahoma,2020/3/21,56.59364407,4,0,53,1,No,No,10892
Oklahoma,2020/3/22,56.59364407,14,1,67,2,No,No,10892
Oklahoma,2020/3/23,56.59364407,14,0,81,2,No,No,10892
Oklahoma,2020/3/24,56.59364407,25,1,106,3,No,No,10892
Oklahoma,2020/3/25,56.59364407,58,2,164,5,No,No,80984
Oklahoma,2020/3/26,56.59364407,84,2,248,7,No,No,80984
Oklahoma,2020/3/27,56.59364407,74,1,322,8,No,No,80984
Oklahoma,2020/3/28,56.59364407,55,7,377,15,No,No,80984
Oklahoma,2020/3/29,56.59364407,52,1,429,16,No,No,80984
Oklahoma,2020/3/30,56.59364407,52,1,481,17,No,No,80984
Oklahoma,2020/3/31,56.59364407,85,6,566,23,No,No,80984
Oklahoma,2020/4/1,56.59364407,153,7,719,30,Yes,No,106739
Oklahoma,2020/4/2,56.59364407,160,4,879,34,Yes,No,106739
Oklahoma,2020/4/3,56.59364407,110,4,989,38,Yes,No,106739
Oklahoma,2020/4/4,56.59364407,170,4,1159,42,Yes,No,106739
Oklahoma,2020/4/5,56.59364407,92,4,1251,46,Yes,No,106739
Oklahoma,2020/4/6,56.59364407,75,5,1326,51,Yes,No,106739
Oklahoma,2020/4/7,56.59364407,144,16,1470,67,Yes,No,106739
Oklahoma,2020/4/8,56.59364407,53,12,1523,79,Yes,No,77515
Oklahoma,2020/4/9,56.59364407,160,1,1683,80,Yes,No,77515
Oklahoma,2020/4/10,56.59364407,111,8,1794,88,Yes,No,77515
Oklahoma,2020/4/11,56.59364407,74,5,1868,93,Yes,No,77515
Oklahoma,2020/4/12,56.59364407,102,3,1970,96,Yes,No,77515
Oklahoma,2020/4/13,56.59364407,99,2,2069,98,Yes,No,77515
Oklahoma,2020/4/14,56.59364407,115,11,2184,109,Yes,No,77515
Oklahoma,2020/4/15,56.59364407,79,14,2263,123,Yes,No,66432
Oklahoma,2020/4/16,56.59364407,94,8,2357,131,Yes,No,66432
Oklahoma,2020/4/17,56.59364407,108,5,2465,136,Yes,No,66432
Oklahoma,2020/4/18,56.59364407,105,3,2570,139,Yes,No,66432
Oklahoma,2020/4/19,56.59364407,29,1,2599,140,Yes,No,66432
Oklahoma,2020/4/20,56.59364407,81,3,2680,143,Yes,No,66432
Oklahoma,2020/4/21,56.59364407,127,21,2807,164,Yes,No,66432
Oklahoma,2020/4/22,56.59364407,87,5,2894,169,Yes,No,74966
Oklahoma,2020/4/23,56.59364407,123,10,3017,179,Yes,No,74966
Oklahoma,2020/4/24,56.59364407,103,9,3120,188,Yes,No,74966
Oklahoma,2020/4/25,56.59364407,73,6,3193,194,Yes,No,74966
Oklahoma,2020/4/26,56.59364407,60,1,3253,195,Yes,No,74966
Oklahoma,2020/4/27,56.59364407,27,2,3280,197,Yes,No,74966
Oklahoma,2020/4/28,56.59364407,130,10,3410,207,Yes,No,74966
Oklahoma,2020/4/29,56.59364407,63,7,3473,214,Yes,No,28985
Oklahoma,2020/4/30,56.59364407,145,8,3618,222,Yes,No,28985
Oklahoma,2020/5/1,56.59364407,130,8,3748,230,Yes,No,28985
Oklahoma,2020/5/2,56.59364407,103,8,3851,238,Yes,No,28985
Oklahoma,2020/5/3,56.59364407,121,0,3972,238,Yes,No,28985
Oklahoma,2020/5/4,56.59364407,72,0,4044,238,Yes,No,28985
Oklahoma,2020/5/5,56.59364407,83,9,4127,247,Yes,No,28985
Oklahoma,2020/5/6,56.59364407,74,6,4201,253,Yes,No,26666
Oklahoma,2020/5/7,56.59364407,129,7,4330,260,No,No,26666
Oklahoma,2020/5/8,56.59364407,94,6,4424,266,No,No,26666
Oklahoma,2020/5/9,56.59364407,66,4,4490,270,No,No,26666
Oklahoma,2020/5/10,56.59364407,99,2,4589,272,No,No,26666
Oklahoma,2020/5/11,56.59364407,24,2,4613,274,No,No,26666
Oklahoma,2020/5/12,56.59364407,118,4,4731,278,No,No,26666
Oklahoma,2020/5/13,56.59364407,121,0,4852,278,No,No,25150
Oklahoma,2020/5/14,56.59364407,110,6,4962,284,No,No,25150
Oklahoma,2020/5/15,56.59364407,124,1,5086,285,No,No,25150
Oklahoma,2020/5/16,56.59364407,151,3,5237,288,No,No,25150
Oklahoma,2020/5/17,56.59364407,73,0,5310,288,No,No,25150
Oklahoma,2020/5/18,56.59364407,88,0,5398,288,No,No,25150
Oklahoma,2020/5/19,56.59364407,91,6,5489,294,No,No,25150
Oklahoma,2020/5/20,56.59364407,43,5,5532,299,No,No,27919
Oklahoma,2020/5/21,56.59364407,148,5,5680,304,No,No,27919
Oklahoma,2020/5/22,56.59364407,169,3,5849,307,No,No,27919
Oklahoma,2020/5/23,56.59364407,111,4,5960,311,No,No,27919
Oklahoma,2020/5/24,56.59364407,77,0,6037,311,No,No,27919
Oklahoma,2020/5/25,56.59364407,53,2,6090,313,No,No,27919
Oklahoma,2020/5/26,56.59364407,47,5,6137,318,No,No,27919
Oklahoma,2020/5/27,56.59364407,92,4,6229,322,No,No,21335
Oklahoma,2020/5/28,56.59364407,41,4,6270,326,No,No,21335
Oklahoma,2020/5/29,56.59364407,68,3,6338,329,No,No,21335
Oklahoma,2020/5/30,56.59364407,80,5,6418,334,No,No,21335
Oklahoma,2020/5/31,56.59364407,88,0,6506,334,No,No,21335
Oklahoma,2020/6/1,56.59364407,67,0,6573,334,No,No,21335
Oklahoma,2020/6/2,56.59364407,119,5,6692,339,No,No,21335
Oklahoma,2020/6/3,56.59364407,113,2,6805,341,No,No,19949
Oklahoma,2020/6/4,56.59364407,102,3,6907,344,No,No,19949
Oklahoma,2020/6/5,56.59364407,97,1,7004,345,No,No,19949
Oklahoma,2020/6/6,56.59364407,56,2,7060,347,No,No,19949
Oklahoma,2020/6/7,56.59364407,91,1,7151,348,No,No,19949
Oklahoma,2020/6/8,56.59364407,55,0,7206,348,No,No,19949
Oklahoma,2020/6/9,56.59364407,158,5,7364,353,No,No,19949
Oklahoma,2020/6/10,56.59364407,116,2,7480,355,No,No,18367
Oklahoma,2020/6/11,56.59364407,146,2,7626,357,No,No,18367
Oklahoma,2020/6/12,56.59364407,222,2,7848,359,No,No,18367
Oklahoma,2020/6/13,56.59364407,225,0,8073,359,No,No,18367
Oklahoma,2020/6/14,56.59364407,158,0,8231,359,No,No,18367
Oklahoma,2020/6/15,56.59364407,186,0,8417,359,No,No,18367
Oklahoma,2020/6/16,56.59364407,228,4,8645,363,No,No,18367
Oklahoma,2020/6/17,56.59364407,258,1,8903,364,No,No,18671
Oklahoma,2020/6/18,56.59364407,451,2,9354,366,No,No,18671
Oklahoma,2020/6/19,56.59364407,352,1,9706,367,No,No,18671
Oklahoma,2020/6/20,56.59364407,331,1,10037,368,No,No,18671
Oklahoma,2020/6/21,56.59364407,478,1,10515,369,No,No,18671
Oklahoma,2020/6/22,56.59364407,218,0,10733,369,No,No,18671
Oklahoma,2020/6/23,56.59364407,295,2,11028,371,No,No,18671
Oklahoma,2020/6/24,56.59364407,481,1,11509,372,No,No,18338
Oklahoma,2020/6/25,56.59364407,438,3,11947,375,No,No,18338
Oklahoma,2020/6/26,56.59364407,396,2,12343,377,No,No,18338
Oklahoma,2020/6/27,56.59364407,299,7,12642,384,No,No,18338
Oklahoma,2020/6/28,56.59364407,302,1,12944,385,No,No,18338
Oklahoma,2020/6/29,56.59364407,228,0,13172,385,No,No,18338
Oklahoma,2020/6/30,56.59364407,585,2,13757,387,No,No,18338
Oklahoma,2020/7/1,56.59364407,355,2,14112,389,No,No,19056
Oklahoma,2020/7/2,56.59364407,427,6,14539,395,No,No,19056
Oklahoma,2020/7/3,56.59364407,526,3,15065,398,No,No,19056
Oklahoma,2020/7/4,56.59364407,580,0,15645,398,No,No,19056
Oklahoma,2020/7/5,56.59364407,283,0,15928,398,No,No,19056
Oklahoma,2020/7/6,56.59364407,434,1,16362,399,No,No,19056
Oklahoma,2020/7/7,56.59364407,858,5,17220,404,No,No,19056
Oklahoma,2020/7/8,56.59364407,673,3,17893,407,No,No,20563
Oklahoma,2020/7/9,56.59364407,603,3,18496,410,No,No,20563
Oklahoma,2020/7/10,56.59364407,596,6,19092,416,No,No,20563
Oklahoma,2020/7/11,56.59364407,687,5,19779,421,No,No,20563
Oklahoma,2020/7/12,56.59364407,456,1,20235,422,No,No,20563
Oklahoma,2020/7/13,56.59364407,510,2,20745,424,No,No,20563
Oklahoma,2020/7/14,56.59364407,993,4,21738,428,No,No,20563
Oklahoma,2020/7/15,56.59364407,1075,4,22813,432,No,No,23676
Oklahoma,2020/7/16,56.59364407,628,6,23441,438,No,No,23676
Oklahoma,2020/7/17,56.59364407,699,7,24140,445,No,No,23676
Oklahoma,2020/7/18,56.59364407,916,6,25056,451,No,No,23676
Oklahoma,2020/7/19,56.59364407,209,0,25265,451,No,No,23676
Oklahoma,2020/7/20,56.59364407,168,1,25433,452,No,No,23676
Oklahoma,2020/7/21,56.59364407,893,9,26326,461,No,No,23676
Oklahoma,2020/7/22,56.59364407,975,13,27301,474,No,No,17437
Oklahoma,2020/7/23,56.59364407,668,3,27969,477,No,No,17437
Oklahoma,2020/7/24,56.59364407,1147,7,29116,484,No,No,17437
Oklahoma,2020/7/25,56.59364407,965,12,30081,496,No,No,17437
Oklahoma,2020/7/26,56.59364407,1204,0,31285,496,No,No,17437
Oklahoma,2020/7/27,56.59364407,1244,-1,32529,495,No,No,17437
Oklahoma,2020/7/28,56.59364407,1228,14,33757,509,No,No,17437
Oklahoma,2020/7/29,56.59364407,848,14,34605,523,No,No,11690
Oklahoma,2020/7/30,56.59364407,1105,13,35710,536,No,No,11690
Oklahoma,2020/7/31,56.59364407,746,5,36456,541,No,No,11690
Oklahoma,2020/8/1,56.59364407,1250,8,37706,549,No,No,11690
Oklahoma,2020/8/2,56.59364407,495,1,38201,550,No,No,11690
Oklahoma,2020/8/3,56.59364407,385,1,38586,551,No,No,11690
Oklahoma,2020/8/4,56.59364407,866,15,39452,566,No,No,11690
Oklahoma,2020/8/5,56.59364407,1103,17,40555,583,No,No,9467
Oklahoma,2020/8/6,56.59364407,840,10,41395,593,No,No,9467
Oklahoma,2020/8/7,56.59364407,839,7,42234,600,No,No,9467
Oklahoma,2020/8/8,56.59364407,836,3,43070,603,No,No,9467
Oklahoma,2020/8/9,56.59364407,491,0,43561,603,No,No,9467
Oklahoma,2020/8/10,56.59364407,401,2,43962,605,No,No,9467
Oklahoma,2020/8/11,56.59364407,763,13,44725,618,No,No,9467
Oklahoma,2020/8/12,56.59364407,667,9,45392,627,No,No,11047
Oklahoma,2020/8/13,56.59364407,709,11,46101,638,No,No,11047
Oklahoma,2020/8/14,56.59364407,792,6,46893,644,No,No,11047
Oklahoma,2020/8/15,56.59364407,905,13,47798,657,No,No,11047
Oklahoma,2020/8/16,56.59364407,544,4,48342,661,No,No,11047
Oklahoma,2020/8/17,56.59364407,369,4,48711,665,No,No,11047
Oklahoma,2020/8/18,56.59364407,615,17,49326,682,No,No,11047
Oklahoma,2020/8/19,56.59364407,597,17,49923,699,No,No,8676
Oklahoma,2020/8/20,56.59364407,746,10,50669,709,No,No,8676
Oklahoma,2020/8/21,56.59364407,1077,6,51746,715,No,No,8676
Oklahoma,2020/8/22,56.59364407,853,10,52599,725,No,No,8676
Oklahoma,2020/8/23,56.59364407,566,1,53165,726,No,No,8676
Oklahoma,2020/8/24,56.59364407,357,4,53522,730,No,No,8676
Oklahoma,2020/8/25,56.59364407,650,14,54172,744,No,No,8676
Oklahoma,2020/8/26,56.59364407,666,19,54838,763,No,No,8511
Oklahoma,2020/8/27,56.59364407,712,15,55550,778,No,No,8511
Oklahoma,2020/8/28,56.59364407,710,8,56260,786,No,No,8511
Oklahoma,2020/8/29,56.59364407,1093,11,57353,797,No,No,8511
Oklahoma,2020/8/30,56.59364407,667,2,58020,799,No,No,8511
Oklahoma,2020/8/31,56.59364407,713,1,58733,800,No,No,8511
Oklahoma,2020/9/1,56.59364407,666,9,59399,809,No,No,8511
Oklahoma,2020/9/2,56.59364407,719,12,60118,821,No,No,8901
Oklahoma,2020/9/3,56.59364407,909,14,61027,835,No,No,8901
Oklahoma,2020/9/4,56.59364407,1013,11,62040,846,No,No,8901
Oklahoma,2020/9/5,56.59364407,1147,4,63187,850,No,No,8901
Oklahoma,2020/9/6,56.59364407,420,3,63607,853,No,No,8901
Oklahoma,2020/9/7,56.59364407,613,0,64220,853,No,No,8901
Oklahoma,2020/9/8,56.59364407,833,1,65053,854,No,No,8901
Oklahoma,2020/9/9,56.59364407,876,9,65929,863,No,No,8848
Oklahoma,2020/9/10,56.59364407,771,13,66700,876,No,No,8848
Oklahoma,2020/9/11,56.59364407,942,12,67642,888,No,No,8848
Oklahoma,2020/9/12,56.59364407,1017,11,68659,899,No,No,8848
Oklahoma,2020/9/13,56.59364407,695,6,69354,905,No,No,8848
Oklahoma,2020/9/14,56.59364407,869,0,70223,905,No,No,8848
Oklahoma,2020/9/15,56.59364407,1091,7,71314,912,No,No,8848
Oklahoma,2020/9/16,56.59364407,970,12,72284,924,No,No,8679
Oklahoma,2020/9/17,56.59364407,1034,6,73318,930,No,No,8679
Oklahoma,2020/9/18,56.59364407,1249,9,74567,939,No,No,8679
Oklahoma,2020/9/19,56.59364407,1237,4,75804,943,No,No,8679
Oklahoma,2020/9/20,56.59364407,1003,3,76807,946,No,No,8679
Oklahoma,2020/9/21,56.59364407,1101,2,77908,948,No,No,8679
Oklahoma,2020/9/22,56.59364407,1164,14,79072,962,No,No,8679
Oklahoma,2020/9/23,56.59364407,1089,8,80161,970,No,No,8805
Oklahoma,2020/9/24,56.59364407,1083,11,81244,981,No,No,8805
Oklahoma,2020/9/25,56.59364407,1276,12,82520,993,No,No,8805
Oklahoma,2020/9/26,56.59364407,990,11,83510,1004,No,No,8805
Oklahoma,2020/9/27,56.59364407,823,2,84333,1006,No,No,8805
Oklahoma,2020/9/28,56.59364407,861,1,85194,1007,No,No,8805
Oklahoma,2020/9/29,56.59364407,1025,11,86219,1018,No,No,8805
Oklahoma,2020/9/30,56.59364407,980,13,87199,1031,No,No,7732
Oklahoma,2020/10/1,56.59364407,1170,4,88369,1035,No,No,7732
Oklahoma,2020/10/2,56.59364407,1190,9,89559,1044,No,No,7732
Oklahoma,2020/10/3,56.59364407,1189,7,90748,1051,No,No,7732
Oklahoma,2020/10/4,56.59364407,569,1,91317,1052,No,No,7732
Oklahoma,2020/10/5,56.59364407,665,3,91982,1055,No,No,7732
Oklahoma,2020/10/6,56.59364407,1364,11,93346,1066,No,No,7732
Oklahoma,2020/10/7,56.59364407,1006,9,94352,1075,No,No,8581
Oklahoma,2020/10/8,56.59364407,1212,10,95564,1085,No,No,8581
Oklahoma,2020/10/9,56.59364407,1524,6,97088,1091,No,No,8581
Oklahoma,2020/10/10,56.59364407,1533,4,98621,1095,No,No,8581
Oklahoma,2020/10/11,56.59364407,766,3,99387,1098,No,No,8581
Oklahoma,2020/10/12,56.59364407,797,6,100184,1104,No,No,8581
Oklahoma,2020/10/13,56.59364407,1309,15,101493,1119,No,No,8581
Oklahoma,2020/10/14,56.59364407,1122,13,102615,1132,No,No,7964
Oklahoma,2020/10/15,56.59364407,1221,11,103836,1143,No,No,7964
Oklahoma,2020/10/16,56.59364407,1472,11,105308,1154,No,No,7964
Oklahoma,2020/10/17,56.59364407,1195,14,106503,1168,No,No,7964
Oklahoma,2020/10/18,56.59364407,796,3,107299,1171,No,No,7964
Oklahoma,2020/10/19,56.59364407,774,2,108073,1173,No,No,7964
Oklahoma,2020/10/20,56.59364407,1475,18,109548,1191,No,No,7964
Oklahoma,2020/10/21,56.59364407,1307,19,110855,1210,No,No,7126
Oklahoma,2020/10/22,56.59364407,1628,11,112483,1221,No,No,7126
Oklahoma,2020/10/23,56.59364407,1373,13,113856,1234,No,No,7126
Oklahoma,2020/10/24,56.59364407,1829,11,115685,1245,No,No,7126
Oklahoma,2020/10/25,56.59364407,1051,4,116736,1249,No,No,7126
Oklahoma,2020/10/26,56.59364407,663,2,117399,1251,No,No,7126
Oklahoma,2020/10/27,56.59364407,1010,22,118409,1273,No,No,7126
Oklahoma,2020/10/28,56.59364407,743,13,119152,1286,No,No,7060
Oklahoma,2020/10/29,56.59364407,1041,20,120193,1306,No,No,7060
Oklahoma,2020/10/30,56.59364407,1302,20,121495,1326,No,No,7060
Oklahoma,2020/10/31,56.59364407,1267,11,122762,1337,No,No,7060
Oklahoma,2020/11/1,56.59364407,1349,8,124111,1345,No,No,7060
Oklahoma,2020/11/2,56.59364407,1084,9,125195,1354,No,No,7060
Oklahoma,2020/11/3,56.59364407,1331,21,126526,1375,No,No,7060
Oklahoma,2020/11/4,56.59364407,1246,17,127772,1392,No,No,8764
Oklahoma,2020/11/5,56.59364407,2101,21,129873,1413,No,No,8764
Oklahoma,2020/11/6,56.59364407,1878,16,131751,1429,No,No,8764
Oklahoma,2020/11/7,56.59364407,4507,9,136258,1438,No,No,8764
Oklahoma,2020/11/8,56.59364407,0,0,136258,1438,No,No,8764
Oklahoma,2020/11/9,56.59364407,2197,6,138455,1444,No,No,8764
Oklahoma,2020/11/10,56.59364407,1702,7,140157,1451,No,No,8764
Oklahoma,2020/11/11,56.59364407,2177,19,142334,1470,No,No,9262
Oklahoma,2020/11/12,56.59364407,2357,11,144691,1481,No,Yes,9262
Oklahoma,2020/11/13,56.59364407,2667,12,147358,1493,No,Yes,9262
Oklahoma,2020/11/14,56.59364407,2847,23,150205,1516,No,Yes,9262
Oklahoma,2020/11/15,56.59364407,3923,12,154128,1528,No,Yes,9262
Oklahoma,2020/11/16,56.59364407,2729,10,156857,1538,No,Yes,9262
Oklahoma,2020/11/17,56.59364407,1551,6,158408,1544,No,Yes,9262
Oklahoma,2020/11/18,56.59364407,3017,26,161425,1570,No,Yes,11813
Oklahoma,2020/11/19,56.59364407,2915,18,164340,1588,No,Yes,11813
Oklahoma,2020/11/20,56.59364407,2921,15,167261,1603,No,Yes,11813
Oklahoma,2020/11/21,56.59364407,3663,21,170924,1624,No,Yes,11813
Oklahoma,2020/11/22,56.59364407,3406,10,174330,1634,No,Yes,11813
Oklahoma,2020/11/23,56.59364407,3544,15,177874,1649,No,Yes,11813
Oklahoma,2020/11/24,56.59364407,2736,15,180610,1664,No,Yes,11813
Oklahoma,2020/11/25,56.59364407,3732,16,184342,1680,No,Yes,7061
Oklahoma,2020/11/26,56.59364407,0,0,184342,1680,No,Yes,7061
Oklahoma,2020/11/27,56.59364407,3225,24,187567,1704,No,Yes,7061
Oklahoma,2020/11/28,56.59364407,6257,13,193824,1717,No,Yes,7061
Oklahoma,2020/11/29,56.59364407,1721,19,195545,1736,No,Yes,7061
Oklahoma,2020/11/30,56.59364407,2200,7,197745,1743,No,Yes,7061
Oklahoma,2020/12/1,56.59364407,1737,15,199482,1758,No,Yes,7061
Oklahoma,2020/12/2,56.59364407,2859,54,202341,1812,No,Yes,7656
Oklahoma,2020/12/3,56.59364407,1707,24,204048,1836,No,Yes,7656
Oklahoma,2020/12/4,56.59364407,4827,24,208875,1860,No,Yes,7656
Oklahoma,2020/12/5,56.59364407,4370,14,213245,1874,No,Yes,7656
Oklahoma,2020/12/6,56.59364407,3241,22,216486,1896,No,Yes,7656
Oklahoma,2020/12/7,56.59364407,1903,15,218389,1911,No,Yes,7656
Oklahoma,2020/12/8,56.59364407,2297,11,220686,1922,No,Yes,7656
Oklahoma,2020/12/9,56.59364407,2307,23,222993,1945,No,Yes,7568
Oklahoma,2020/12/10,56.59364407,2460,35,225453,1980,No,Yes,7568
Oklahoma,2020/12/11,56.59364407,3900,27,229353,2007,No,Yes,7568
Oklahoma,2020/12/12,56.59364407,3983,35,233336,2042,No,Yes,7568
Oklahoma,2020/12/13,56.59364407,4332,22,237668,2064,No,Yes,7568
Oklahoma,2020/12/14,56.59364407,2099,8,239767,2072,No,Yes,7568
Oklahoma,2020/12/15,56.59364407,2224,14,241991,2086,No,Yes,7568
Oklahoma,2020/12/16,56.59364407,3238,42,245229,2128,No,Yes,7543
Oklahoma,2020/12/17,56.59364407,2975,16,248204,2144,No,Yes,7543
Oklahoma,2020/12/18,56.59364407,3556,17,251760,2161,No,Yes,7543
Oklahoma,2020/12/19,56.59364407,4108,28,255868,2189,No,Yes,7543
Oklahoma,2020/12/20,56.59364407,4970,23,260838,2212,No,Yes,7543
Oklahoma,2020/12/21,56.59364407,2596,6,263434,2218,No,Yes,7543
Oklahoma,2020/12/22,56.59364407,2186,22,265620,2240,No,Yes,7543
Oklahoma,2020/12/23,56.59364407,3656,43,269276,2283,No,Yes,5506
Oklahoma,2020/12/24,56.59364407,3277,45,272553,2328,No,Yes,5506
Oklahoma,2020/12/25,56.59364407,0,0,272553,2328,No,Yes,5506
Oklahoma,2020/12/26,56.59364407,3955,29,276508,2357,No,Yes,5506
Oklahoma,2020/12/27,56.59364407,2631,13,279139,2370,No,Yes,5506
Oklahoma,2020/12/28,56.59364407,3448,13,282587,2383,No,Yes,5506
Oklahoma,2020/12/29,56.59364407,1194,22,283781,2405,No,Yes,5506
Oklahoma,2020/12/30,56.59364407,3249,48,287030,2453,No,Yes,10986
Oklahoma,2020/12/31,56.59364407,3906,36,290936,2489,No,Yes,10986
Oklahoma,2021/1/1,56.59364407,0,0,290936,2489,No,Yes,10986
Oklahoma,2021/1/2,56.59364407,5119,38,296055,2527,No,Yes,10986
Oklahoma,2021/1/3,56.59364407,8017,20,304072,2547,No,Yes,10986
Oklahoma,2021/1/4,56.59364407,2699,5,306771,2552,No,Yes,10986
Oklahoma,2021/1/5,56.59364407,1497,19,308268,2571,No,Yes,10986
Oklahoma,2021/1/6,56.59364407,3305,62,311573,2633,No,Yes,14084
Oklahoma,2021/1/7,56.59364407,3781,39,315354,2672,No,Yes,14084
Oklahoma,2021/1/8,56.59364407,5232,31,320586,2703,No,Yes,14084
Oklahoma,2021/1/9,56.59364407,4289,35,324875,2738,No,Yes,14084
Oklahoma,2021/1/10,56.59364407,6487,23,331362,2761,No,Yes,14084
Oklahoma,2021/1/11,56.59364407,3885,14,335247,2775,No,Yes,14084
Oklahoma,2021/1/12,56.59364407,2210,29,337457,2804,No,Yes,14084
Oklahoma,2021/1/13,56.59364407,3907,44,341364,2848,No,Yes,11980
Oklahoma,2021/1/14,56.59364407,3142,34,344506,2882,No,Yes,11980
Oklahoma,2021/1/15,56.59364407,3538,43,348044,2925,No,Yes,11980
Oklahoma,2021/1/16,56.59364407,3621,27,351665,2952,No,Yes,11980
Oklahoma,2021/1/17,56.59364407,3314,35,354979,2987,No,Yes,11980
Oklahoma,2021/1/18,56.59364407,1837,7,356816,2994,No,Yes,11980
Oklahoma,2021/1/19,56.59364407,1558,43,358374,3037,No,Yes,11980
Oklahoma,2021/1/20,56.59364407,1986,48,360360,3085,No,Yes,11615
Oklahoma,2021/1/21,56.59364407,2686,55,363046,3140,No,Yes,11615
Oklahoma,2021/1/22,56.59364407,2946,47,365992,3187,No,Yes,11615
Oklahoma,2021/1/23,56.59364407,4157,44,370149,3231,No,Yes,11615
Oklahoma,2021/1/24,56.59364407,2941,48,373090,3279,No,Yes,11615
Oklahoma,2021/1/25,56.59364407,1763,14,374853,3293,No,Yes,11615
Oklahoma,2021/1/26,56.59364407,1571,30,376424,3323,No,Yes,11615
Oklahoma,2021/1/27,56.59364407,2686,65,379110,3388,No,Yes,12664
Oklahoma,2021/1/28,56.59364407,2320,35,381430,3423,No,Yes,12664
Oklahoma,2021/1/29,56.59364407,2787,48,384217,3471,No,Yes,12664
Oklahoma,2021/1/30,56.59364407,2373,33,386590,3504,No,Yes,12664
Oklahoma,2021/1/31,56.59364407,2882,43,389472,3547,No,Yes,12664
Oklahoma,2021/2/1,56.59364407,1396,17,390868,3564,No,Yes,12664
Oklahoma,2021/2/2,56.59364407,1296,38,392164,3602,No,Yes,12664
Oklahoma,2021/2/3,56.59364407,2119,52,394283,3654,No,Yes,13464
Oklahoma,2021/2/4,56.59364407,2782,27,397065,3681,No,Yes,13464
Oklahoma,2021/2/5,56.59364407,2662,29,399727,3710,No,Yes,13464
Oklahoma,2021/2/6,56.59364407,2053,51,401780,3761,No,Yes,13464
Oklahoma,2021/2/7,56.59364407,2174,52,403954,3813,No,Yes,13464
Oklahoma,2021/2/8,56.59364407,1040,4,404994,3817,No,Yes,13464
Oklahoma,2021/2/9,56.59364407,1070,53,406064,3870,No,Yes,13464
Oklahoma,2021/2/10,56.59364407,1660,30,407724,3900,No,Yes,12087
Oklahoma,2021/2/11,56.59364407,1677,48,409401,3948,No,Yes,12087
Oklahoma,2021/2/12,56.59364407,1417,11,410818,3959,No,Yes,12087
Oklahoma,2021/2/13,56.59364407,1458,35,412276,3994,No,Yes,12087
Oklahoma,2021/2/14,56.59364407,1266,30,413542,4024,No,Yes,12087
Oklahoma,2021/2/15,56.59364407,730,17,414272,4041,No,Yes,12087
Oklahoma,2021/2/16,56.59364407,508,20,414780,4061,No,Yes,12087
Oklahoma,2021/2/17,56.59364407,1078,28,415858,4089,No,Yes,11395
Oklahoma,2021/2/18,56.59364407,618,23,416476,4112,No,Yes,11395
Oklahoma,2021/2/19,56.59364407,869,20,417345,4132,No,Yes,11395
Oklahoma,2021/2/20,56.59364407,973,23,418318,4155,No,Yes,11395
Oklahoma,2021/2/21,56.59364407,1036,26,419354,4181,No,Yes,11395
Oklahoma,2021/2/22,56.59364407,499,22,419853,4203,No,Yes,11395
Oklahoma,2021/2/23,56.59364407,359,24,420212,4227,No,Yes,11395
Oklahoma,2021/2/24,56.59364407,798,37,421010,4264,No,Yes,11395
Oklahoma,2021/2/25,56.59364407,1146,38,422156,4302,No,Yes,11395
Oklahoma,2021/2/26,56.59364407,867,18,423023,4320,No,Yes,11395
Oklahoma,2021/2/27,56.59364407,779,59,423802,4379,No,Yes,11395
Oklahoma,2021/2/28,56.59364407,706,49,424508,4428,No,Yes,11395
Oklahoma,2021/3/1,56.59364407,380,50,424888,4478,No,Yes,11395
Oklahoma,2021/3/2,56.59364407,111,56,424999,4534,No,Yes,11395
Oklahoma,2021/3/3,56.59364407,747,0,425746,4534,No,Yes,11395
Oklahoma,2021/3/4,56.59364407,895,0,426641,4534,No,Yes,11395
Oregon,2020/3/1,43.49034347,2,0,2,0,No,No,1575
Oregon,2020/3/2,43.49034347,0,0,2,0,No,No,1575
Oregon,2020/3/3,43.49034347,0,0,2,0,No,No,1575
Oregon,2020/3/4,43.49034347,0,0,2,0,No,No,1663
Oregon,2020/3/5,43.49034347,0,0,2,0,No,No,1663
Oregon,2020/3/6,43.49034347,0,0,2,0,No,No,1663
Oregon,2020/3/7,43.49034347,4,0,6,0,No,No,1663
Oregon,2020/3/8,43.49034347,7,0,13,0,No,No,1663
Oregon,2020/3/9,43.49034347,0,0,13,0,No,No,1663
Oregon,2020/3/10,43.49034347,1,0,14,0,No,No,1663
Oregon,2020/3/11,43.49034347,6,0,20,0,No,No,1819
Oregon,2020/3/12,43.49034347,10,0,30,0,No,No,1819
Oregon,2020/3/13,43.49034347,0,0,30,0,No,No,1819
Oregon,2020/3/14,43.49034347,6,1,36,1,No,No,1819
Oregon,2020/3/15,43.49034347,3,0,39,1,No,No,1819
Oregon,2020/3/16,43.49034347,7,0,46,1,No,No,1819
Oregon,2020/3/17,43.49034347,20,1,66,2,No,No,1819
Oregon,2020/3/18,43.49034347,8,1,74,3,No,No,10892
Oregon,2020/3/19,43.49034347,13,0,87,3,No,No,10892
Oregon,2020/3/20,43.49034347,27,0,114,3,No,No,10892
Oregon,2020/3/21,43.49034347,23,1,137,4,No,No,10892
Oregon,2020/3/22,43.49034347,24,1,161,5,No,No,10892
Oregon,2020/3/23,43.49034347,30,0,191,5,Yes,No,10892
Oregon,2020/3/24,43.49034347,18,3,209,8,Yes,No,10892
Oregon,2020/3/25,43.49034347,57,2,266,10,Yes,No,80984
Oregon,2020/3/26,43.49034347,50,1,316,11,Yes,No,80984
Oregon,2020/3/27,43.49034347,99,1,415,12,Yes,No,80984
Oregon,2020/3/28,43.49034347,65,1,480,13,Yes,No,80984
Oregon,2020/3/29,43.49034347,69,0,549,13,Yes,No,80984
Oregon,2020/3/30,43.49034347,58,3,607,16,Yes,No,80984
Oregon,2020/3/31,43.49034347,83,2,690,18,Yes,No,80984
Oregon,2020/4/1,43.49034347,47,1,737,19,Yes,No,106739
Oregon,2020/4/2,43.49034347,90,2,827,21,Yes,No,106739
Oregon,2020/4/3,43.49034347,72,1,899,22,Yes,No,106739
Oregon,2020/4/4,43.49034347,101,4,1000,26,Yes,No,106739
Oregon,2020/4/5,43.49034347,68,1,1068,27,Yes,No,106739
Oregon,2020/4/6,43.49034347,64,2,1132,29,Yes,No,106739
Oregon,2020/4/7,43.49034347,49,4,1181,33,Yes,No,106739
Oregon,2020/4/8,43.49034347,58,5,1239,38,Yes,No,77515
Oregon,2020/4/9,43.49034347,82,6,1321,44,Yes,No,77515
Oregon,2020/4/10,43.49034347,50,4,1371,48,Yes,No,77515
Oregon,2020/4/11,43.49034347,76,3,1447,51,Yes,No,77515
Oregon,2020/4/12,43.49034347,80,1,1527,52,Yes,No,77515
Oregon,2020/4/13,43.49034347,57,1,1584,53,Yes,No,77515
Oregon,2020/4/14,43.49034347,49,2,1633,55,Yes,No,77515
Oregon,2020/4/15,43.49034347,30,3,1663,58,Yes,No,66432
Oregon,2020/4/16,43.49034347,73,6,1736,64,Yes,No,66432
Oregon,2020/4/17,43.49034347,49,6,1785,70,Yes,No,66432
Oregon,2020/4/18,43.49034347,59,2,1844,72,Yes,No,66432
Oregon,2020/4/19,43.49034347,66,2,1910,74,Yes,No,66432
Oregon,2020/4/20,43.49034347,46,1,1956,75,Yes,No,66432
Oregon,2020/4/21,43.49034347,46,3,2002,78,Yes,No,66432
Oregon,2020/4/22,43.49034347,57,0,2059,78,Yes,No,74966
Oregon,2020/4/23,43.49034347,68,5,2127,83,Yes,No,74966
Oregon,2020/4/24,43.49034347,50,3,2177,86,Yes,No,74966
Oregon,2020/4/25,43.49034347,76,1,2253,87,Yes,No,74966
Oregon,2020/4/26,43.49034347,58,4,2311,91,Yes,No,74966
Oregon,2020/4/27,43.49034347,43,1,2354,92,Yes,No,74966
Oregon,2020/4/28,43.49034347,31,7,2385,99,Yes,No,74966
Oregon,2020/4/29,43.49034347,61,2,2446,101,Yes,No,28985
Oregon,2020/4/30,43.49034347,64,2,2510,103,Yes,No,28985
Oregon,2020/5/1,43.49034347,69,1,2579,104,Yes,No,28985
Oregon,2020/5/2,43.49034347,56,5,2635,109,Yes,No,28985
Oregon,2020/5/3,43.49034347,45,0,2680,109,Yes,No,28985
Oregon,2020/5/4,43.49034347,79,0,2759,109,Yes,No,28985
Oregon,2020/5/5,43.49034347,80,4,2839,113,Yes,No,28985
Oregon,2020/5/6,43.49034347,77,2,2916,115,Yes,No,26666
Oregon,2020/5/7,43.49034347,73,6,2989,121,Yes,No,26666
Oregon,2020/5/8,43.49034347,79,3,3068,124,Yes,No,26666
Oregon,2020/5/9,43.49034347,92,3,3160,127,Yes,No,26666
Oregon,2020/5/10,43.49034347,68,0,3228,127,Yes,No,26666
Oregon,2020/5/11,43.49034347,58,3,3286,130,Yes,No,26666
Oregon,2020/5/12,43.49034347,73,0,3359,130,Yes,No,26666
Oregon,2020/5/13,43.49034347,57,4,3416,134,Yes,No,25150
Oregon,2020/5/14,43.49034347,63,3,3479,137,Yes,No,25150
Oregon,2020/5/15,43.49034347,62,0,3541,137,Yes,No,25150
Oregon,2020/5/16,43.49034347,71,0,3612,137,Yes,No,25150
Oregon,2020/5/17,43.49034347,11,0,3623,137,Yes,No,25150
Oregon,2020/5/18,43.49034347,64,1,3687,138,Yes,No,25150
Oregon,2020/5/19,43.49034347,39,2,3726,140,Yes,No,25150
Oregon,2020/5/20,43.49034347,75,4,3801,144,Yes,No,27919
Oregon,2020/5/21,43.49034347,16,1,3817,145,Yes,No,27919
Oregon,2020/5/22,43.49034347,47,2,3864,147,Yes,No,27919
Oregon,2020/5/23,43.49034347,24,0,3888,147,Yes,No,27919
Oregon,2020/5/24,43.49034347,39,1,3927,148,Yes,No,27919
Oregon,2020/5/25,43.49034347,22,0,3949,148,Yes,No,27919
Oregon,2020/5/26,43.49034347,19,0,3968,148,Yes,No,27919
Oregon,2020/5/27,43.49034347,73,0,4041,148,Yes,No,21335
Oregon,2020/5/28,43.49034347,46,3,4087,151,Yes,No,21335
Oregon,2020/5/29,43.49034347,46,0,4133,151,Yes,No,21335
Oregon,2020/5/30,43.49034347,52,2,4185,153,Yes,No,21335
Oregon,2020/5/31,43.49034347,58,0,4243,153,Yes,No,21335
Oregon,2020/6/1,43.49034347,60,1,4303,154,Yes,No,21335
Oregon,2020/6/2,43.49034347,35,3,4338,157,Yes,No,21335
Oregon,2020/6/3,43.49034347,61,2,4399,159,Yes,No,19949
Oregon,2020/6/4,43.49034347,76,0,4475,159,Yes,No,19949
Oregon,2020/6/5,43.49034347,110,2,4585,161,Yes,No,19949
Oregon,2020/6/6,43.49034347,87,2,4672,163,Yes,No,19949
Oregon,2020/6/7,43.49034347,137,1,4809,164,Yes,No,19949
Oregon,2020/6/8,43.49034347,118,0,4927,164,Yes,No,19949
Oregon,2020/6/9,43.49034347,100,5,5027,169,Yes,No,19949
Oregon,2020/6/10,43.49034347,72,0,5099,169,Yes,No,18367
Oregon,2020/6/11,43.49034347,153,2,5252,171,Yes,No,18367
Oregon,2020/6/12,43.49034347,136,3,5388,174,Yes,No,18367
Oregon,2020/6/13,43.49034347,155,1,5543,175,Yes,No,18367
Oregon,2020/6/14,43.49034347,101,1,5644,176,Yes,No,18367
Oregon,2020/6/15,43.49034347,187,4,5831,180,Yes,No,18367
Oregon,2020/6/16,43.49034347,280,2,6111,182,Yes,No,18367
Oregon,2020/6/17,43.49034347,124,1,6235,183,Yes,No,18671
Oregon,2020/6/18,43.49034347,155,4,6390,187,Yes,No,18671
Oregon,2020/6/19,43.49034347,202,1,6592,188,Yes,No,18671
Oregon,2020/6/20,43.49034347,90,0,6682,188,No,No,18671
Oregon,2020/6/21,43.49034347,263,2,6945,190,No,No,18671
Oregon,2020/6/22,43.49034347,170,2,7115,192,No,No,18671
Oregon,2020/6/23,43.49034347,202,0,7317,192,No,No,18671
Oregon,2020/6/24,43.49034347,145,3,7462,195,No,No,18338
Oregon,2020/6/25,43.49034347,143,4,7605,199,No,No,18338
Oregon,2020/6/26,43.49034347,403,5,8008,204,No,No,18338
Oregon,2020/6/27,43.49034347,102,0,8110,204,No,No,18338
Oregon,2020/6/28,43.49034347,238,0,8348,204,No,No,18338
Oregon,2020/6/29,43.49034347,161,3,8509,207,No,No,18338
Oregon,2020/6/30,43.49034347,186,3,8695,210,No,No,18338
Oregon,2020/7/1,43.49034347,324,1,9019,211,No,No,19056
Oregon,2020/7/2,43.49034347,325,1,9344,212,No,No,19056
Oregon,2020/7/3,43.49034347,299,3,9643,215,No,No,19056
Oregon,2020/7/4,43.49034347,294,1,9937,216,No,No,19056
Oregon,2020/7/5,43.49034347,300,2,10237,218,No,No,19056
Oregon,2020/7/6,43.49034347,176,0,10413,218,No,No,19056
Oregon,2020/7/7,43.49034347,241,6,10654,224,No,No,19056
Oregon,2020/7/8,43.49034347,218,4,10872,228,No,No,20563
Oregon,2020/7/9,43.49034347,375,5,11247,233,No,No,20563
Oregon,2020/7/10,43.49034347,254,2,11501,235,No,No,20563
Oregon,2020/7/11,43.49034347,350,0,11851,235,No,No,20563
Oregon,2020/7/12,43.49034347,319,2,12170,237,No,No,20563
Oregon,2020/7/13,43.49034347,341,3,12511,240,No,No,20563
Oregon,2020/7/14,43.49034347,323,7,12834,247,No,No,20563
Oregon,2020/7/15,43.49034347,295,2,13129,249,No,Yes,23676
Oregon,2020/7/16,43.49034347,412,3,13541,252,No,Yes,23676
Oregon,2020/7/17,43.49034347,301,4,13842,256,No,Yes,23676
Oregon,2020/7/18,43.49034347,389,3,14231,259,No,Yes,23676
Oregon,2020/7/19,43.49034347,355,3,14586,262,No,Yes,23676
Oregon,2020/7/20,43.49034347,321,2,14907,264,No,Yes,23676
Oregon,2020/7/21,43.49034347,350,8,15257,272,No,Yes,23676
Oregon,2020/7/22,43.49034347,179,2,15436,274,No,Yes,17437
Oregon,2020/7/23,43.49034347,329,3,15765,277,No,Yes,17437
Oregon,2020/7/24,43.49034347,407,8,16172,285,No,Yes,17437
Oregon,2020/7/25,43.49034347,320,1,16492,286,No,Yes,17437
Oregon,2020/7/26,43.49034347,272,5,16764,291,No,Yes,17437
Oregon,2020/7/27,43.49034347,358,-2,17122,289,No,Yes,17437
Oregon,2020/7/28,43.49034347,297,16,17419,305,No,Yes,17437
Oregon,2020/7/29,43.49034347,386,8,17805,313,No,Yes,11690
Oregon,2020/7/30,43.49034347,361,5,18166,318,No,Yes,11690
Oregon,2020/7/31,43.49034347,344,7,18510,325,No,Yes,11690
Oregon,2020/8/1,43.49034347,307,4,18817,329,No,Yes,11690
Oregon,2020/8/2,43.49034347,280,2,19097,331,No,Yes,11690
Oregon,2020/8/3,43.49034347,298,3,19395,334,No,Yes,11690
Oregon,2020/8/4,43.49034347,305,2,19700,336,No,Yes,11690
Oregon,2020/8/5,43.49034347,279,6,19979,342,No,Yes,9467
Oregon,2020/8/6,43.49034347,271,1,20250,343,No,Yes,9467
Oregon,2020/8/7,43.49034347,408,8,20658,351,No,Yes,9467
Oregon,2020/8/8,43.49034347,353,7,21011,358,No,Yes,9467
Oregon,2020/8/9,43.49034347,261,1,21272,359,No,Yes,9467
Oregon,2020/8/10,43.49034347,216,3,21488,362,No,Yes,9467
Oregon,2020/8/11,43.49034347,294,10,21782,372,No,Yes,9467
Oregon,2020/8/12,43.49034347,247,6,22029,378,No,Yes,11047
Oregon,2020/8/13,43.49034347,286,9,22315,387,No,Yes,11047
Oregon,2020/8/14,43.49034347,299,1,22614,388,No,Yes,11047
Oregon,2020/8/15,43.49034347,404,1,23018,389,No,Yes,11047
Oregon,2020/8/16,43.49034347,244,-1,23262,388,No,Yes,11047
Oregon,2020/8/17,43.49034347,199,3,23461,391,No,Yes,11047
Oregon,2020/8/18,43.49034347,224,8,23685,399,No,Yes,11047
Oregon,2020/8/19,43.49034347,202,9,23887,408,No,Yes,8676
Oregon,2020/8/20,43.49034347,289,4,24176,412,No,Yes,8676
Oregon,2020/8/21,43.49034347,259,9,24435,421,No,Yes,8676
Oregon,2020/8/22,43.49034347,276,1,24711,422,No,Yes,8676
Oregon,2020/8/23,43.49034347,227,0,24938,422,No,Yes,8676
Oregon,2020/8/24,43.49034347,236,10,25174,432,No,Yes,8676
Oregon,2020/8/25,43.49034347,234,4,25408,436,No,Yes,8676
Oregon,2020/8/26,43.49034347,167,2,25575,438,No,Yes,8511
Oregon,2020/8/27,43.49034347,200,6,25775,444,No,Yes,8511
Oregon,2020/8/28,43.49034347,294,13,26069,457,No,Yes,8511
Oregon,2020/8/29,43.49034347,224,3,26293,460,No,Yes,8511
Oregon,2020/8/30,43.49034347,261,3,26554,463,No,Yes,8511
Oregon,2020/8/31,43.49034347,169,4,26723,467,No,Yes,8511
Oregon,2020/9/1,43.49034347,235,0,26958,467,No,Yes,8511
Oregon,2020/9/2,43.49034347,127,6,27085,473,No,Yes,8901
Oregon,2020/9/3,43.49034347,271,2,27356,475,No,Yes,8901
Oregon,2020/9/4,43.49034347,249,6,27605,481,No,Yes,8901
Oregon,2020/9/5,43.49034347,252,1,27857,482,No,Yes,8901
Oregon,2020/9/6,43.49034347,188,1,28045,483,No,Yes,8901
Oregon,2020/9/7,43.49034347,146,4,28191,487,No,Yes,8901
Oregon,2020/9/8,43.49034347,164,5,28355,492,No,Yes,8901
Oregon,2020/9/9,43.49034347,119,7,28474,499,No,Yes,8848
Oregon,2020/9/10,43.49034347,187,2,28661,501,No,Yes,8848
Oregon,2020/9/11,43.49034347,227,-1,28888,500,No,Yes,8848
Oregon,2020/9/12,43.49034347,268,5,29156,505,No,Yes,8848
Oregon,2020/9/13,43.49034347,181,4,29337,509,No,Yes,8848
Oregon,2020/9/14,43.49034347,151,2,29488,511,No,Yes,8848
Oregon,2020/9/15,43.49034347,176,8,29664,519,No,Yes,8848
Oregon,2020/9/16,43.49034347,192,2,29856,521,No,Yes,8679
Oregon,2020/9/17,43.49034347,212,0,30068,521,No,Yes,8679
Oregon,2020/9/18,43.49034347,283,3,30351,524,No,Yes,8679
Oregon,2020/9/19,43.49034347,249,3,30600,527,No,Yes,8679
Oregon,2020/9/20,43.49034347,202,1,30802,528,No,Yes,8679
Oregon,2020/9/21,43.49034347,197,4,30999,532,No,Yes,8679
Oregon,2020/9/22,43.49034347,324,3,31323,535,No,Yes,8679
Oregon,2020/9/23,43.49034347,190,3,31513,538,No,Yes,8805
Oregon,2020/9/24,43.49034347,356,2,31869,540,No,Yes,8805
Oregon,2020/9/25,43.49034347,459,5,32328,545,No,Yes,8805
Oregon,2020/9/26,43.49034347,253,4,32581,549,No,Yes,8805
Oregon,2020/9/27,43.49034347,239,0,32820,549,No,Yes,8805
Oregon,2020/9/28,43.49034347,175,0,32995,549,No,Yes,8805
Oregon,2020/9/29,43.49034347,302,6,33297,555,No,Yes,8805
Oregon,2020/9/30,43.49034347,257,5,33554,560,No,Yes,7732
Oregon,2020/10/1,43.49034347,311,1,33865,561,No,Yes,7732
Oregon,2020/10/2,43.49034347,315,5,34180,566,No,Yes,7732
Oregon,2020/10/3,43.49034347,332,6,34512,572,No,Yes,7732
Oregon,2020/10/4,43.49034347,259,1,34771,573,No,Yes,7732
Oregon,2020/10/5,43.49034347,285,1,35056,574,No,Yes,7732
Oregon,2020/10/6,43.49034347,291,7,35347,581,No,Yes,7732
Oregon,2020/10/7,43.49034347,299,4,35646,585,No,Yes,8581
Oregon,2020/10/8,43.49034347,475,11,36121,596,No,Yes,8581
Oregon,2020/10/9,43.49034347,417,4,36538,600,No,Yes,8581
Oregon,2020/10/10,43.49034347,387,0,36925,600,No,Yes,8581
Oregon,2020/10/11,43.49034347,338,0,37263,600,No,Yes,8581
Oregon,2020/10/12,43.49034347,209,0,37472,600,No,Yes,8581
Oregon,2020/10/13,43.49034347,316,5,37788,605,No,Yes,8581
Oregon,2020/10/14,43.49034347,387,4,38175,609,No,Yes,7964
Oregon,2020/10/15,43.49034347,361,4,38536,613,No,Yes,7964
Oregon,2020/10/16,43.49034347,411,7,38947,620,No,Yes,7964
Oregon,2020/10/17,43.49034347,369,2,39316,622,No,Yes,7964
Oregon,2020/10/18,43.49034347,216,0,39532,622,No,Yes,7964
Oregon,2020/10/19,43.49034347,267,8,39799,630,No,Yes,7964
Oregon,2020/10/20,43.49034347,350,6,40149,636,No,Yes,7964
Oregon,2020/10/21,43.49034347,309,2,40458,638,No,Yes,7126
Oregon,2020/10/22,43.49034347,367,9,40825,647,No,Yes,7126
Oregon,2020/10/23,43.49034347,532,4,41357,651,No,Yes,7126
Oregon,2020/10/24,43.49034347,382,3,41739,654,No,Yes,7126
Oregon,2020/10/25,43.49034347,362,0,42101,654,No,Yes,7126
Oregon,2020/10/26,43.49034347,353,3,42454,657,No,Yes,7126
Oregon,2020/10/27,43.49034347,367,8,42821,665,No,Yes,7126
Oregon,2020/10/28,43.49034347,407,8,43228,673,No,Yes,7060
Oregon,2020/10/29,43.49034347,565,1,43793,674,No,Yes,7060
Oregon,2020/10/30,43.49034347,595,3,44388,677,No,Yes,7060
Oregon,2020/10/31,43.49034347,535,13,44923,690,No,Yes,7060
Oregon,2020/11/1,43.49034347,496,1,45419,691,No,Yes,7060
Oregon,2020/11/2,43.49034347,559,3,45978,694,No,Yes,7060
Oregon,2020/11/3,43.49034347,482,7,46460,701,No,Yes,7060
Oregon,2020/11/4,43.49034347,589,6,47049,707,No,Yes,8764
Oregon,2020/11/5,43.49034347,790,3,47839,710,No,Yes,8764
Oregon,2020/11/6,43.49034347,769,6,48608,716,No,Yes,8764
Oregon,2020/11/7,43.49034347,979,13,49587,729,No,Yes,8764
Oregon,2020/11/8,43.49034347,861,1,50448,730,No,Yes,8764
Oregon,2020/11/9,43.49034347,707,8,51155,738,No,Yes,8764
Oregon,2020/11/10,43.49034347,754,3,51909,741,No,Yes,8764
Oregon,2020/11/11,43.49034347,861,5,52770,746,No,Yes,9262
Oregon,2020/11/12,43.49034347,1109,2,53879,748,No,Yes,9262
Oregon,2020/11/13,43.49034347,1058,11,54937,759,No,Yes,9262
Oregon,2020/11/14,43.49034347,1081,1,56018,760,No,Yes,9262
Oregon,2020/11/15,43.49034347,862,2,56880,762,No,Yes,9262
Oregon,2020/11/16,43.49034347,766,10,57646,772,No,Yes,9262
Oregon,2020/11/17,43.49034347,924,7,58570,779,No,Yes,9262
Oregon,2020/11/18,43.49034347,1100,12,59670,791,No,Yes,11813
Oregon,2020/11/19,43.49034347,1204,18,60874,809,No,Yes,11813
Oregon,2020/11/20,43.49034347,1302,6,62176,815,No,Yes,11813
Oregon,2020/11/21,43.49034347,1492,7,63668,822,No,Yes,11813
Oregon,2020/11/22,43.49034347,1502,0,65170,822,No,Yes,11813
Oregon,2020/11/23,43.49034347,1164,8,66334,830,No,Yes,11813
Oregon,2020/11/24,43.49034347,1003,18,67337,848,No,Yes,11813
Oregon,2020/11/25,43.49034347,1167,23,68504,871,No,Yes,7061
Oregon,2020/11/26,43.49034347,1502,13,70006,884,No,Yes,7061
Oregon,2020/11/27,43.49034347,827,6,70833,890,No,Yes,7061
Oregon,2020/11/28,43.49034347,1673,9,72506,899,No,Yes,7061
Oregon,2020/11/29,43.49034347,1614,8,74120,907,No,Yes,7061
Oregon,2020/11/30,43.49034347,1334,12,75454,919,No,Yes,7061
Oregon,2020/12/1,43.49034347,1201,19,76655,938,No,Yes,7061
Oregon,2020/12/2,43.49034347,1551,24,78206,962,No,Yes,7656
Oregon,2020/12/3,43.49034347,1088,12,79294,974,No,Yes,7656
Oregon,2020/12/4,43.49034347,2147,30,81441,1004,No,Yes,7656
Oregon,2020/12/5,43.49034347,1802,23,83243,1027,No,Yes,7656
Oregon,2020/12/6,43.49034347,1253,6,84496,1033,No,Yes,7656
Oregon,2020/12/7,43.49034347,1307,16,85803,1049,No,Yes,7656
Oregon,2020/12/8,43.49034347,1279,33,87082,1082,No,Yes,7656
Oregon,2020/12/9,43.49034347,1226,30,88308,1112,No,Yes,7568
Oregon,2020/12/10,43.49034347,1530,12,89838,1124,No,Yes,7568
Oregon,2020/12/11,43.49034347,1596,23,91434,1147,No,Yes,7568
Oregon,2020/12/12,43.49034347,1405,8,92839,1155,No,Yes,7568
Oregon,2020/12/13,43.49034347,1014,3,93853,1158,No,Yes,7568
Oregon,2020/12/14,43.49034347,1189,10,95042,1168,No,Yes,7568
Oregon,2020/12/15,43.49034347,1051,45,96093,1213,No,Yes,7568
Oregon,2020/12/16,43.49034347,1532,54,97625,1267,No,Yes,7543
Oregon,2020/12/17,43.49034347,1312,17,98937,1284,No,Yes,7543
Oregon,2020/12/18,43.49034347,1372,22,100309,1306,No,Yes,7543
Oregon,2020/12/19,43.49034347,1505,34,101814,1340,No,Yes,7543
Oregon,2020/12/20,43.49034347,1116,1,102930,1341,No,Yes,7543
Oregon,2020/12/21,43.49034347,950,10,103880,1351,No,Yes,7543
Oregon,2020/12/22,43.49034347,1211,31,105091,1382,No,Yes,7543
Oregon,2020/12/23,43.49034347,929,27,106020,1409,No,Yes,5506
Oregon,2020/12/24,43.49034347,802,8,106822,1417,No,Yes,5506
Oregon,2020/12/25,43.49034347,1011,14,107833,1431,No,Yes,5506
Oregon,2020/12/26,43.49034347,515,0,108348,1431,No,Yes,5506
Oregon,2020/12/27,43.49034347,1386,5,109734,1436,No,Yes,5506
Oregon,2020/12/28,43.49034347,569,2,110303,1438,No,Yes,5506
Oregon,2020/12/29,43.49034347,955,19,111258,1457,No,Yes,5506
Oregon,2020/12/30,43.49034347,1043,21,112301,1478,No,Yes,10986
Oregon,2020/12/31,43.49034347,1628,7,113929,1485,No,Yes,10986
Oregon,2021/1/1,43.49034347,1448,16,115377,1501,No,Yes,10986
Oregon,2021/1/2,43.49034347,971,2,116348,1503,No,Yes,10986
Oregon,2021/1/3,43.49034347,1397,7,117745,1510,No,Yes,10986
Oregon,2021/1/4,43.49034347,728,7,118473,1517,No,Yes,10986
Oregon,2021/1/5,43.49034347,1035,33,119508,1550,No,Yes,10986
Oregon,2021/1/6,43.49034347,735,21,120243,1571,No,Yes,14084
Oregon,2021/1/7,43.49034347,844,6,121087,1577,No,Yes,14084
Oregon,2021/1/8,43.49034347,1760,13,122847,1590,No,Yes,14084
Oregon,2021/1/9,43.49034347,1629,17,124476,1607,No,Yes,14084
Oregon,2021/1/10,43.49034347,1207,0,125683,1607,No,Yes,14084
Oregon,2021/1/11,43.49034347,924,21,126607,1628,No,Yes,14084
Oregon,2021/1/12,43.49034347,1184,41,127791,1669,No,Yes,14084
Oregon,2021/1/13,43.49034347,1318,47,129109,1716,No,Yes,11980
Oregon,2021/1/14,43.49034347,1137,21,130246,1737,No,Yes,11980
Oregon,2021/1/15,43.49034347,1050,26,131296,1763,No,Yes,11980
Oregon,2021/1/16,43.49034347,1116,37,132412,1800,No,Yes,11980
Oregon,2021/1/17,43.49034347,793,1,133205,1801,No,Yes,11980
Oregon,2021/1/18,43.49034347,646,10,133851,1811,No,Yes,11980
Oregon,2021/1/19,43.49034347,617,5,134468,1816,No,Yes,11980
Oregon,2021/1/20,43.49034347,675,25,135143,1841,No,Yes,11615
Oregon,2021/1/21,43.49034347,830,9,135973,1850,No,Yes,11615
Oregon,2021/1/22,43.49034347,866,24,136839,1874,No,Yes,11615
Oregon,2021/1/23,43.49034347,761,8,137600,1882,No,Yes,11615
Oregon,2021/1/24,43.49034347,568,3,138168,1885,No,Yes,11615
Oregon,2021/1/25,43.49034347,419,7,138587,1892,No,Yes,11615
Oregon,2021/1/26,43.49034347,768,17,139355,1909,No,Yes,11615
Oregon,2021/1/27,43.49034347,708,27,140063,1936,No,Yes,12664
Oregon,2021/1/28,43.49034347,720,10,140783,1946,No,Yes,12664
Oregon,2021/1/29,43.49034347,946,10,141729,1956,No,Yes,12664
Oregon,2021/1/30,43.49034347,688,16,142417,1972,No,Yes,12664
Oregon,2021/1/31,43.49034347,0,0,142417,1972,No,Yes,12664
Oregon,2021/2/1,43.49034347,956,8,143373,1980,No,Yes,12664
Oregon,2021/2/2,43.49034347,605,21,143978,2001,No,Yes,12664
Oregon,2021/2/3,43.49034347,627,10,144605,2011,No,Yes,13464
Oregon,2021/2/4,43.49034347,717,7,145322,2018,No,Yes,13464
Oregon,2021/2/5,43.49034347,815,4,146137,2022,No,Yes,13464
Oregon,2021/2/6,43.49034347,604,10,146741,2032,No,Yes,13464
Oregon,2021/2/7,43.49034347,381,2,147122,2034,No,Yes,13464
Oregon,2021/2/8,43.49034347,297,9,147419,2043,No,Yes,13464
Oregon,2021/2/9,43.49034347,513,7,147932,2050,No,Yes,13464
Oregon,2021/2/10,43.49034347,543,10,148475,2060,No,Yes,12087
Oregon,2021/2/11,43.49034347,607,7,149082,2067,No,Yes,12087
Oregon,2021/2/12,43.49034347,494,42,149576,2109,No,Yes,12087
Oregon,2021/2/13,43.49034347,458,28,150034,2137,No,Yes,12087
Oregon,2021/2/14,43.49034347,247,0,150281,2137,No,Yes,12087
Oregon,2021/2/15,43.49034347,183,0,150464,2137,No,Yes,12087
Oregon,2021/2/16,43.49034347,411,1,150875,2138,No,Yes,12087
Oregon,2021/2/17,43.49034347,382,11,151257,2149,No,Yes,11395
Oregon,2021/2/18,43.49034347,456,6,151713,2155,No,Yes,11395
Oregon,2021/2/19,43.49034347,477,0,152190,2155,No,Yes,11395
Oregon,2021/2/20,43.49034347,521,4,152711,2159,No,Yes,11395
Oregon,2021/2/21,43.49034347,107,0,152818,2159,No,Yes,11395
Oregon,2021/2/22,43.49034347,321,7,153139,2166,No,Yes,11395
Oregon,2021/2/23,43.49034347,506,5,153645,2171,No,Yes,11395
Oregon,2021/2/24,43.49034347,424,33,154069,2204,No,Yes,11395
Oregon,2021/2/25,43.49034347,512,10,154581,2214,No,Yes,11395
Oregon,2021/2/26,43.49034347,321,2,154902,2216,No,Yes,11395
Oregon,2021/2/27,43.49034347,413,2,155315,2218,No,Yes,11395
Oregon,2021/2/28,43.49034347,282,0,155597,2218,No,Yes,11395
Oregon,2021/3/1,43.49034347,276,4,155873,2222,No,Yes,11395
Oregon,2021/3/2,43.49034347,215,9,156088,2231,No,Yes,11395
Oregon,2021/3/3,43.49034347,299,31,156387,2262,No,Yes,11395
Oregon,2021/3/4,43.49034347,327,22,156714,2284,No,Yes,11395
Pennsylvania,2020/3/1,282.3988926,0,0,0,0,No,No,1575
Pennsylvania,2020/3/2,282.3988926,0,0,0,0,No,No,1575
Pennsylvania,2020/3/3,282.3988926,0,0,0,0,No,No,1575
Pennsylvania,2020/3/4,282.3988926,0,0,0,0,No,No,1663
Pennsylvania,2020/3/5,282.3988926,0,0,0,0,No,No,1663
Pennsylvania,2020/3/6,282.3988926,2,0,2,0,No,No,1663
Pennsylvania,2020/3/7,282.3988926,2,0,4,0,No,No,1663
Pennsylvania,2020/3/8,282.3988926,2,0,6,0,No,No,1663
Pennsylvania,2020/3/9,282.3988926,4,0,10,0,No,No,1663
Pennsylvania,2020/3/10,282.3988926,2,0,12,0,No,No,1663
Pennsylvania,2020/3/11,282.3988926,4,0,16,0,No,No,1819
Pennsylvania,2020/3/12,282.3988926,6,0,22,0,No,No,1819
Pennsylvania,2020/3/13,282.3988926,19,0,41,0,No,No,1819
Pennsylvania,2020/3/14,282.3988926,6,0,47,0,No,No,1819
Pennsylvania,2020/3/15,282.3988926,21,0,68,0,No,No,1819
Pennsylvania,2020/3/16,282.3988926,13,0,81,0,No,No,1819
Pennsylvania,2020/3/17,282.3988926,20,0,101,0,No,No,1819
Pennsylvania,2020/3/18,282.3988926,38,1,139,1,No,No,10892
Pennsylvania,2020/3/19,282.3988926,48,0,187,1,No,No,10892
Pennsylvania,2020/3/20,282.3988926,82,0,269,1,No,No,10892
Pennsylvania,2020/3/21,282.3988926,119,1,388,2,No,No,10892
Pennsylvania,2020/3/22,282.3988926,116,1,504,3,No,No,10892
Pennsylvania,2020/3/23,282.3988926,140,3,644,6,No,No,10892
Pennsylvania,2020/3/24,282.3988926,207,2,851,8,No,No,10892
Pennsylvania,2020/3/25,282.3988926,300,4,1151,12,No,No,80984
Pennsylvania,2020/3/26,282.3988926,539,4,1690,16,No,No,80984
Pennsylvania,2020/3/27,282.3988926,527,7,2217,23,No,No,80984
Pennsylvania,2020/3/28,282.3988926,598,12,2815,35,No,No,80984
Pennsylvania,2020/3/29,282.3988926,626,5,3441,40,No,No,80984
Pennsylvania,2020/3/30,282.3988926,715,8,4156,48,No,No,80984
Pennsylvania,2020/3/31,282.3988926,841,24,4997,72,No,No,80984
Pennsylvania,2020/4/1,282.3988926,808,6,5805,78,Yes,No,106739
Pennsylvania,2020/4/2,282.3988926,1216,13,7021,91,Yes,No,106739
Pennsylvania,2020/4/3,282.3988926,1399,11,8420,102,Yes,No,106739
Pennsylvania,2020/4/4,282.3988926,1690,38,10110,140,Yes,No,106739
Pennsylvania,2020/4/5,282.3988926,1480,19,11590,159,Yes,No,106739
Pennsylvania,2020/4/6,282.3988926,1485,11,13075,170,Yes,No,106739
Pennsylvania,2020/4/7,282.3988926,1507,71,14582,241,Yes,No,106739
Pennsylvania,2020/4/8,282.3988926,1832,72,16414,313,Yes,No,77515
Pennsylvania,2020/4/9,282.3988926,1965,31,18379,344,Yes,No,77515
Pennsylvania,2020/4/10,282.3988926,1749,91,20128,435,Yes,No,77515
Pennsylvania,2020/4/11,282.3988926,1646,80,21774,515,Yes,No,77515
Pennsylvania,2020/4/12,282.3988926,1181,10,22955,525,Yes,No,77515
Pennsylvania,2020/4/13,282.3988926,1340,38,24295,563,Yes,No,77515
Pennsylvania,2020/4/14,282.3988926,1296,183,25591,746,Yes,No,77515
Pennsylvania,2020/4/15,282.3988926,1213,87,26804,833,Yes,No,66432
Pennsylvania,2020/4/16,282.3988926,1510,107,28314,940,Yes,No,66432
Pennsylvania,2020/4/17,282.3988926,1807,87,30121,1027,Yes,No,66432
Pennsylvania,2020/4/18,282.3988926,1621,123,31742,1150,Yes,No,66432
Pennsylvania,2020/4/19,282.3988926,1250,135,32992,1285,Yes,No,66432
Pennsylvania,2020/4/20,282.3988926,1013,81,34005,1366,Yes,No,66432
Pennsylvania,2020/4/21,282.3988926,1379,254,35384,1620,Yes,No,66432
Pennsylvania,2020/4/22,282.3988926,1379,100,36763,1720,Yes,No,74966
Pennsylvania,2020/4/23,282.3988926,1571,3,38334,1723,Yes,No,74966
Pennsylvania,2020/4/24,282.3988926,1964,63,40298,1786,Yes,No,74966
Pennsylvania,2020/4/25,282.3988926,1328,56,41626,1842,Yes,No,74966
Pennsylvania,2020/4/26,282.3988926,1083,29,42709,1871,Yes,No,74966
Pennsylvania,2020/4/27,282.3988926,1019,75,43728,1946,Yes,No,74966
Pennsylvania,2020/4/28,282.3988926,1595,146,45323,2092,Yes,No,74966
Pennsylvania,2020/4/29,282.3988926,868,300,46191,2392,Yes,No,28985
Pennsylvania,2020/4/30,282.3988926,2033,188,48224,2580,Yes,No,28985
Pennsylvania,2020/5/1,282.3988926,1540,91,49764,2671,Yes,No,28985
Pennsylvania,2020/5/2,282.3988926,1307,123,51071,2794,Yes,No,28985
Pennsylvania,2020/5/3,282.3988926,1008,49,52079,2843,Yes,No,28985
Pennsylvania,2020/5/4,282.3988926,913,37,52992,2880,Yes,No,28985
Pennsylvania,2020/5/5,282.3988926,975,326,53967,3206,Yes,No,28985
Pennsylvania,2020/5/6,282.3988926,1022,154,54989,3360,Yes,No,26666
Pennsylvania,2020/5/7,282.3988926,1160,239,56149,3599,Yes,No,26666
Pennsylvania,2020/5/8,282.3988926,1352,125,57501,3724,Yes,No,26666
Pennsylvania,2020/5/9,282.3988926,1160,69,58661,3793,Yes,No,26666
Pennsylvania,2020/5/10,282.3988926,1376,26,60037,3819,Yes,No,26666
Pennsylvania,2020/5/11,282.3988926,520,27,60557,3846,Yes,No,26666
Pennsylvania,2020/5/12,282.3988926,850,78,61407,3924,Yes,No,26666
Pennsylvania,2020/5/13,282.3988926,787,180,62194,4104,Yes,No,25150
Pennsylvania,2020/5/14,282.3988926,964,194,63158,4298,Yes,No,25150
Pennsylvania,2020/5/15,282.3988926,1020,134,64178,4432,Yes,No,25150
Pennsylvania,2020/5/16,282.3988926,1050,58,65228,4490,Yes,No,25150
Pennsylvania,2020/5/17,282.3988926,517,14,65745,4504,Yes,No,25150
Pennsylvania,2020/5/18,282.3988926,931,56,66676,4560,Yes,No,25150
Pennsylvania,2020/5/19,282.3988926,728,115,67404,4675,Yes,No,25150
Pennsylvania,2020/5/20,282.3988926,747,119,68151,4794,Yes,No,27919
Pennsylvania,2020/5/21,282.3988926,1101,93,69252,4887,Yes,No,27919
Pennsylvania,2020/5/22,282.3988926,1053,145,70305,5032,Yes,No,27919
Pennsylvania,2020/5/23,282.3988926,797,89,71102,5121,Yes,No,27919
Pennsylvania,2020/5/24,282.3988926,554,24,71656,5145,Yes,No,27919
Pennsylvania,2020/5/25,282.3988926,700,14,72356,5159,Yes,No,27919
Pennsylvania,2020/5/26,282.3988926,517,16,72873,5175,Yes,No,27919
Pennsylvania,2020/5/27,282.3988926,773,115,73646,5290,Yes,No,21335
Pennsylvania,2020/5/28,282.3988926,666,107,74312,5397,Yes,No,21335
Pennsylvania,2020/5/29,282.3988926,761,70,75073,5467,Yes,No,21335
Pennsylvania,2020/5/30,282.3988926,716,70,75789,5537,Yes,No,21335
Pennsylvania,2020/5/31,282.3988926,429,18,76218,5555,Yes,No,21335
Pennsylvania,2020/6/1,282.3988926,516,19,76734,5574,Yes,No,21335
Pennsylvania,2020/6/2,282.3988926,581,96,77315,5670,Yes,No,21335
Pennsylvania,2020/6/3,282.3988926,556,72,77871,5742,Yes,No,19949
Pennsylvania,2020/6/4,282.3988926,557,120,78428,5862,Yes,No,19949
Pennsylvania,2020/6/5,282.3988926,480,90,78908,5952,No,No,19949
Pennsylvania,2020/6/6,282.3988926,599,34,79507,5986,No,No,19949
Pennsylvania,2020/6/7,282.3988926,494,11,80001,5997,No,No,19949
Pennsylvania,2020/6/8,282.3988926,431,10,80432,6007,No,No,19949
Pennsylvania,2020/6/9,282.3988926,532,63,80964,6070,No,No,19949
Pennsylvania,2020/6/10,282.3988926,446,73,81410,6143,No,No,18367
Pennsylvania,2020/6/11,282.3988926,534,44,81944,6187,No,No,18367
Pennsylvania,2020/6/12,282.3988926,634,42,82578,6229,No,No,18367
Pennsylvania,2020/6/13,282.3988926,410,35,82988,6264,No,No,18367
Pennsylvania,2020/6/14,282.3988926,313,11,83301,6275,No,No,18367
Pennsylvania,2020/6/15,282.3988926,386,32,83687,6307,No,No,18367
Pennsylvania,2020/6/16,282.3988926,390,30,84077,6337,No,No,18367
Pennsylvania,2020/6/17,282.3988926,310,39,84387,6376,No,No,18671
Pennsylvania,2020/6/18,282.3988926,393,41,84780,6417,No,No,18671
Pennsylvania,2020/6/19,282.3988926,508,29,85288,6446,No,No,18671
Pennsylvania,2020/6/20,282.3988926,390,21,85678,6467,No,No,18671
Pennsylvania,2020/6/21,282.3988926,346,5,86024,6472,No,No,18671
Pennsylvania,2020/6/22,282.3988926,642,3,86666,6475,No,No,18671
Pennsylvania,2020/6/23,282.3988926,617,36,87283,6511,No,No,18671
Pennsylvania,2020/6/24,282.3988926,492,57,87775,6568,No,No,18338
Pennsylvania,2020/6/25,282.3988926,455,34,88230,6602,No,No,18338
Pennsylvania,2020/6/26,282.3988926,720,23,88950,6625,No,No,18338
Pennsylvania,2020/6/27,282.3988926,450,27,89400,6652,No,No,18338
Pennsylvania,2020/6/28,282.3988926,385,3,89785,6655,No,No,18338
Pennsylvania,2020/6/29,282.3988926,768,8,90553,6663,No,No,18338
Pennsylvania,2020/6/30,282.3988926,673,32,91226,6695,No,No,18338
Pennsylvania,2020/7/1,282.3988926,638,9,91864,6704,No,No,19056
Pennsylvania,2020/7/2,282.3988926,839,54,92703,6758,No,No,19056
Pennsylvania,2020/7/3,282.3988926,715,32,93418,6790,No,No,19056
Pennsylvania,2020/7/4,282.3988926,504,3,93922,6793,No,No,19056
Pennsylvania,2020/7/5,282.3988926,481,4,94403,6797,No,No,19056
Pennsylvania,2020/7/6,282.3988926,784,1,95187,6798,No,No,19056
Pennsylvania,2020/7/7,282.3988926,799,37,95986,6835,No,No,19056
Pennsylvania,2020/7/8,282.3988926,831,29,96817,6864,No,No,20563
Pennsylvania,2020/7/9,282.3988926,817,31,97634,6895,No,No,20563
Pennsylvania,2020/7/10,282.3988926,940,34,98574,6929,No,No,20563
Pennsylvania,2020/7/11,282.3988926,678,16,99252,6945,No,No,20563
Pennsylvania,2020/7/12,282.3988926,542,5,99794,6950,No,No,20563
Pennsylvania,2020/7/13,282.3988926,584,5,100378,6955,No,No,20563
Pennsylvania,2020/7/14,282.3988926,982,18,101360,6973,No,No,20563
Pennsylvania,2020/7/15,282.3988926,1001,38,102361,7011,No,No,23676
Pennsylvania,2020/7/16,282.3988926,808,28,103169,7039,No,No,23676
Pennsylvania,2020/7/17,282.3988926,1003,18,104172,7057,No,No,23676
Pennsylvania,2020/7/18,282.3988926,608,11,104780,7068,No,No,23676
Pennsylvania,2020/7/19,282.3988926,604,6,105384,7074,No,No,23676
Pennsylvania,2020/7/20,282.3988926,1114,2,106498,7076,No,No,23676
Pennsylvania,2020/7/21,282.3988926,962,18,107460,7094,No,No,23676
Pennsylvania,2020/7/22,282.3988926,807,31,108267,7125,No,No,17437
Pennsylvania,2020/7/23,282.3988926,886,17,109153,7142,No,No,17437
Pennsylvania,2020/7/24,282.3988926,1189,20,110342,7162,No,No,17437
Pennsylvania,2020/7/25,282.3988926,779,5,111121,7167,No,No,17437
Pennsylvania,2020/7/26,282.3988926,652,3,111773,7170,No,No,17437
Pennsylvania,2020/7/27,282.3988926,1222,4,112995,7174,No,No,17437
Pennsylvania,2020/7/28,282.3988926,1134,23,114129,7197,No,No,17437
Pennsylvania,2020/7/29,282.3988926,855,22,114984,7219,No,No,11690
Pennsylvania,2020/7/30,282.3988926,869,29,115853,7248,No,No,11690
Pennsylvania,2020/7/31,282.3988926,934,13,116787,7261,No,No,11690
Pennsylvania,2020/8/1,282.3988926,681,9,117468,7270,No,No,11690
Pennsylvania,2020/8/2,282.3988926,570,4,118038,7274,No,No,11690
Pennsylvania,2020/8/3,282.3988926,899,2,118937,7276,No,No,11690
Pennsylvania,2020/8/4,282.3988926,828,20,119765,7296,No,No,11690
Pennsylvania,2020/8/5,282.3988926,727,14,120492,7310,No,No,9467
Pennsylvania,2020/8/6,282.3988926,802,30,121294,7340,No,No,9467
Pennsylvania,2020/8/7,282.3988926,784,20,122078,7360,No,No,9467
Pennsylvania,2020/8/8,282.3988926,588,12,122666,7372,No,No,9467
Pennsylvania,2020/8/9,282.3988926,646,2,123312,7374,No,No,9467
Pennsylvania,2020/8/10,282.3988926,957,4,124269,7378,No,No,9467
Pennsylvania,2020/8/11,282.3988926,792,26,125061,7404,No,No,9467
Pennsylvania,2020/8/12,282.3988926,904,43,125965,7447,No,No,11047
Pennsylvania,2020/8/13,282.3988926,985,27,126950,7474,No,No,11047
Pennsylvania,2020/8/14,282.3988926,824,39,127774,7513,No,No,11047
Pennsylvania,2020/8/15,282.3988926,757,12,128531,7525,No,No,11047
Pennsylvania,2020/8/16,282.3988926,544,7,129075,7532,No,No,11047
Pennsylvania,2020/8/17,282.3988926,611,3,129686,7535,No,No,11047
Pennsylvania,2020/8/18,282.3988926,600,26,130286,7561,No,No,11047
Pennsylvania,2020/8/19,282.3988926,664,32,130950,7593,No,No,8676
Pennsylvania,2020/8/20,282.3988926,786,13,131736,7606,No,No,8676
Pennsylvania,2020/8/21,282.3988926,725,23,132461,7629,No,No,8676
Pennsylvania,2020/8/22,282.3988926,699,14,133160,7643,No,No,8676
Pennsylvania,2020/8/23,282.3988926,519,0,133679,7643,No,No,8676
Pennsylvania,2020/8/24,282.3988926,567,-1,134246,7642,No,No,8676
Pennsylvania,2020/8/25,282.3988926,557,24,134803,7666,No,No,8676
Pennsylvania,2020/8/26,282.3988926,520,25,135323,7691,No,No,8511
Pennsylvania,2020/8/27,282.3988926,635,11,135958,7702,No,No,8511
Pennsylvania,2020/8/28,282.3988926,866,20,136824,7722,No,No,8511
Pennsylvania,2020/8/29,282.3988926,752,18,137576,7740,No,No,8511
Pennsylvania,2020/8/30,282.3988926,561,2,138137,7742,No,No,8511
Pennsylvania,2020/8/31,282.3988926,703,1,138840,7743,No,No,8511
Pennsylvania,2020/9/1,282.3988926,751,21,139591,7764,No,No,8511
Pennsylvania,2020/9/2,282.3988926,986,28,140577,7792,No,No,8901
Pennsylvania,2020/9/3,282.3988926,1001,13,141578,7805,No,No,8901
Pennsylvania,2020/9/4,282.3988926,959,16,142537,7821,No,No,8901
Pennsylvania,2020/9/5,282.3988926,764,16,143301,7837,No,No,8901
Pennsylvania,2020/9/6,282.3988926,601,0,143902,7837,No,No,8901
Pennsylvania,2020/9/7,282.3988926,756,18,144658,7855,No,No,8901
Pennsylvania,2020/9/8,282.3988926,533,7,145191,7862,No,No,8901
Pennsylvania,2020/9/9,282.3988926,867,20,146058,7882,No,No,8848
Pennsylvania,2020/9/10,282.3988926,677,12,146735,7894,No,No,8848
Pennsylvania,2020/9/11,282.3988926,1009,20,147744,7914,No,No,8848
Pennsylvania,2020/9/12,282.3988926,891,1,148635,7915,No,No,8848
Pennsylvania,2020/9/13,282.3988926,0,0,148635,7915,No,No,8848
Pennsylvania,2020/9/14,282.3988926,1409,25,150044,7940,No,No,8848
Pennsylvania,2020/9/15,282.3988926,1037,5,151081,7945,No,No,8848
Pennsylvania,2020/9/16,282.3988926,808,18,151889,7963,No,No,8679
Pennsylvania,2020/9/17,282.3988926,924,15,152813,7978,No,No,8679
Pennsylvania,2020/9/18,282.3988926,747,28,153560,8006,No,No,8679
Pennsylvania,2020/9/19,282.3988926,701,22,154261,8028,No,No,8679
Pennsylvania,2020/9/20,282.3988926,663,21,154924,8049,No,No,8679
Pennsylvania,2020/9/21,282.3988926,805,31,155729,8080,No,No,8679
Pennsylvania,2020/9/22,282.3988926,783,19,156512,8099,No,No,8679
Pennsylvania,2020/9/23,282.3988926,861,38,157373,8137,No,No,8805
Pennsylvania,2020/9/24,282.3988926,848,13,158221,8150,No,No,8805
Pennsylvania,2020/9/25,282.3988926,830,7,159051,8157,No,No,8805
Pennsylvania,2020/9/26,282.3988926,886,20,159937,8177,No,No,8805
Pennsylvania,2020/9/27,282.3988926,833,3,160770,8180,No,No,8805
Pennsylvania,2020/9/28,282.3988926,872,1,161642,8181,No,No,8805
Pennsylvania,2020/9/29,282.3988926,1577,15,163219,8196,No,No,8805
Pennsylvania,2020/9/30,282.3988926,916,20,164135,8216,No,No,7732
Pennsylvania,2020/10/1,282.3988926,943,18,165078,8234,No,No,7732
Pennsylvania,2020/10/2,282.3988926,1192,20,166270,8254,No,No,7732
Pennsylvania,2020/10/3,282.3988926,0,17,166270,8271,No,No,7732
Pennsylvania,2020/10/4,282.3988926,1891,16,168161,8287,No,No,7732
Pennsylvania,2020/10/5,282.3988926,965,13,169126,8300,No,No,7732
Pennsylvania,2020/10/6,282.3988926,1129,18,170255,8318,No,No,7732
Pennsylvania,2020/10/7,282.3988926,1295,29,171550,8347,No,No,8581
Pennsylvania,2020/10/8,282.3988926,1421,25,172971,8372,No,No,8581
Pennsylvania,2020/10/9,282.3988926,1381,15,174352,8387,No,No,8581
Pennsylvania,2020/10/10,282.3988926,1452,34,175804,8421,No,No,8581
Pennsylvania,2020/10/11,282.3988926,1016,5,176820,8426,No,No,8581
Pennsylvania,2020/10/12,282.3988926,1024,18,177844,8444,No,No,8581
Pennsylvania,2020/10/13,282.3988926,1829,14,179673,8458,No,No,8581
Pennsylvania,2020/10/14,282.3988926,1283,23,180956,8481,No,No,7964
Pennsylvania,2020/10/15,282.3988926,1546,15,182502,8496,No,No,7964
Pennsylvania,2020/10/16,282.3988926,1683,28,184185,8524,No,No,7964
Pennsylvania,2020/10/17,282.3988926,1485,11,185670,8535,No,No,7964
Pennsylvania,2020/10/18,282.3988926,1102,20,186772,8555,No,No,7964
Pennsylvania,2020/10/19,282.3988926,1670,7,188442,8562,No,No,7964
Pennsylvania,2020/10/20,282.3988926,1546,29,189988,8591,No,No,7964
Pennsylvania,2020/10/21,282.3988926,1359,38,191347,8629,No,No,7126
Pennsylvania,2020/10/22,282.3988926,2054,31,193401,8660,No,No,7126
Pennsylvania,2020/10/23,282.3988926,2258,35,195659,8695,No,No,7126
Pennsylvania,2020/10/24,282.3988926,1711,26,197370,8721,No,No,7126
Pennsylvania,2020/10/25,282.3988926,1386,9,198756,8730,No,No,7126
Pennsylvania,2020/10/26,282.3988926,2492,7,201248,8737,No,No,7126
Pennsylvania,2020/10/27,282.3988926,2272,23,203520,8760,No,No,7126
Pennsylvania,2020/10/28,282.3988926,2332,29,205852,8789,No,No,7060
Pennsylvania,2020/10/29,282.3988926,2235,39,208087,8828,No,No,7060
Pennsylvania,2020/10/30,282.3988926,2499,32,210586,8860,No,No,7060
Pennsylvania,2020/10/31,282.3988926,2230,23,212816,8883,No,No,7060
Pennsylvania,2020/11/1,282.3988926,1684,5,214500,8888,No,No,7060
Pennsylvania,2020/11/2,282.3988926,2743,5,217243,8893,No,No,7060
Pennsylvania,2020/11/3,282.3988926,2868,33,220111,8926,No,No,7060
Pennsylvania,2020/11/4,282.3988926,2772,41,222883,8967,No,No,8764
Pennsylvania,2020/11/5,282.3988926,2815,42,225698,9009,No,No,8764
Pennsylvania,2020/11/6,282.3988926,3648,43,229346,9052,No,No,8764
Pennsylvania,2020/11/7,282.3988926,3236,37,232582,9089,No,No,8764
Pennsylvania,2020/11/8,282.3988926,2580,4,235162,9093,No,No,8764
Pennsylvania,2020/11/9,282.3988926,4562,5,239724,9098,No,No,8764
Pennsylvania,2020/11/10,282.3988926,4322,58,244046,9156,No,No,8764
Pennsylvania,2020/11/11,282.3988926,4098,61,248144,9217,No,No,9262
Pennsylvania,2020/11/12,282.3988926,6023,55,254167,9272,No,No,9262
Pennsylvania,2020/11/13,282.3988926,5834,34,260001,9306,No,No,9262
Pennsylvania,2020/11/14,282.3988926,4395,47,264396,9353,No,No,9262
Pennsylvania,2020/11/15,282.3988926,4647,32,269043,9385,No,No,9262
Pennsylvania,2020/11/16,282.3988926,6214,14,275257,9399,No,No,9262
Pennsylvania,2020/11/17,282.3988926,5721,34,280978,9433,No,No,9262
Pennsylvania,2020/11/18,282.3988926,6486,108,287464,9541,No,No,11813
Pennsylvania,2020/11/19,282.3988926,6881,102,294345,9643,No,No,11813
Pennsylvania,2020/11/20,282.3988926,7028,105,301373,9748,No,No,11813
Pennsylvania,2020/11/21,282.3988926,5874,114,307247,9862,No,No,11813
Pennsylvania,2020/11/22,282.3988926,6541,39,313788,9901,No,No,11813
Pennsylvania,2020/11/23,282.3988926,6462,31,320250,9932,No,No,11813
Pennsylvania,2020/11/24,282.3988926,6365,82,326615,10014,No,No,11813
Pennsylvania,2020/11/25,282.3988926,6956,148,333571,10162,No,No,7061
Pennsylvania,2020/11/26,282.3988926,7427,109,340998,10271,No,No,7061
Pennsylvania,2020/11/27,282.3988926,8362,24,349360,10295,No,No,7061
Pennsylvania,2020/11/28,282.3988926,6883,42,356243,10337,No,No,7061
Pennsylvania,2020/11/29,282.3988926,5144,69,361387,10406,No,No,7061
Pennsylvania,2020/11/30,282.3988926,5584,33,366971,10439,No,No,7061
Pennsylvania,2020/12/1,282.3988926,5717,175,372688,10614,No,No,7061
Pennsylvania,2020/12/2,282.3988926,8654,189,381342,10803,No,No,7656
Pennsylvania,2020/12/3,282.3988926,11268,205,392610,11008,No,No,7656
Pennsylvania,2020/12/4,282.3988926,12089,181,404699,11189,No,No,7656
Pennsylvania,2020/12/5,282.3988926,11374,142,416073,11331,No,No,7656
Pennsylvania,2020/12/6,282.3988926,7755,58,423828,11389,No,No,7656
Pennsylvania,2020/12/7,282.3988926,8582,42,432410,11431,No,No,7656
Pennsylvania,2020/12/8,282.3988926,10118,161,442528,11592,No,No,7656
Pennsylvania,2020/12/9,282.3988926,8626,247,451154,11839,No,No,7568
Pennsylvania,2020/12/10,282.3988926,12021,227,463175,12066,No,No,7568
Pennsylvania,2020/12/11,282.3988926,12669,232,475844,12298,No,No,7568
Pennsylvania,2020/12/12,282.3988926,10057,191,485901,12489,No,No,7568
Pennsylvania,2020/12/13,282.3988926,10005,124,495906,12613,No,No,7568
Pennsylvania,2020/12/14,282.3988926,9516,55,505422,12668,No,No,7568
Pennsylvania,2020/12/15,282.3988926,9587,262,515009,12930,No,No,7568
Pennsylvania,2020/12/16,282.3988926,10190,270,525199,13200,No,No,7543
Pennsylvania,2020/12/17,282.3988926,10032,242,535231,13442,No,No,7543
Pennsylvania,2020/12/18,282.3988926,9186,222,544417,13664,No,No,7543
Pennsylvania,2020/12/19,282.3988926,9007,205,553424,13869,No,No,7543
Pennsylvania,2020/12/20,282.3988926,6578,95,560002,13964,No,No,7543
Pennsylvania,2020/12/21,282.3988926,9411,57,569413,14021,No,No,7543
Pennsylvania,2020/12/22,282.3988926,7770,223,577183,14244,No,No,7543
Pennsylvania,2020/12/23,282.3988926,9725,226,586908,14470,No,No,5506
Pennsylvania,2020/12/24,282.3988926,9214,289,596122,14759,No,No,5506
Pennsylvania,2020/12/25,282.3988926,6483,133,602605,14892,No,No,5506
Pennsylvania,2020/12/26,282.3988926,7077,23,609682,14915,No,No,5506
Pennsylvania,2020/12/27,282.3988926,4621,125,614303,15040,No,No,5506
Pennsylvania,2020/12/28,282.3988926,5122,74,619425,15114,No,No,5506
Pennsylvania,2020/12/29,282.3988926,8658,275,628083,15389,No,No,5506
Pennsylvania,2020/12/30,282.3988926,8627,329,636710,15718,No,No,10986
Pennsylvania,2020/12/31,282.3988926,9350,302,646060,16020,No,No,10986
Pennsylvania,2021/1/1,282.3988926,6892,227,652952,16247,No,No,10986
Pennsylvania,2021/1/2,282.3988926,8779,23,661731,16270,No,No,10986
Pennsylvania,2021/1/3,282.3988926,4476,54,666207,16324,No,No,10986
Pennsylvania,2021/1/4,282.3988926,4562,70,670769,16394,No,No,10986
Pennsylvania,2021/1/5,282.3988926,8991,189,679760,16583,No,No,10986
Pennsylvania,2021/1/6,282.3988926,9402,377,689162,16960,No,No,14084
Pennsylvania,2021/1/7,282.3988926,9856,260,699018,17220,No,No,14084
Pennsylvania,2021/1/8,282.3988926,10217,207,709235,17427,No,No,14084
Pennsylvania,2021/1/9,282.3988926,9407,254,718642,17681,No,No,14084
Pennsylvania,2021/1/10,282.3988926,6864,99,725506,17780,No,No,14084
Pennsylvania,2021/1/11,282.3988926,6461,81,731967,17861,No,No,14084
Pennsylvania,2021/1/12,282.3988926,7245,230,739212,18091,No,No,14084
Pennsylvania,2021/1/13,282.3988926,8033,367,747245,18458,No,No,11980
Pennsylvania,2021/1/14,282.3988926,7196,294,754441,18752,No,No,11980
Pennsylvania,2021/1/15,282.3988926,6111,226,760552,18978,No,No,11980
Pennsylvania,2021/1/16,282.3988926,6522,210,767074,19188,No,No,11980
Pennsylvania,2021/1/17,282.3988926,5673,122,772747,19310,No,No,11980
Pennsylvania,2021/1/18,282.3988926,3743,80,776490,19390,No,No,11980
Pennsylvania,2021/1/19,282.3988926,6865,77,783355,19467,No,No,11980
Pennsylvania,2021/1/20,282.3988926,5674,401,789029,19868,No,No,11615
Pennsylvania,2021/1/21,282.3988926,5603,260,794632,20128,No,No,11615
Pennsylvania,2021/1/22,282.3988926,5316,194,799948,20322,No,No,11615
Pennsylvania,2021/1/23,282.3988926,5324,204,805272,20526,No,No,11615
Pennsylvania,2021/1/24,282.3988926,3679,83,808951,20609,No,No,11615
Pennsylvania,2021/1/25,282.3988926,4714,55,813665,20664,No,No,11615
Pennsylvania,2021/1/26,282.3988926,4665,219,818330,20883,No,No,11615
Pennsylvania,2021/1/27,282.3988926,5886,222,824216,21105,No,No,12664
Pennsylvania,2021/1/28,282.3988926,6079,245,830295,21350,No,No,12664
Pennsylvania,2021/1/29,282.3988926,9593,174,839888,21524,No,No,12664
Pennsylvania,2021/1/30,282.3988926,4631,134,844519,21658,No,No,12664
Pennsylvania,2021/1/31,282.3988926,3725,57,848244,21715,No,No,12664
Pennsylvania,2021/2/1,282.3988926,3667,26,851911,21741,No,No,12664
Pennsylvania,2021/2/2,282.3988926,4303,125,856214,21866,No,No,12664
Pennsylvania,2021/2/3,282.3988926,3131,144,859345,22010,No,No,13464
Pennsylvania,2021/2/4,282.3988926,3418,133,862763,22143,No,No,13464
Pennsylvania,2021/2/5,282.3988926,4739,130,867502,22273,No,No,13464
Pennsylvania,2021/2/6,282.3988926,3933,149,871435,22422,No,No,13464
Pennsylvania,2021/2/7,282.3988926,4122,71,875557,22493,No,No,13464
Pennsylvania,2021/2/8,282.3988926,3122,4,878679,22497,No,No,13464
Pennsylvania,2021/2/9,282.3988926,4326,159,883005,22656,No,No,13464
Pennsylvania,2021/2/10,282.3988926,3110,139,886115,22795,No,No,12087
Pennsylvania,2021/2/11,282.3988926,3985,113,890100,22908,No,No,12087
Pennsylvania,2021/2/12,282.3988926,3259,99,893359,23007,No,No,12087
Pennsylvania,2021/2/13,282.3988926,3679,107,897038,23114,No,No,12087
Pennsylvania,2021/2/14,282.3988926,2436,22,899474,23136,No,No,12087
Pennsylvania,2021/2/15,282.3988926,1771,21,901245,23157,No,No,12087
Pennsylvania,2021/2/16,282.3988926,2958,9,904203,23166,No,No,12087
Pennsylvania,2021/2/17,282.3988926,3533,194,907736,23360,No,No,11395
Pennsylvania,2021/2/18,282.3988926,3297,92,911033,23452,No,No,11395
Pennsylvania,2021/2/19,282.3988926,2792,77,913825,23529,No,No,11395
Pennsylvania,2021/2/20,282.3988926,2553,86,916378,23615,No,No,11395
Pennsylvania,2021/2/21,282.3988926,1796,25,918174,23640,No,No,11395
Pennsylvania,2021/2/22,282.3988926,1851,17,920025,23657,No,No,11395
Pennsylvania,2021/2/23,282.3988926,2823,92,922848,23749,No,No,11395
Pennsylvania,2021/2/24,282.3988926,2814,83,925662,23832,No,No,11395
Pennsylvania,2021/2/25,282.3988926,2367,78,928029,23910,No,No,11395
Pennsylvania,2021/2/26,282.3988926,3070,69,931099,23979,No,No,11395
Pennsylvania,2021/2/27,282.3988926,3014,0,934113,23979,No,No,11395
Pennsylvania,2021/2/28,282.3988926,1798,77,935911,24056,No,No,11395
Pennsylvania,2021/3/1,282.3988926,2397,9,938308,24065,No,No,11395
Pennsylvania,2021/3/2,282.3988926,2503,70,940811,24135,No,No,11395
Pennsylvania,2021/3/3,282.3988926,2637,79,943448,24214,No,No,11395
Pennsylvania,2021/3/4,282.3988926,3007,51,946455,24265,No,No,11395
Rhode Island,2020/3/1,872.6202636,2,0,2,0,No,No,1575
Rhode Island,2020/3/2,872.6202636,0,0,2,0,No,No,1575
Rhode Island,2020/3/3,872.6202636,0,0,2,0,No,No,1575
Rhode Island,2020/3/4,872.6202636,0,0,2,0,No,No,1663
Rhode Island,2020/3/5,872.6202636,0,0,2,0,No,No,1663
Rhode Island,2020/3/6,872.6202636,1,0,3,0,No,No,1663
Rhode Island,2020/3/7,872.6202636,0,0,3,0,No,No,1663
Rhode Island,2020/3/8,872.6202636,0,0,3,0,No,No,1663
Rhode Island,2020/3/9,872.6202636,0,0,3,0,No,No,1663
Rhode Island,2020/3/10,872.6202636,2,0,5,0,No,No,1663
Rhode Island,2020/3/11,872.6202636,0,0,5,0,No,No,1819
Rhode Island,2020/3/12,872.6202636,0,0,5,0,No,No,1819
Rhode Island,2020/3/13,872.6202636,15,0,20,0,No,No,1819
Rhode Island,2020/3/14,872.6202636,0,0,20,0,No,No,1819
Rhode Island,2020/3/15,872.6202636,0,0,20,0,No,No,1819
Rhode Island,2020/3/16,872.6202636,1,0,21,0,No,No,1819
Rhode Island,2020/3/17,872.6202636,2,0,23,0,No,No,1819
Rhode Island,2020/3/18,872.6202636,10,0,33,0,No,No,10892
Rhode Island,2020/3/19,872.6202636,11,0,44,0,No,No,10892
Rhode Island,2020/3/20,872.6202636,0,0,44,0,No,No,10892
Rhode Island,2020/3/21,872.6202636,22,0,66,0,No,No,10892
Rhode Island,2020/3/22,872.6202636,17,0,83,0,No,No,10892
Rhode Island,2020/3/23,872.6202636,23,0,106,0,No,No,10892
Rhode Island,2020/3/24,872.6202636,18,0,124,0,No,No,10892
Rhode Island,2020/3/25,872.6202636,8,0,132,0,No,No,80984
Rhode Island,2020/3/26,872.6202636,33,0,165,0,No,No,80984
Rhode Island,2020/3/27,872.6202636,38,0,203,0,No,No,80984
Rhode Island,2020/3/28,872.6202636,36,2,239,2,Yes,No,80984
Rhode Island,2020/3/29,872.6202636,55,1,294,3,Yes,No,80984
Rhode Island,2020/3/30,872.6202636,114,1,408,4,Yes,No,80984
Rhode Island,2020/3/31,872.6202636,80,4,488,8,Yes,No,80984
Rhode Island,2020/4/1,872.6202636,78,2,566,10,Yes,No,106739
Rhode Island,2020/4/2,872.6202636,91,2,657,12,Yes,No,106739
Rhode Island,2020/4/3,872.6202636,54,2,711,14,Yes,No,106739
Rhode Island,2020/4/4,872.6202636,95,3,806,17,Yes,No,106739
Rhode Island,2020/4/5,872.6202636,116,8,922,25,Yes,No,106739
Rhode Island,2020/4/6,872.6202636,160,2,1082,27,Yes,No,106739
Rhode Island,2020/4/7,872.6202636,147,3,1229,30,Yes,No,106739
Rhode Island,2020/4/8,872.6202636,221,5,1450,35,Yes,No,77515
Rhode Island,2020/4/9,872.6202636,277,8,1727,43,Yes,No,77515
Rhode Island,2020/4/10,872.6202636,288,6,2015,49,Yes,No,77515
Rhode Island,2020/4/11,872.6202636,334,7,2349,56,Yes,No,77515
Rhode Island,2020/4/12,872.6202636,316,7,2665,63,Yes,No,77515
Rhode Island,2020/4/13,872.6202636,311,10,2976,73,Yes,No,77515
Rhode Island,2020/4/14,872.6202636,275,7,3251,80,Yes,No,77515
Rhode Island,2020/4/15,872.6202636,278,7,3529,87,Yes,No,66432
Rhode Island,2020/4/16,872.6202636,309,18,3838,105,Yes,No,66432
Rhode Island,2020/4/17,872.6202636,339,13,4177,118,Yes,No,66432
Rhode Island,2020/4/18,872.6202636,314,19,4491,137,Yes,No,66432
Rhode Island,2020/4/19,872.6202636,215,13,4706,150,Yes,No,66432
Rhode Island,2020/4/20,872.6202636,384,5,5090,155,Yes,No,66432
Rhode Island,2020/4/21,872.6202636,410,16,5500,171,Yes,No,66432
Rhode Island,2020/4/22,872.6202636,341,10,5841,181,Yes,No,74966
Rhode Island,2020/4/23,872.6202636,415,8,6256,189,Yes,No,74966
Rhode Island,2020/4/24,872.6202636,443,13,6699,202,Yes,No,74966
Rhode Island,2020/4/25,872.6202636,430,13,7129,215,Yes,No,74966
Rhode Island,2020/4/26,872.6202636,310,11,7439,226,Yes,No,74966
Rhode Island,2020/4/27,872.6202636,269,7,7708,233,Yes,No,74966
Rhode Island,2020/4/28,872.6202636,218,6,7926,239,Yes,No,74966
Rhode Island,2020/4/29,872.6202636,321,12,8247,251,Yes,No,28985
Rhode Island,2020/4/30,872.6202636,374,15,8621,266,Yes,No,28985
Rhode Island,2020/5/1,872.6202636,341,13,8962,279,Yes,No,28985
Rhode Island,2020/5/2,872.6202636,327,17,9289,296,Yes,No,28985
Rhode Island,2020/5/3,872.6202636,188,24,9477,320,Yes,No,28985
Rhode Island,2020/5/4,872.6202636,175,21,9652,341,Yes,No,28985
Rhode Island,2020/5/5,872.6202636,281,14,9933,355,Yes,No,28985
Rhode Island,2020/5/6,872.6202636,272,15,10205,370,Yes,No,26666
Rhode Island,2020/5/7,872.6202636,325,18,10530,388,Yes,No,26666
Rhode Island,2020/5/8,872.6202636,249,11,10779,399,Yes,No,26666
Rhode Island,2020/5/9,872.6202636,210,19,10989,418,No,No,26666
Rhode Island,2020/5/10,872.6202636,285,4,11274,422,No,No,26666
Rhode Island,2020/5/11,872.6202636,176,8,11450,430,No,No,26666
Rhode Island,2020/5/12,872.6202636,164,14,11614,444,No,No,26666
Rhode Island,2020/5/13,872.6202636,221,18,11835,462,No,No,25150
Rhode Island,2020/5/14,872.6202636,181,6,12016,468,No,No,25150
Rhode Island,2020/5/15,872.6202636,203,11,12219,479,No,No,25150
Rhode Island,2020/5/16,872.6202636,215,10,12434,489,No,No,25150
Rhode Island,2020/5/17,872.6202636,240,10,12674,499,No,No,25150
Rhode Island,2020/5/18,872.6202636,121,7,12795,506,No,No,25150
Rhode Island,2020/5/19,872.6202636,156,26,12951,532,No,No,25150
Rhode Island,2020/5/20,872.6202636,405,6,13356,538,No,No,27919
Rhode Island,2020/5/21,872.6202636,215,18,13571,556,No,No,27919
Rhode Island,2020/5/22,872.6202636,165,23,13736,579,No,No,27919
Rhode Island,2020/5/23,872.6202636,216,18,13952,597,No,No,27919
Rhode Island,2020/5/24,872.6202636,113,11,14065,608,No,No,27919
Rhode Island,2020/5/25,872.6202636,0,0,14065,608,No,No,27919
Rhode Island,2020/5/26,872.6202636,145,26,14210,634,No,No,27919
Rhode Island,2020/5/27,872.6202636,143,21,14353,655,No,No,21335
Rhode Island,2020/5/28,872.6202636,141,22,14494,677,No,No,21335
Rhode Island,2020/5/29,872.6202636,141,16,14635,693,No,No,21335
Rhode Island,2020/5/30,872.6202636,184,18,14819,711,No,No,21335
Rhode Island,2020/5/31,872.6202636,109,7,14928,718,No,No,21335
Rhode Island,2020/6/1,872.6202636,63,2,14991,720,No,No,21335
Rhode Island,2020/6/2,872.6202636,121,12,15112,732,No,No,21335
Rhode Island,2020/6/3,872.6202636,107,10,15219,742,No,No,19949
Rhode Island,2020/6/4,872.6202636,106,14,15325,756,No,No,19949
Rhode Island,2020/6/5,872.6202636,116,16,15441,772,No,No,19949
Rhode Island,2020/6/6,872.6202636,0,0,15441,772,No,No,19949
Rhode Island,2020/6/7,872.6202636,0,0,15441,772,No,No,19949
Rhode Island,2020/6/8,872.6202636,201,27,15642,799,No,No,19949
Rhode Island,2020/6/9,872.6202636,49,9,15691,808,No,No,19949
Rhode Island,2020/6/10,872.6202636,65,4,15756,812,No,No,18367
Rhode Island,2020/6/11,872.6202636,106,11,15862,823,No,No,18367
Rhode Island,2020/6/12,872.6202636,85,10,15947,833,No,No,18367
Rhode Island,2020/6/13,872.6202636,0,0,15947,833,No,No,18367
Rhode Island,2020/6/14,872.6202636,0,0,15947,833,No,No,18367
Rhode Island,2020/6/15,872.6202636,146,18,16093,851,No,No,18367
Rhode Island,2020/6/16,872.6202636,71,14,16164,865,No,No,18367
Rhode Island,2020/6/17,872.6202636,49,11,16213,876,No,No,18671
Rhode Island,2020/6/18,872.6202636,56,9,16269,885,No,No,18671
Rhode Island,2020/6/19,872.6202636,68,9,16337,894,No,No,18671
Rhode Island,2020/6/20,872.6202636,0,0,16337,894,No,No,18671
Rhode Island,2020/6/21,872.6202636,0,0,16337,894,No,No,18671
Rhode Island,2020/6/22,872.6202636,122,9,16459,903,No,No,18671
Rhode Island,2020/6/23,872.6202636,74,3,16533,906,No,No,18671
Rhode Island,2020/6/24,872.6202636,73,6,16606,912,No,No,18338
Rhode Island,2020/6/25,872.6202636,34,8,16640,920,No,No,18338
Rhode Island,2020/6/26,872.6202636,21,7,16661,927,No,No,18338
Rhode Island,2020/6/27,872.6202636,0,0,16661,927,No,No,18338
Rhode Island,2020/6/28,872.6202636,0,0,16661,927,No,No,18338
Rhode Island,2020/6/29,872.6202636,103,19,16764,946,No,No,18338
Rhode Island,2020/6/30,872.6202636,49,4,16813,950,No,No,18338
Rhode Island,2020/7/1,872.6202636,40,6,16853,956,No,No,19056
Rhode Island,2020/7/2,872.6202636,88,3,16941,959,No,No,19056
Rhode Island,2020/7/3,872.6202636,50,1,16991,960,No,No,19056
Rhode Island,2020/7/4,872.6202636,0,0,16991,960,No,No,19056
Rhode Island,2020/7/5,872.6202636,0,0,16991,960,No,No,19056
Rhode Island,2020/7/6,872.6202636,0,0,16991,960,No,No,19056
Rhode Island,2020/7/7,872.6202636,163,9,17154,969,No,No,19056
Rhode Island,2020/7/8,872.6202636,50,2,17204,971,No,No,20563
Rhode Island,2020/7/9,872.6202636,39,3,17243,974,No,No,20563
Rhode Island,2020/7/10,872.6202636,69,2,17312,976,No,No,20563
Rhode Island,2020/7/11,872.6202636,0,0,17312,976,No,No,20563
Rhode Island,2020/7/12,872.6202636,0,0,17312,976,No,No,20563
Rhode Island,2020/7/13,872.6202636,175,8,17487,984,No,No,20563
Rhode Island,2020/7/14,872.6202636,101,1,17588,985,No,No,20563
Rhode Island,2020/7/15,872.6202636,52,2,17640,987,No,No,23676
Rhode Island,2020/7/16,872.6202636,71,1,17711,988,No,No,23676
Rhode Island,2020/7/17,872.6202636,82,2,17793,990,No,No,23676
Rhode Island,2020/7/18,872.6202636,0,0,17793,990,No,No,23676
Rhode Island,2020/7/19,872.6202636,0,0,17793,990,No,No,23676
Rhode Island,2020/7/20,872.6202636,111,5,17904,995,No,No,23676
Rhode Island,2020/7/21,872.6202636,82,1,17986,996,No,No,23676
Rhode Island,2020/7/22,872.6202636,76,1,18062,997,No,No,17437
Rhode Island,2020/7/23,872.6202636,86,4,18148,1001,No,No,17437
Rhode Island,2020/7/24,872.6202636,76,1,18224,1002,No,No,17437
Rhode Island,2020/7/25,872.6202636,0,0,18224,1002,No,No,17437
Rhode Island,2020/7/26,872.6202636,0,0,18224,1002,No,No,17437
Rhode Island,2020/7/27,872.6202636,291,2,18515,1004,No,No,17437
Rhode Island,2020/7/28,872.6202636,210,1,18725,1005,No,No,17437
Rhode Island,2020/7/29,872.6202636,75,2,18800,1007,No,No,11690
Rhode Island,2020/7/30,872.6202636,150,0,18950,1007,No,No,11690
Rhode Island,2020/7/31,872.6202636,72,0,19022,1007,No,No,11690
Rhode Island,2020/8/1,872.6202636,0,0,19022,1007,No,No,11690
Rhode Island,2020/8/2,872.6202636,0,0,19022,1007,No,No,11690
Rhode Island,2020/8/3,872.6202636,224,3,19246,1010,No,Yes,11690
Rhode Island,2020/8/4,872.6202636,144,1,19390,1011,No,Yes,11690
Rhode Island,2020/8/5,872.6202636,91,1,19481,1012,No,Yes,9467
Rhode Island,2020/8/6,872.6202636,130,2,19611,1014,No,Yes,9467
Rhode Island,2020/8/7,872.6202636,127,0,19738,1014,No,Yes,9467
Rhode Island,2020/8/8,872.6202636,0,0,19738,1014,No,Yes,9467
Rhode Island,2020/8/9,872.6202636,0,0,19738,1014,No,Yes,9467
Rhode Island,2020/8/10,872.6202636,196,1,19934,1015,No,Yes,9467
Rhode Island,2020/8/11,872.6202636,119,1,20053,1016,No,Yes,9467
Rhode Island,2020/8/12,872.6202636,76,2,20129,1018,No,Yes,11047
Rhode Island,2020/8/13,872.6202636,111,1,20240,1019,No,Yes,11047
Rhode Island,2020/8/14,872.6202636,95,2,20335,1021,No,Yes,11047
Rhode Island,2020/8/15,872.6202636,0,0,20335,1021,No,Yes,11047
Rhode Island,2020/8/16,872.6202636,0,0,20335,1021,No,Yes,11047
Rhode Island,2020/8/17,872.6202636,237,2,20572,1023,No,Yes,11047
Rhode Island,2020/8/18,872.6202636,120,1,20692,1024,No,Yes,11047
Rhode Island,2020/8/19,872.6202636,103,3,20795,1027,No,Yes,8676
Rhode Island,2020/8/20,872.6202636,76,1,20871,1028,No,Yes,8676
Rhode Island,2020/8/21,872.6202636,151,2,21022,1030,No,Yes,8676
Rhode Island,2020/8/22,872.6202636,0,0,21022,1030,No,Yes,8676
Rhode Island,2020/8/23,872.6202636,0,0,21022,1030,No,Yes,8676
Rhode Island,2020/8/24,872.6202636,280,5,21302,1035,No,Yes,8676
Rhode Island,2020/8/25,872.6202636,70,4,21372,1039,No,Yes,8676
Rhode Island,2020/8/26,872.6202636,82,2,21454,1041,No,Yes,8511
Rhode Island,2020/8/27,872.6202636,135,3,21589,1044,No,Yes,8511
Rhode Island,2020/8/28,872.6202636,94,2,21683,1046,No,Yes,8511
Rhode Island,2020/8/29,872.6202636,0,0,21683,1046,No,Yes,8511
Rhode Island,2020/8/30,872.6202636,0,0,21683,1046,No,Yes,8511
Rhode Island,2020/8/31,872.6202636,266,2,21949,1048,No,Yes,8511
Rhode Island,2020/9/1,872.6202636,53,2,22002,1050,No,Yes,8511
Rhode Island,2020/9/2,872.6202636,76,1,22078,1051,No,Yes,8901
Rhode Island,2020/9/3,872.6202636,65,4,22143,1055,No,No,8901
Rhode Island,2020/9/4,872.6202636,100,0,22243,1055,No,No,8901
Rhode Island,2020/9/5,872.6202636,0,0,22243,1055,No,No,8901
Rhode Island,2020/9/6,872.6202636,0,0,22243,1055,No,No,8901
Rhode Island,2020/9/7,872.6202636,0,0,22243,1055,No,No,8901
Rhode Island,2020/9/8,872.6202636,349,4,22592,1059,No,No,8901
Rhode Island,2020/9/9,872.6202636,84,3,22676,1062,No,No,8848
Rhode Island,2020/9/10,872.6202636,106,5,22782,1067,No,No,8848
Rhode Island,2020/9/11,872.6202636,123,4,22905,1071,No,No,8848
Rhode Island,2020/9/12,872.6202636,0,0,22905,1071,No,No,8848
Rhode Island,2020/9/13,872.6202636,0,0,22905,1071,No,No,8848
Rhode Island,2020/9/14,872.6202636,225,4,23130,1075,No,No,8848
Rhode Island,2020/9/15,872.6202636,120,3,23250,1078,No,No,8848
Rhode Island,2020/9/16,872.6202636,108,3,23358,1081,No,No,8679
Rhode Island,2020/9/17,872.6202636,130,4,23488,1085,No,No,8679
Rhode Island,2020/9/18,872.6202636,132,3,23620,1088,No,No,8679
Rhode Island,2020/9/19,872.6202636,0,0,23620,1088,No,No,8679
Rhode Island,2020/9/20,872.6202636,0,0,23620,1088,No,No,8679
Rhode Island,2020/9/21,872.6202636,312,9,23932,1097,No,No,8679
Rhode Island,2020/9/22,872.6202636,112,2,24044,1099,No,No,8679
Rhode Island,2020/9/23,872.6202636,133,3,24177,1102,No,No,8805
Rhode Island,2020/9/24,872.6202636,134,4,24311,1106,No,No,8805
Rhode Island,2020/9/25,872.6202636,-130,1,24181,1107,No,No,8805
Rhode Island,2020/9/26,872.6202636,0,0,24181,1107,No,No,8805
Rhode Island,2020/9/27,872.6202636,0,0,24181,1107,No,No,8805
Rhode Island,2020/9/28,872.6202636,243,3,24424,1110,No,No,8805
Rhode Island,2020/9/29,872.6202636,132,3,24556,1113,No,No,8805
Rhode Island,2020/9/30,872.6202636,192,1,24748,1114,No,No,7732
Rhode Island,2020/10/1,872.6202636,166,3,24914,1117,No,No,7732
Rhode Island,2020/10/2,872.6202636,162,1,25076,1118,No,No,7732
Rhode Island,2020/10/3,872.6202636,0,0,25076,1118,No,No,7732
Rhode Island,2020/10/4,872.6202636,0,0,25076,1118,No,No,7732
Rhode Island,2020/10/5,872.6202636,343,3,25419,1121,No,No,7732
Rhode Island,2020/10/6,872.6202636,177,4,25596,1125,No,No,7732
Rhode Island,2020/10/7,872.6202636,180,1,25776,1126,No,No,8581
Rhode Island,2020/10/8,872.6202636,269,1,26045,1127,No,No,8581
Rhode Island,2020/10/9,872.6202636,249,3,26294,1130,No,No,8581
Rhode Island,2020/10/10,872.6202636,0,0,26294,1130,No,No,8581
Rhode Island,2020/10/11,872.6202636,0,0,26294,1130,No,No,8581
Rhode Island,2020/10/12,872.6202636,0,0,26294,1130,No,No,8581
Rhode Island,2020/10/13,872.6202636,666,9,26960,1139,No,No,8581
Rhode Island,2020/10/14,872.6202636,204,8,27164,1147,No,No,7964
Rhode Island,2020/10/15,872.6202636,274,2,27438,1149,No,No,7964
Rhode Island,2020/10/16,872.6202636,253,3,27691,1152,No,No,7964
Rhode Island,2020/10/17,872.6202636,0,0,27691,1152,No,No,7964
Rhode Island,2020/10/18,872.6202636,0,0,27691,1152,No,No,7964
Rhode Island,2020/10/19,872.6202636,656,7,28347,1159,No,No,7964
Rhode Island,2020/10/20,872.6202636,302,5,28649,1164,No,No,7964
Rhode Island,2020/10/21,872.6202636,474,5,29123,1169,No,No,7126
Rhode Island,2020/10/22,872.6202636,471,4,29594,1173,No,No,7126
Rhode Island,2020/10/23,872.6202636,524,4,30118,1177,No,No,7126
Rhode Island,2020/10/24,872.6202636,0,0,30118,1177,No,No,7126
Rhode Island,2020/10/25,872.6202636,0,0,30118,1177,No,No,7126
Rhode Island,2020/10/26,872.6202636,906,7,31024,1184,No,No,7126
Rhode Island,2020/10/27,872.6202636,421,4,31445,1188,No,No,7126
Rhode Island,2020/10/28,872.6202636,499,4,31944,1192,No,No,7060
Rhode Island,2020/10/29,872.6202636,368,3,32312,1195,No,No,7060
Rhode Island,2020/10/30,872.6202636,562,6,32874,1201,No,No,7060
Rhode Island,2020/10/31,872.6202636,0,0,32874,1201,No,No,7060
Rhode Island,2020/11/1,872.6202636,0,0,32874,1201,No,No,7060
Rhode Island,2020/11/2,872.6202636,1246,9,34120,1210,No,No,7060
Rhode Island,2020/11/3,872.6202636,423,2,34543,1212,No,No,7060
Rhode Island,2020/11/4,872.6202636,579,2,35122,1214,No,No,8764
Rhode Island,2020/11/5,872.6202636,628,8,35750,1222,No,No,8764
Rhode Island,2020/11/6,872.6202636,630,2,36380,1224,No,No,8764
Rhode Island,2020/11/7,872.6202636,0,0,36380,1224,No,No,8764
Rhode Island,2020/11/8,872.6202636,0,0,36380,1224,No,No,8764
Rhode Island,2020/11/9,872.6202636,1629,9,38009,1233,No,No,8764
Rhode Island,2020/11/10,872.6202636,789,4,38798,1237,No,No,8764
Rhode Island,2020/11/11,872.6202636,978,6,39776,1243,No,No,9262
Rhode Island,2020/11/12,872.6202636,988,7,40764,1250,No,No,9262
Rhode Island,2020/11/13,872.6202636,765,4,41529,1254,No,No,9262
Rhode Island,2020/11/14,872.6202636,0,0,41529,1254,No,No,9262
Rhode Island,2020/11/15,872.6202636,0,0,41529,1254,No,No,9262
Rhode Island,2020/11/16,872.6202636,2394,16,43923,1270,No,No,9262
Rhode Island,2020/11/17,872.6202636,605,8,44528,1278,No,No,9262
Rhode Island,2020/11/18,872.6202636,1383,6,45911,1284,No,No,11813
Rhode Island,2020/11/19,872.6202636,1040,4,46951,1288,No,No,11813
Rhode Island,2020/11/20,872.6202636,1050,6,48001,1294,No,No,11813
Rhode Island,2020/11/21,872.6202636,0,0,48001,1294,No,No,11813
Rhode Island,2020/11/22,872.6202636,0,0,48001,1294,No,No,11813
Rhode Island,2020/11/23,872.6202636,2572,15,50573,1309,No,No,11813
Rhode Island,2020/11/24,872.6202636,851,16,51424,1325,No,No,11813
Rhode Island,2020/11/25,872.6202636,893,10,52317,1335,No,No,7061
Rhode Island,2020/11/26,872.6202636,0,0,52317,1335,No,No,7061
Rhode Island,2020/11/27,872.6202636,1637,11,53954,1346,No,No,7061
Rhode Island,2020/11/28,872.6202636,0,0,53954,1346,No,No,7061
Rhode Island,2020/11/29,872.6202636,0,0,53954,1346,No,No,7061
Rhode Island,2020/11/30,872.6202636,2769,27,56723,1373,No,No,7061
Rhode Island,2020/12/1,872.6202636,1183,7,57906,1380,No,No,7061
Rhode Island,2020/12/2,872.6202636,1099,11,59005,1391,No,No,7656
Rhode Island,2020/12/3,872.6202636,1717,9,60722,1400,No,No,7656
Rhode Island,2020/12/4,872.6202636,1415,13,62137,1413,No,No,7656
Rhode Island,2020/12/5,872.6202636,0,0,62137,1413,No,No,7656
Rhode Island,2020/12/6,872.6202636,0,0,62137,1413,No,No,7656
Rhode Island,2020/12/7,872.6202636,3681,35,65818,1448,No,No,7656
Rhode Island,2020/12/8,872.6202636,1249,22,67067,1470,No,No,7656
Rhode Island,2020/12/9,872.6202636,1232,14,68299,1484,No,No,7568
Rhode Island,2020/12/10,872.6202636,948,14,69247,1498,No,No,7568
Rhode Island,2020/12/11,872.6202636,1571,11,70818,1509,No,No,7568
Rhode Island,2020/12/12,872.6202636,0,0,70818,1509,No,No,7568
Rhode Island,2020/12/13,872.6202636,0,0,70818,1509,No,No,7568
Rhode Island,2020/12/14,872.6202636,3253,46,74071,1555,No,No,7568
Rhode Island,2020/12/15,872.6202636,1166,15,75237,1570,No,No,7568
Rhode Island,2020/12/16,872.6202636,972,20,76209,1590,No,No,7543
Rhode Island,2020/12/17,872.6202636,1081,12,77290,1602,No,No,7543
Rhode Island,2020/12/18,872.6202636,522,23,77812,1625,No,No,7543
Rhode Island,2020/12/19,872.6202636,0,0,77812,1625,No,No,7543
Rhode Island,2020/12/20,872.6202636,0,0,77812,1625,No,No,7543
Rhode Island,2020/12/21,872.6202636,2419,45,80231,1670,No,No,7543
Rhode Island,2020/12/22,872.6202636,956,8,81187,1678,No,No,7543
Rhode Island,2020/12/23,872.6202636,879,26,82066,1704,No,No,5506
Rhode Island,2020/12/24,872.6202636,0,0,82066,1704,No,No,5506
Rhode Island,2020/12/25,872.6202636,0,0,82066,1704,No,No,5506
Rhode Island,2020/12/26,872.6202636,0,0,82066,1704,No,No,5506
Rhode Island,2020/12/27,872.6202636,0,0,82066,1704,No,No,5506
Rhode Island,2020/12/28,872.6202636,3536,38,85602,1742,No,No,5506
Rhode Island,2020/12/29,872.6202636,1187,18,86789,1760,No,No,5506
Rhode Island,2020/12/30,872.6202636,1160,17,87949,1777,No,No,10986
Rhode Island,2020/12/31,872.6202636,0,0,87949,1777,No,No,10986
Rhode Island,2021/1/1,872.6202636,0,0,87949,1777,No,No,10986
Rhode Island,2021/1/2,872.6202636,0,0,87949,1777,No,No,10986
Rhode Island,2021/1/3,872.6202636,0,0,87949,1777,No,No,10986
Rhode Island,2021/1/4,872.6202636,4759,78,92708,1855,No,No,10986
Rhode Island,2021/1/5,872.6202636,1144,15,93852,1870,No,No,10986
Rhode Island,2021/1/6,872.6202636,1611,20,95463,1890,No,No,14084
Rhode Island,2021/1/7,872.6202636,1128,20,96591,1910,No,No,14084
Rhode Island,2021/1/8,872.6202636,1023,6,97614,1916,No,No,14084
Rhode Island,2021/1/9,872.6202636,0,0,97614,1916,No,No,14084
Rhode Island,2021/1/10,872.6202636,0,0,97614,1916,No,No,14084
Rhode Island,2021/1/11,872.6202636,2993,31,100607,1947,No,No,14084
Rhode Island,2021/1/12,872.6202636,786,23,101393,1970,No,No,14084
Rhode Island,2021/1/13,872.6202636,1092,17,102485,1987,No,No,11980
Rhode Island,2021/1/14,872.6202636,901,9,103386,1996,No,No,11980
Rhode Island,2021/1/15,872.6202636,1057,9,104443,2005,No,No,11980
Rhode Island,2021/1/16,872.6202636,0,0,104443,2005,No,No,11980
Rhode Island,2021/1/17,872.6202636,0,0,104443,2005,No,No,11980
Rhode Island,2021/1/18,872.6202636,0,0,104443,2005,No,No,11980
Rhode Island,2021/1/19,872.6202636,2623,40,107066,2045,No,No,11980
Rhode Island,2021/1/20,872.6202636,810,13,107876,2058,No,No,11615
Rhode Island,2021/1/21,872.6202636,910,18,108786,2076,No,No,11615
Rhode Island,2021/1/22,872.6202636,949,7,109735,2083,No,No,11615
Rhode Island,2021/1/23,872.6202636,0,0,109735,2083,No,No,11615
Rhode Island,2021/1/24,872.6202636,0,0,109735,2083,No,No,11615
Rhode Island,2021/1/25,872.6202636,2019,27,111754,2110,No,No,11615
Rhode Island,2021/1/26,872.6202636,642,16,112396,2126,No,No,11615
Rhode Island,2021/1/27,872.6202636,613,9,113009,2135,No,No,12664
Rhode Island,2021/1/28,872.6202636,745,9,113754,2144,No,No,12664
Rhode Island,2021/1/29,872.6202636,684,10,114438,2154,No,No,12664
Rhode Island,2021/1/30,872.6202636,0,0,114438,2154,No,No,12664
Rhode Island,2021/1/31,872.6202636,0,0,114438,2154,No,No,12664
Rhode Island,2021/2/1,872.6202636,1518,19,115956,2173,No,No,12664
Rhode Island,2021/2/2,872.6202636,235,13,116191,2186,No,No,12664
Rhode Island,2021/2/3,872.6202636,513,12,116704,2198,No,No,13464
Rhode Island,2021/2/4,872.6202636,587,11,117291,2209,No,No,13464
Rhode Island,2021/2/5,872.6202636,600,3,117891,2212,No,No,13464
Rhode Island,2021/2/6,872.6202636,0,0,117891,2212,No,No,13464
Rhode Island,2021/2/7,872.6202636,0,0,117891,2212,No,No,13464
Rhode Island,2021/2/8,872.6202636,1213,24,119104,2236,No,No,13464
Rhode Island,2021/2/9,872.6202636,330,12,119434,2248,No,No,13464
Rhode Island,2021/2/10,872.6202636,459,11,119893,2259,No,No,12087
Rhode Island,2021/2/11,872.6202636,488,15,120381,2274,No,No,12087
Rhode Island,2021/2/12,872.6202636,440,16,120821,2290,No,No,12087
Rhode Island,2021/2/13,872.6202636,0,0,120821,2290,No,No,12087
Rhode Island,2021/2/14,872.6202636,0,0,120821,2290,No,No,12087
Rhode Island,2021/2/15,872.6202636,966,44,121787,2334,No,No,12087
Rhode Island,2021/2/16,872.6202636,285,10,122072,2344,No,No,12087
Rhode Island,2021/2/17,872.6202636,368,8,122440,2352,No,No,11395
Rhode Island,2021/2/18,872.6202636,419,15,122859,2367,No,No,11395
Rhode Island,2021/2/19,872.6202636,286,9,123145,2376,No,No,11395
Rhode Island,2021/2/20,872.6202636,0,0,123145,2376,No,No,11395
Rhode Island,2021/2/21,872.6202636,0,0,123145,2376,No,No,11395
Rhode Island,2021/2/22,872.6202636,835,90,123980,2466,No,No,11395
Rhode Island,2021/2/23,872.6202636,282,10,124262,2476,No,No,11395
Rhode Island,2021/2/24,872.6202636,456,11,124718,2487,No,No,11395
Rhode Island,2021/2/25,872.6202636,467,9,125185,2496,No,No,11395
Rhode Island,2021/2/26,872.6202636,437,6,125622,2502,No,No,11395
Rhode Island,2021/2/27,872.6202636,0,0,125622,2502,No,No,11395
Rhode Island,2021/2/28,872.6202636,0,0,125622,2502,No,No,11395
Rhode Island,2021/3/1,872.6202636,966,15,126588,2517,No,No,11395
Rhode Island,2021/3/2,872.6202636,261,8,126849,2525,No,No,11395
Rhode Island,2021/3/3,872.6202636,436,9,127285,2534,No,No,11395
Rhode Island,2021/3/4,872.6202636,442,5,127727,2539,No,No,11395
South Carolina,2020/3/1,165.7933988,0,0,0,0,No,No,1575
South Carolina,2020/3/2,165.7933988,0,0,0,0,No,No,1575
South Carolina,2020/3/3,165.7933988,0,0,0,0,No,No,1575
South Carolina,2020/3/4,165.7933988,0,0,0,0,No,No,1663
South Carolina,2020/3/5,165.7933988,0,0,0,0,No,No,1663
South Carolina,2020/3/6,165.7933988,2,0,2,0,No,No,1663
South Carolina,2020/3/7,165.7933988,0,0,2,0,No,No,1663
South Carolina,2020/3/8,165.7933988,4,0,6,0,No,No,1663
South Carolina,2020/3/9,165.7933988,1,0,7,0,No,No,1663
South Carolina,2020/3/10,165.7933988,2,0,9,0,No,No,1663
South Carolina,2020/3/11,165.7933988,1,0,10,0,No,No,1819
South Carolina,2020/3/12,165.7933988,2,0,12,0,No,No,1819
South Carolina,2020/3/13,165.7933988,1,0,13,0,No,No,1819
South Carolina,2020/3/14,165.7933988,6,0,19,0,No,No,1819
South Carolina,2020/3/15,165.7933988,9,0,28,0,No,No,1819
South Carolina,2020/3/16,165.7933988,5,1,33,1,No,No,1819
South Carolina,2020/3/17,165.7933988,14,0,47,1,No,No,1819
South Carolina,2020/3/18,165.7933988,13,0,60,1,No,No,10892
South Carolina,2020/3/19,165.7933988,21,0,81,1,No,No,10892
South Carolina,2020/3/20,165.7933988,45,2,126,3,No,No,10892
South Carolina,2020/3/21,165.7933988,46,0,172,3,No,No,10892
South Carolina,2020/3/22,165.7933988,22,0,194,3,No,No,10892
South Carolina,2020/3/23,165.7933988,105,2,299,5,No,No,10892
South Carolina,2020/3/24,165.7933988,43,3,342,8,No,No,10892
South Carolina,2020/3/25,165.7933988,83,0,425,8,No,No,80984
South Carolina,2020/3/26,165.7933988,31,1,456,9,No,No,80984
South Carolina,2020/3/27,165.7933988,86,4,542,13,No,No,80984
South Carolina,2020/3/28,165.7933988,119,2,661,15,No,No,80984
South Carolina,2020/3/29,165.7933988,114,1,775,16,No,No,80984
South Carolina,2020/3/30,165.7933988,150,2,925,18,No,No,80984
South Carolina,2020/3/31,165.7933988,158,4,1083,22,No,No,80984
South Carolina,2020/4/1,165.7933988,210,4,1293,26,No,No,106739
South Carolina,2020/4/2,165.7933988,261,5,1554,31,No,No,106739
South Carolina,2020/4/3,165.7933988,146,3,1700,34,No,No,106739
South Carolina,2020/4/4,165.7933988,217,6,1917,40,No,No,106739
South Carolina,2020/4/5,165.7933988,132,4,2049,44,No,No,106739
South Carolina,2020/4/6,165.7933988,183,4,2232,48,No,No,106739
South Carolina,2020/4/7,165.7933988,185,3,2417,51,Yes,No,106739
South Carolina,2020/4/8,165.7933988,135,12,2552,63,Yes,No,77515
South Carolina,2020/4/9,165.7933988,240,4,2792,67,Yes,No,77515
South Carolina,2020/4/10,165.7933988,273,5,3065,72,Yes,No,77515
South Carolina,2020/4/11,165.7933988,142,8,3207,80,Yes,No,77515
South Carolina,2020/4/12,165.7933988,112,2,3319,82,Yes,No,77515
South Carolina,2020/4/13,165.7933988,120,5,3439,87,Yes,No,77515
South Carolina,2020/4/14,165.7933988,114,10,3553,97,Yes,No,77515
South Carolina,2020/4/15,165.7933988,103,10,3656,107,Yes,No,66432
South Carolina,2020/4/16,165.7933988,275,2,3931,109,Yes,No,66432
South Carolina,2020/4/17,165.7933988,155,7,4086,116,Yes,No,66432
South Carolina,2020/4/18,165.7933988,160,3,4246,119,Yes,No,66432
South Carolina,2020/4/19,165.7933988,131,1,4377,120,Yes,No,66432
South Carolina,2020/4/20,165.7933988,62,4,4439,124,Yes,No,66432
South Carolina,2020/4/21,165.7933988,169,11,4608,135,Yes,No,66432
South Carolina,2020/4/22,165.7933988,153,5,4761,140,Yes,No,74966
South Carolina,2020/4/23,165.7933988,156,10,4917,150,Yes,No,74966
South Carolina,2020/4/24,165.7933988,153,7,5070,157,Yes,No,74966
South Carolina,2020/4/25,165.7933988,183,9,5253,166,Yes,No,74966
South Carolina,2020/4/26,165.7933988,237,8,5490,174,Yes,No,74966
South Carolina,2020/4/27,165.7933988,123,3,5613,177,Yes,No,74966
South Carolina,2020/4/28,165.7933988,122,15,5735,192,Yes,No,74966
South Carolina,2020/4/29,165.7933988,146,40,5881,232,Yes,No,28985
South Carolina,2020/4/30,165.7933988,214,12,6095,244,Yes,No,28985
South Carolina,2020/5/1,165.7933988,163,12,6258,256,Yes,No,28985
South Carolina,2020/5/2,165.7933988,231,11,6489,267,Yes,No,28985
South Carolina,2020/5/3,165.7933988,137,8,6626,275,Yes,No,28985
South Carolina,2020/5/4,165.7933988,131,8,6757,283,Yes,No,28985
South Carolina,2020/5/5,165.7933988,84,13,6841,296,No,No,28985
South Carolina,2020/5/6,165.7933988,95,9,6936,305,No,No,26666
South Carolina,2020/5/7,165.7933988,206,11,7142,316,No,No,26666
South Carolina,2020/5/8,165.7933988,225,4,7367,320,No,No,26666
South Carolina,2020/5/9,165.7933988,164,10,7531,330,No,No,26666
South Carolina,2020/5/10,165.7933988,122,1,7653,331,No,No,26666
South Carolina,2020/5/11,165.7933988,139,15,7792,346,No,No,26666
South Carolina,2020/5/12,165.7933988,135,9,7927,355,No,No,26666
South Carolina,2020/5/13,165.7933988,103,7,8030,362,No,No,25150
South Carolina,2020/5/14,165.7933988,159,9,8189,371,No,No,25150
South Carolina,2020/5/15,165.7933988,218,9,8407,380,No,No,25150
South Carolina,2020/5/16,165.7933988,254,0,8661,380,No,No,25150
South Carolina,2020/5/17,165.7933988,155,5,8816,385,No,No,25150
South Carolina,2020/5/18,165.7933988,126,6,8942,391,No,No,25150
South Carolina,2020/5/19,165.7933988,114,8,9056,399,No,No,25150
South Carolina,2020/5/20,165.7933988,119,8,9175,407,No,No,27919
South Carolina,2020/5/21,165.7933988,204,9,9379,416,No,No,27919
South Carolina,2020/5/22,165.7933988,259,3,9638,419,No,No,27919
South Carolina,2020/5/23,165.7933988,257,6,9895,425,No,No,27919
South Carolina,2020/5/24,165.7933988,201,10,10096,435,No,No,27919
South Carolina,2020/5/25,165.7933988,82,5,10178,440,No,No,27919
South Carolina,2020/5/26,165.7933988,238,6,10416,446,No,No,27919
South Carolina,2020/5/27,165.7933988,207,20,10623,466,No,No,21335
South Carolina,2020/5/28,165.7933988,165,4,10788,470,No,No,21335
South Carolina,2020/5/29,165.7933988,343,13,11131,483,No,No,21335
South Carolina,2020/5/30,165.7933988,263,4,11394,487,No,No,21335
South Carolina,2020/5/31,165.7933988,467,7,11861,494,No,No,21335
South Carolina,2020/6/1,165.7933988,287,6,12148,500,No,No,21335
South Carolina,2020/6/2,165.7933988,267,1,12415,501,No,No,21335
South Carolina,2020/6/3,165.7933988,236,17,12651,518,No,No,19949
South Carolina,2020/6/4,165.7933988,354,7,13005,525,No,No,19949
South Carolina,2020/6/5,165.7933988,448,13,13453,538,No,No,19949
South Carolina,2020/6/6,165.7933988,463,7,13916,545,No,No,19949
South Carolina,2020/6/7,165.7933988,370,1,14286,546,No,No,19949
South Carolina,2020/6/8,165.7933988,514,11,14800,557,No,No,19949
South Carolina,2020/6/9,165.7933988,428,11,15228,568,No,No,19949
South Carolina,2020/6/10,165.7933988,531,7,15759,575,No,No,18367
South Carolina,2020/6/11,165.7933988,682,13,16441,588,No,No,18367
South Carolina,2020/6/12,165.7933988,729,5,17170,593,No,No,18367
South Carolina,2020/6/13,165.7933988,785,6,17955,599,No,No,18367
South Carolina,2020/6/14,165.7933988,841,1,18796,600,No,No,18367
South Carolina,2020/6/15,165.7933988,585,2,19381,602,No,No,18367
South Carolina,2020/6/16,165.7933988,614,5,19995,607,No,No,18367
South Carolina,2020/6/17,165.7933988,561,10,20556,617,No,No,18671
South Carolina,2020/6/18,165.7933988,992,4,21548,621,No,No,18671
South Carolina,2020/6/19,165.7933988,1083,18,22631,639,No,No,18671
South Carolina,2020/6/20,165.7933988,1155,5,23786,644,No,No,18671
South Carolina,2020/6/21,165.7933988,907,9,24693,653,No,No,18671
South Carolina,2020/6/22,165.7933988,1008,6,25701,659,No,No,18671
South Carolina,2020/6/23,165.7933988,912,14,26613,673,No,No,18671
South Carolina,2020/6/24,165.7933988,1284,10,27897,683,No,No,18338
South Carolina,2020/6/25,165.7933988,1125,10,29022,693,No,No,18338
South Carolina,2020/6/26,165.7933988,1313,1,30335,694,No,No,18338
South Carolina,2020/6/27,165.7933988,1604,17,31939,711,No,No,18338
South Carolina,2020/6/28,165.7933988,1381,5,33320,716,No,No,18338
South Carolina,2020/6/29,165.7933988,1324,4,34644,720,No,No,18338
South Carolina,2020/6/30,165.7933988,1755,19,36399,739,No,No,18338
South Carolina,2020/7/1,165.7933988,1520,27,37919,766,No,No,19056
South Carolina,2020/7/2,165.7933988,1782,18,39701,784,No,No,19056
South Carolina,2020/7/3,165.7933988,1831,9,41532,793,No,No,19056
South Carolina,2020/7/4,165.7933988,1854,20,43386,813,No,No,19056
South Carolina,2020/7/5,165.7933988,1461,7,44847,820,No,No,19056
South Carolina,2020/7/6,165.7933988,1533,7,46380,827,No,No,19056
South Carolina,2020/7/7,165.7933988,972,19,47352,846,No,No,19056
South Carolina,2020/7/8,165.7933988,1557,38,48909,884,No,No,20563
South Carolina,2020/7/9,165.7933988,1782,21,50691,905,No,No,20563
South Carolina,2020/7/10,165.7933988,1728,24,52419,929,No,No,20563
South Carolina,2020/7/11,165.7933988,2280,22,54699,951,No,No,20563
South Carolina,2020/7/12,165.7933988,1949,10,56648,961,No,No,20563
South Carolina,2020/7/13,165.7933988,1520,11,58168,972,No,No,20563
South Carolina,2020/7/14,165.7933988,2221,21,60389,993,No,No,20563
South Carolina,2020/7/15,165.7933988,1856,5,62245,998,No,No,23676
South Carolina,2020/7/16,165.7933988,1838,72,64083,1070,No,No,23676
South Carolina,2020/7/17,165.7933988,1977,26,66060,1096,No,No,23676
South Carolina,2020/7/18,165.7933988,1552,39,67612,1135,No,No,23676
South Carolina,2020/7/19,165.7933988,2374,20,69986,1155,No,No,23676
South Carolina,2020/7/20,165.7933988,1459,9,71445,1164,No,No,23676
South Carolina,2020/7/21,165.7933988,1892,57,73337,1221,No,No,23676
South Carolina,2020/7/22,165.7933988,1705,64,75042,1285,No,No,17437
South Carolina,2020/7/23,165.7933988,1564,49,76606,1334,No,No,17437
South Carolina,2020/7/24,165.7933988,2001,51,78607,1385,No,No,17437
South Carolina,2020/7/25,165.7933988,1401,80,80008,1465,No,No,17437
South Carolina,2020/7/26,165.7933988,1191,26,81199,1491,No,No,17437
South Carolina,2020/7/27,165.7933988,1218,15,82417,1506,No,No,17437
South Carolina,2020/7/28,165.7933988,1692,59,84109,1565,No,No,17437
South Carolina,2020/7/29,165.7933988,1737,50,85846,1615,No,No,11690
South Carolina,2020/7/30,165.7933988,1726,52,87572,1667,No,No,11690
South Carolina,2020/7/31,165.7933988,1444,45,89016,1712,No,No,11690
South Carolina,2020/8/1,165.7933988,1583,39,90599,1751,No,No,11690
South Carolina,2020/8/2,165.7933988,1189,26,91788,1777,No,Yes,11690
South Carolina,2020/8/3,165.7933988,1163,16,92951,1793,No,Yes,11690
South Carolina,2020/8/4,165.7933988,1239,54,94190,1847,No,Yes,11690
South Carolina,2020/8/5,165.7933988,1282,47,95472,1894,No,Yes,9467
South Carolina,2020/8/6,165.7933988,1325,49,96797,1943,No,Yes,9467
South Carolina,2020/8/7,165.7933988,1422,19,98219,1962,No,Yes,9467
South Carolina,2020/8/8,165.7933988,1241,45,99460,2007,No,Yes,9467
South Carolina,2020/8/9,165.7933988,975,24,100435,2031,No,Yes,9467
South Carolina,2020/8/10,165.7933988,724,18,101159,2049,No,Yes,9467
South Carolina,2020/8/11,165.7933988,971,49,102130,2098,No,Yes,9467
South Carolina,2020/8/12,165.7933988,844,46,102974,2144,No,Yes,11047
South Carolina,2020/8/13,165.7933988,935,42,103909,2186,No,Yes,11047
South Carolina,2020/8/14,165.7933988,932,18,104841,2204,No,Yes,11047
South Carolina,2020/8/15,165.7933988,1041,56,105882,2260,No,Yes,11047
South Carolina,2020/8/16,165.7933988,615,9,106497,2269,No,Yes,11047
South Carolina,2020/8/17,165.7933988,456,19,106953,2288,No,Yes,11047
South Carolina,2020/8/18,165.7933988,719,55,107672,2343,No,Yes,11047
South Carolina,2020/8/19,165.7933988,739,17,108411,2360,No,Yes,8676
South Carolina,2020/8/20,165.7933988,909,41,109320,2401,No,Yes,8676
South Carolina,2020/8/21,165.7933988,1058,58,110378,2459,No,Yes,8676
South Carolina,2020/8/22,165.7933988,917,34,111295,2493,No,Yes,8676
South Carolina,2020/8/23,165.7933988,693,11,111988,2504,No,Yes,8676
South Carolina,2020/8/24,165.7933988,563,7,112551,2511,No,Yes,8676
South Carolina,2020/8/25,165.7933988,937,18,113488,2529,No,Yes,8676
South Carolina,2020/8/26,165.7933988,605,44,114093,2573,No,Yes,8511
South Carolina,2020/8/27,165.7933988,505,55,114598,2628,No,Yes,8511
South Carolina,2020/8/28,165.7933988,1353,27,115951,2655,No,Yes,8511
South Carolina,2020/8/29,165.7933988,1298,43,117249,2698,No,Yes,8511
South Carolina,2020/8/30,165.7933988,1075,11,118324,2709,No,Yes,8511
South Carolina,2020/8/31,165.7933988,668,11,118992,2720,No,Yes,8511
South Carolina,2020/9/1,165.7933988,854,37,119846,2757,No,Yes,8511
South Carolina,2020/9/2,165.7933988,657,37,120503,2794,No,Yes,8901
South Carolina,2020/9/3,165.7933988,1193,13,121696,2807,No,Yes,8901
South Carolina,2020/9/4,165.7933988,1629,39,123325,2846,No,Yes,8901
South Carolina,2020/9/5,165.7933988,964,31,124289,2877,No,Yes,8901
South Carolina,2020/9/6,165.7933988,663,10,124952,2887,No,Yes,8901
South Carolina,2020/9/7,165.7933988,655,20,125607,2907,No,Yes,8901
South Carolina,2020/9/8,165.7933988,301,5,125908,2912,No,Yes,8901
South Carolina,2020/9/9,165.7933988,305,30,126213,2942,No,Yes,8848
South Carolina,2020/9/10,165.7933988,379,33,126592,2975,No,Yes,8848
South Carolina,2020/9/11,165.7933988,2454,53,129046,3028,No,Yes,8848
South Carolina,2020/9/12,165.7933988,932,12,129978,3040,No,Yes,8848
South Carolina,2020/9/13,165.7933988,1886,24,131864,3064,No,Yes,8848
South Carolina,2020/9/14,165.7933988,816,13,132680,3077,No,Yes,8848
South Carolina,2020/9/15,165.7933988,790,21,133470,3098,No,Yes,8848
South Carolina,2020/9/16,165.7933988,652,34,134122,3132,No,Yes,8679
South Carolina,2020/9/17,165.7933988,1324,26,135446,3158,No,Yes,8679
South Carolina,2020/9/18,165.7933988,872,19,136318,3177,No,Yes,8679
South Carolina,2020/9/19,165.7933988,922,11,137240,3188,No,Yes,8679
South Carolina,2020/9/20,165.7933988,468,11,137708,3199,No,Yes,8679
South Carolina,2020/9/21,165.7933988,416,13,138124,3212,No,Yes,8679
South Carolina,2020/9/22,165.7933988,2665,31,140789,3243,No,Yes,8679
South Carolina,2020/9/23,165.7933988,897,19,141686,3262,No,Yes,8805
South Carolina,2020/9/24,165.7933988,1021,17,142707,3279,No,Yes,8805
South Carolina,2020/9/25,165.7933988,1195,18,143902,3297,No,Yes,8805
South Carolina,2020/9/26,165.7933988,1371,26,145273,3323,No,Yes,8805
South Carolina,2020/9/27,165.7933988,614,3,145887,3326,No,Yes,8805
South Carolina,2020/9/28,165.7933988,568,11,146455,3337,No,Yes,8805
South Carolina,2020/9/29,165.7933988,1179,22,147634,3359,No,Yes,8805
South Carolina,2020/9/30,165.7933988,308,19,147942,3378,No,Yes,7732
South Carolina,2020/10/1,165.7933988,381,22,148323,3400,No,Yes,7732
South Carolina,2020/10/2,165.7933988,862,9,149185,3409,No,Yes,7732
South Carolina,2020/10/3,165.7933988,1706,33,150891,3442,No,Yes,7732
South Carolina,2020/10/4,165.7933988,691,11,151582,3453,No,Yes,7732
South Carolina,2020/10/5,165.7933988,577,3,152159,3456,No,Yes,7732
South Carolina,2020/10/6,165.7933988,811,15,152970,3471,No,Yes,7732
South Carolina,2020/10/7,165.7933988,735,31,153705,3502,No,Yes,8581
South Carolina,2020/10/8,165.7933988,1050,12,154755,3514,No,Yes,8581
South Carolina,2020/10/9,165.7933988,921,16,155676,3530,No,Yes,8581
South Carolina,2020/10/10,165.7933988,945,21,156621,3551,No,Yes,8581
South Carolina,2020/10/11,165.7933988,785,1,157406,3552,No,Yes,8581
South Carolina,2020/10/12,165.7933988,649,7,158055,3559,No,Yes,8581
South Carolina,2020/10/13,165.7933988,828,17,158883,3576,No,Yes,8581
South Carolina,2020/10/14,165.7933988,926,17,159809,3593,No,Yes,7964
South Carolina,2020/10/15,165.7933988,1297,14,161106,3607,No,Yes,7964
South Carolina,2020/10/16,165.7933988,1147,8,162253,3615,No,Yes,7964
South Carolina,2020/10/17,165.7933988,961,22,163214,3637,No,Yes,7964
South Carolina,2020/10/18,165.7933988,776,13,163990,3650,No,Yes,7964
South Carolina,2020/10/19,165.7933988,619,11,164609,3661,No,Yes,7964
South Carolina,2020/10/20,165.7933988,884,35,165493,3696,No,Yes,7964
South Carolina,2020/10/21,165.7933988,864,12,166357,3708,No,Yes,7126
South Carolina,2020/10/22,165.7933988,1128,47,167485,3755,No,Yes,7126
South Carolina,2020/10/23,165.7933988,1064,22,168549,3777,No,Yes,7126
South Carolina,2020/10/24,165.7933988,792,16,169341,3793,No,Yes,7126
South Carolina,2020/10/25,165.7933988,1337,9,170678,3802,No,Yes,7126
South Carolina,2020/10/26,165.7933988,823,21,171501,3823,No,Yes,7126
South Carolina,2020/10/27,165.7933988,1078,19,172579,3842,No,Yes,7126
South Carolina,2020/10/28,165.7933988,912,34,173491,3876,No,Yes,7060
South Carolina,2020/10/29,165.7933988,1100,13,174591,3889,No,Yes,7060
South Carolina,2020/10/30,165.7933988,1003,7,175594,3896,No,Yes,7060
South Carolina,2020/10/31,165.7933988,1018,39,176612,3935,No,Yes,7060
South Carolina,2020/11/1,165.7933988,1411,1,178023,3936,No,Yes,7060
South Carolina,2020/11/2,165.7933988,894,10,178917,3946,No,Yes,7060
South Carolina,2020/11/3,165.7933988,1035,22,179952,3968,No,Yes,7060
South Carolina,2020/11/4,165.7933988,918,17,180870,3985,No,Yes,8764
South Carolina,2020/11/5,165.7933988,769,7,181639,3992,No,Yes,8764
South Carolina,2020/11/6,165.7933988,1233,13,182872,4005,No,Yes,8764
South Carolina,2020/11/7,165.7933988,1870,10,184742,4015,No,Yes,8764
South Carolina,2020/11/8,165.7933988,946,21,185688,4036,No,Yes,8764
South Carolina,2020/11/9,165.7933988,703,5,186391,4041,No,Yes,8764
South Carolina,2020/11/10,165.7933988,1347,21,187738,4062,No,Yes,8764
South Carolina,2020/11/11,165.7933988,1257,14,188995,4076,No,Yes,9262
South Carolina,2020/11/12,165.7933988,1495,8,190490,4084,No,Yes,9262
South Carolina,2020/11/13,165.7933988,1611,17,192101,4101,No,Yes,9262
South Carolina,2020/11/14,165.7933988,1913,9,194014,4110,No,Yes,9262
South Carolina,2020/11/15,165.7933988,1493,2,195507,4112,No,Yes,9262
South Carolina,2020/11/16,165.7933988,1110,31,196617,4143,No,Yes,9262
South Carolina,2020/11/17,165.7933988,1283,13,197900,4156,No,Yes,9262
South Carolina,2020/11/18,165.7933988,1547,26,199447,4182,No,Yes,11813
South Carolina,2020/11/19,165.7933988,1713,19,201160,4201,No,Yes,11813
South Carolina,2020/11/20,165.7933988,2001,30,203161,4231,No,Yes,11813
South Carolina,2020/11/21,165.7933988,1857,43,205018,4274,No,Yes,11813
South Carolina,2020/11/22,165.7933988,1277,9,206295,4283,No,Yes,11813
South Carolina,2020/11/23,165.7933988,1257,5,207552,4288,No,Yes,11813
South Carolina,2020/11/24,165.7933988,1678,25,209230,4313,No,Yes,11813
South Carolina,2020/11/25,165.7933988,1675,4,210905,4317,No,Yes,7061
South Carolina,2020/11/26,165.7933988,0,0,210905,4317,No,Yes,7061
South Carolina,2020/11/27,165.7933988,2215,29,213120,4346,No,Yes,7061
South Carolina,2020/11/28,165.7933988,1791,0,214911,4346,No,Yes,7061
South Carolina,2020/11/29,165.7933988,1218,7,216129,4353,No,Yes,7061
South Carolina,2020/11/30,165.7933988,1358,28,217487,4381,No,Yes,7061
South Carolina,2020/12/1,165.7933988,1425,23,218912,4404,No,Yes,7061
South Carolina,2020/12/2,165.7933988,1923,40,220835,4444,No,Yes,7656
South Carolina,2020/12/3,165.7933988,2228,22,223063,4466,No,Yes,7656
South Carolina,2020/12/4,165.7933988,2950,30,226013,4496,No,Yes,7656
South Carolina,2020/12/5,165.7933988,3222,21,229235,4517,No,Yes,7656
South Carolina,2020/12/6,165.7933988,2864,49,232099,4566,No,Yes,7656
South Carolina,2020/12/7,165.7933988,2553,13,234652,4579,No,Yes,7656
South Carolina,2020/12/8,165.7933988,2302,6,236954,4585,No,Yes,7656
South Carolina,2020/12/9,165.7933988,2490,27,239444,4612,No,Yes,7568
South Carolina,2020/12/10,165.7933988,2242,15,241686,4627,No,Yes,7568
South Carolina,2020/12/11,165.7933988,3540,46,245226,4673,No,Yes,7568
South Carolina,2020/12/12,165.7933988,3572,12,248798,4685,No,Yes,7568
South Carolina,2020/12/13,165.7933988,3408,54,252206,4739,No,Yes,7568
South Carolina,2020/12/14,165.7933988,2570,12,254776,4751,No,Yes,7568
South Carolina,2020/12/15,165.7933988,2544,5,257320,4756,No,Yes,7568
South Carolina,2020/12/16,165.7933988,2799,44,260119,4800,No,Yes,7543
South Carolina,2020/12/17,165.7933988,2655,43,262774,4843,No,Yes,7543
South Carolina,2020/12/18,165.7933988,4302,29,267076,4872,No,Yes,7543
South Carolina,2020/12/19,165.7933988,3461,23,270537,4895,No,Yes,7543
South Carolina,2020/12/20,165.7933988,2869,40,273406,4935,No,Yes,7543
South Carolina,2020/12/21,165.7933988,2327,27,275733,4962,No,Yes,7543
South Carolina,2020/12/22,165.7933988,2322,14,278055,4976,No,Yes,7543
South Carolina,2020/12/23,165.7933988,4175,52,282230,5028,No,Yes,5506
South Carolina,2020/12/24,165.7933988,2798,15,285028,5043,No,Yes,5506
South Carolina,2020/12/25,165.7933988,0,0,285028,5043,No,Yes,5506
South Carolina,2020/12/26,165.7933988,3864,81,288892,5124,No,Yes,5506
South Carolina,2020/12/27,165.7933988,7287,31,296179,5155,No,Yes,5506
South Carolina,2020/12/28,165.7933988,1871,18,298050,5173,No,Yes,5506
South Carolina,2020/12/29,165.7933988,2552,25,300602,5198,No,Yes,5506
South Carolina,2020/12/30,165.7933988,2873,51,303475,5249,No,Yes,10986
South Carolina,2020/12/31,165.7933988,4032,47,307507,5296,No,Yes,10986
South Carolina,2021/1/1,165.7933988,0,0,307507,5296,No,Yes,10986
South Carolina,2021/1/2,165.7933988,5211,89,312718,5385,No,Yes,10986
South Carolina,2021/1/3,165.7933988,8951,84,321669,5469,No,Yes,10986
South Carolina,2021/1/4,165.7933988,3803,15,325472,5484,No,Yes,10986
South Carolina,2021/1/5,165.7933988,2601,14,328073,5498,No,Yes,10986
South Carolina,2021/1/6,165.7933988,5162,84,333235,5582,No,Yes,14084
South Carolina,2021/1/7,165.7933988,4877,79,338112,5661,No,Yes,14084
South Carolina,2021/1/8,165.7933988,6064,34,344176,5695,No,Yes,14084
South Carolina,2021/1/9,165.7933988,5908,63,350084,5758,No,Yes,14084
South Carolina,2021/1/10,165.7933988,4441,53,354525,5811,No,Yes,14084
South Carolina,2021/1/11,165.7933988,3129,15,357654,5826,No,Yes,14084
South Carolina,2021/1/12,165.7933988,1703,34,359357,5860,No,Yes,14084
South Carolina,2021/1/13,165.7933988,6021,51,365378,5911,No,Yes,11980
South Carolina,2021/1/14,165.7933988,5802,23,371180,5934,No,Yes,11980
South Carolina,2021/1/15,165.7933988,4787,103,375967,6037,No,Yes,11980
South Carolina,2021/1/16,165.7933988,6455,71,382422,6108,No,Yes,11980
South Carolina,2021/1/17,165.7933988,5762,129,388184,6237,No,Yes,11980
South Carolina,2021/1/18,165.7933988,3280,11,391464,6248,No,Yes,11980
South Carolina,2021/1/19,165.7933988,2854,11,394318,6259,No,Yes,11980
South Carolina,2021/1/20,165.7933988,5525,69,399843,6328,No,Yes,11615
South Carolina,2021/1/21,165.7933988,4649,45,404492,6373,No,Yes,11615
South Carolina,2021/1/22,165.7933988,4696,31,409188,6404,No,Yes,11615
South Carolina,2021/1/23,165.7933988,4601,75,413789,6479,No,Yes,11615
South Carolina,2021/1/24,165.7933988,4536,68,418325,6547,No,Yes,11615
South Carolina,2021/1/25,165.7933988,3092,5,421417,6552,No,Yes,11615
South Carolina,2021/1/26,165.7933988,2250,26,423667,6578,No,Yes,11615
South Carolina,2021/1/27,165.7933988,3564,95,427231,6673,No,Yes,12664
South Carolina,2021/1/28,165.7933988,3938,230,431169,6903,No,Yes,12664
South Carolina,2021/1/29,165.7933988,4464,39,435633,6942,No,Yes,12664
South Carolina,2021/1/30,165.7933988,4152,72,439785,7014,No,Yes,12664
South Carolina,2021/1/31,165.7933988,3601,28,443386,7042,No,Yes,12664
South Carolina,2021/2/1,165.7933988,2530,241,445916,7283,No,Yes,12664
South Carolina,2021/2/2,165.7933988,1988,35,447904,7318,No,Yes,12664
South Carolina,2021/2/3,165.7933988,2890,76,450794,7394,No,Yes,13464
South Carolina,2021/2/4,165.7933988,3084,93,453878,7487,No,Yes,13464
South Carolina,2021/2/5,165.7933988,6096,66,459974,7553,No,Yes,13464
South Carolina,2021/2/6,165.7933988,3007,58,462981,7611,No,Yes,13464
South Carolina,2021/2/7,165.7933988,3392,40,466373,7651,No,Yes,13464
South Carolina,2021/2/8,165.7933988,2030,39,468403,7690,No,Yes,13464
South Carolina,2021/2/9,165.7933988,1908,3,470311,7693,No,Yes,13464
South Carolina,2021/2/10,165.7933988,2829,49,473140,7742,No,Yes,12087
South Carolina,2021/2/11,165.7933988,3147,95,476287,7837,No,Yes,12087
South Carolina,2021/2/12,165.7933988,3870,57,480157,7894,No,Yes,12087
South Carolina,2021/2/13,165.7933988,2983,17,483140,7911,No,Yes,12087
South Carolina,2021/2/14,165.7933988,4153,87,487293,7998,No,Yes,12087
South Carolina,2021/2/15,165.7933988,1725,36,489018,8034,No,Yes,12087
South Carolina,2021/2/16,165.7933988,1435,21,490453,8055,No,Yes,12087
South Carolina,2021/2/17,165.7933988,1916,62,492369,8117,No,Yes,11395
South Carolina,2021/2/18,165.7933988,2675,38,495044,8155,No,Yes,11395
South Carolina,2021/2/19,165.7933988,2893,58,497937,8213,No,Yes,11395
South Carolina,2021/2/20,165.7933988,3340,43,501277,8256,No,Yes,11395
South Carolina,2021/2/21,165.7933988,2872,68,504149,8324,No,Yes,11395
South Carolina,2021/2/22,165.7933988,1440,8,505589,8332,No,Yes,11395
South Carolina,2021/2/23,165.7933988,1323,25,506912,8357,No,Yes,11395
South Carolina,2021/2/24,165.7933988,2132,41,509044,8398,No,Yes,11395
South Carolina,2021/2/25,165.7933988,2502,45,511546,8443,No,Yes,11395
South Carolina,2021/2/26,165.7933988,1749,34,513295,8477,No,Yes,11395
South Carolina,2021/2/27,165.7933988,1777,21,515072,8498,No,Yes,11395
South Carolina,2021/2/28,165.7933988,1751,48,516823,8546,No,Yes,11395
South Carolina,2021/3/1,165.7933988,1153,16,517976,8562,No,Yes,11395
South Carolina,2021/3/2,165.7933988,847,14,518823,8576,No,Yes,11395
South Carolina,2021/3/3,165.7933988,1173,44,519996,8620,No,Yes,11395
South Carolina,2021/3/4,165.7933988,1567,40,521563,8660,No,Yes,11395
South Dakota,2020/3/1,11.48206939,0,0,0,0,No,No,1575
South Dakota,2020/3/2,11.48206939,0,0,0,0,No,No,1575
South Dakota,2020/3/3,11.48206939,0,0,0,0,No,No,1575
South Dakota,2020/3/4,11.48206939,0,0,0,0,No,No,1663
South Dakota,2020/3/5,11.48206939,0,0,0,0,No,No,1663
South Dakota,2020/3/6,11.48206939,0,0,0,0,No,No,1663
South Dakota,2020/3/7,11.48206939,0,0,0,0,No,No,1663
South Dakota,2020/3/8,11.48206939,0,0,0,0,No,No,1663
South Dakota,2020/3/9,11.48206939,0,0,0,0,No,No,1663
South Dakota,2020/3/10,11.48206939,5,1,5,1,No,No,1663
South Dakota,2020/3/11,11.48206939,3,0,8,1,No,No,1819
South Dakota,2020/3/12,11.48206939,0,0,8,1,No,No,1819
South Dakota,2020/3/13,11.48206939,1,0,9,1,No,No,1819
South Dakota,2020/3/14,11.48206939,0,0,9,1,No,No,1819
South Dakota,2020/3/15,11.48206939,0,0,9,1,No,No,1819
South Dakota,2020/3/16,11.48206939,1,0,10,1,No,No,1819
South Dakota,2020/3/17,11.48206939,1,0,11,1,No,No,1819
South Dakota,2020/3/18,11.48206939,0,0,11,1,No,No,10892
South Dakota,2020/3/19,11.48206939,3,0,14,1,No,No,10892
South Dakota,2020/3/20,11.48206939,0,0,14,1,No,No,10892
South Dakota,2020/3/21,11.48206939,0,0,14,1,No,No,10892
South Dakota,2020/3/22,11.48206939,7,0,21,1,No,No,10892
South Dakota,2020/3/23,11.48206939,7,0,28,1,No,No,10892
South Dakota,2020/3/24,11.48206939,2,0,30,1,No,No,10892
South Dakota,2020/3/25,11.48206939,11,0,41,1,No,No,80984
South Dakota,2020/3/26,11.48206939,5,0,46,1,No,No,80984
South Dakota,2020/3/27,11.48206939,12,0,58,1,No,No,80984
South Dakota,2020/3/28,11.48206939,10,0,68,1,No,No,80984
South Dakota,2020/3/29,11.48206939,22,0,90,1,No,No,80984
South Dakota,2020/3/30,11.48206939,10,0,100,1,No,No,80984
South Dakota,2020/3/31,11.48206939,7,0,107,1,No,No,80984
South Dakota,2020/4/1,11.48206939,22,0,129,1,No,No,106739
South Dakota,2020/4/2,11.48206939,36,1,165,2,No,No,106739
South Dakota,2020/4/3,11.48206939,22,0,187,2,No,No,106739
South Dakota,2020/4/4,11.48206939,25,0,212,2,No,No,106739
South Dakota,2020/4/5,11.48206939,28,0,240,2,No,No,106739
South Dakota,2020/4/6,11.48206939,48,2,288,4,No,No,106739
South Dakota,2020/4/7,11.48206939,32,2,320,6,No,No,106739
South Dakota,2020/4/8,11.48206939,73,0,393,6,No,No,77515
South Dakota,2020/4/9,11.48206939,54,0,447,6,No,No,77515
South Dakota,2020/4/10,11.48206939,89,0,536,6,No,No,77515
South Dakota,2020/4/11,11.48206939,90,0,626,6,No,No,77515
South Dakota,2020/4/12,11.48206939,103,0,729,6,No,No,77515
South Dakota,2020/4/13,11.48206939,138,0,867,6,No,No,77515
South Dakota,2020/4/14,11.48206939,120,0,987,6,No,No,77515
South Dakota,2020/4/15,11.48206939,181,0,1168,6,No,No,66432
South Dakota,2020/4/16,11.48206939,143,1,1311,7,No,No,66432
South Dakota,2020/4/17,11.48206939,100,0,1411,7,No,No,66432
South Dakota,2020/4/18,11.48206939,130,0,1541,7,No,No,66432
South Dakota,2020/4/19,11.48206939,94,0,1635,7,No,No,66432
South Dakota,2020/4/20,11.48206939,50,0,1685,7,No,No,66432
South Dakota,2020/4/21,11.48206939,70,1,1755,8,No,No,66432
South Dakota,2020/4/22,11.48206939,103,1,1858,9,No,No,74966
South Dakota,2020/4/23,11.48206939,98,0,1956,9,No,No,74966
South Dakota,2020/4/24,11.48206939,84,1,2040,10,No,No,74966
South Dakota,2020/4/25,11.48206939,107,0,2147,10,No,No,74966
South Dakota,2020/4/26,11.48206939,66,1,2213,11,No,No,74966
South Dakota,2020/4/27,11.48206939,33,0,2246,11,No,No,74966
South Dakota,2020/4/28,11.48206939,68,0,2314,11,No,No,74966
South Dakota,2020/4/29,11.48206939,61,2,2375,13,No,No,28985
South Dakota,2020/4/30,11.48206939,75,4,2450,17,No,No,28985
South Dakota,2020/5/1,11.48206939,75,4,2525,21,No,No,28985
South Dakota,2020/5/2,11.48206939,62,0,2587,21,No,No,28985
South Dakota,2020/5/3,11.48206939,43,0,2630,21,No,No,28985
South Dakota,2020/5/4,11.48206939,37,0,2667,21,No,No,28985
South Dakota,2020/5/5,11.48206939,53,3,2720,24,No,No,28985
South Dakota,2020/5/6,11.48206939,59,5,2779,29,No,No,26666
South Dakota,2020/5/7,11.48206939,126,2,2905,31,No,No,26666
South Dakota,2020/5/8,11.48206939,239,0,3144,31,No,No,26666
South Dakota,2020/5/9,11.48206939,249,3,3393,34,No,No,26666
South Dakota,2020/5/10,11.48206939,124,0,3517,34,No,No,26666
South Dakota,2020/5/11,11.48206939,97,0,3614,34,No,No,26666
South Dakota,2020/5/12,11.48206939,49,5,3663,39,No,No,26666
South Dakota,2020/5/13,11.48206939,69,0,3732,39,No,No,25150
South Dakota,2020/5/14,11.48206939,60,4,3792,43,No,No,25150
South Dakota,2020/5/15,11.48206939,95,1,3887,44,No,No,25150
South Dakota,2020/5/16,11.48206939,72,0,3959,44,No,No,25150
South Dakota,2020/5/17,11.48206939,28,0,3987,44,No,No,25150
South Dakota,2020/5/18,11.48206939,40,0,4027,44,No,No,25150
South Dakota,2020/5/19,11.48206939,58,2,4085,46,No,No,25150
South Dakota,2020/5/20,11.48206939,92,0,4177,46,No,No,27919
South Dakota,2020/5/21,11.48206939,0,1,4177,47,No,No,27919
South Dakota,2020/5/22,11.48206939,179,3,4356,50,No,No,27919
South Dakota,2020/5/23,11.48206939,112,0,4468,50,No,No,27919
South Dakota,2020/5/24,11.48206939,95,0,4563,50,No,No,27919
South Dakota,2020/5/25,11.48206939,23,0,4586,50,No,No,27919
South Dakota,2020/5/26,11.48206939,67,0,4653,50,No,No,27919
South Dakota,2020/5/27,11.48206939,57,4,4710,54,No,No,21335
South Dakota,2020/5/28,11.48206939,83,0,4793,54,No,No,21335
South Dakota,2020/5/29,11.48206939,73,5,4866,59,No,No,21335
South Dakota,2020/5/30,11.48206939,94,3,4960,62,No,No,21335
South Dakota,2020/5/31,11.48206939,33,0,4993,62,No,No,21335
South Dakota,2020/6/1,11.48206939,41,0,5034,62,No,No,21335
South Dakota,2020/6/2,11.48206939,32,0,5066,62,No,No,21335
South Dakota,2020/6/3,11.48206939,95,0,5161,62,No,No,19949
South Dakota,2020/6/4,11.48206939,86,2,5247,64,No,No,19949
South Dakota,2020/6/5,11.48206939,30,1,5277,65,No,No,19949
South Dakota,2020/6/6,11.48206939,90,0,5367,65,No,No,19949
South Dakota,2020/6/7,11.48206939,71,0,5438,65,No,No,19949
South Dakota,2020/6/8,11.48206939,33,0,5471,65,No,No,19949
South Dakota,2020/6/9,11.48206939,52,3,5523,68,No,No,19949
South Dakota,2020/6/10,11.48206939,81,1,5604,69,No,No,18367
South Dakota,2020/6/11,11.48206939,61,4,5665,73,No,No,18367
South Dakota,2020/6/12,11.48206939,77,1,5742,74,No,No,18367
South Dakota,2020/6/13,11.48206939,91,1,5833,75,No,No,18367
South Dakota,2020/6/14,11.48206939,65,0,5898,75,No,No,18367
South Dakota,2020/6/15,11.48206939,30,0,5928,75,No,No,18367
South Dakota,2020/6/16,11.48206939,38,2,5966,77,No,No,18367
South Dakota,2020/6/17,11.48206939,84,1,6050,78,No,No,18671
South Dakota,2020/6/18,11.48206939,59,0,6109,78,No,No,18671
South Dakota,2020/6/19,11.48206939,49,3,6158,81,No,No,18671
South Dakota,2020/6/20,11.48206939,67,0,6225,81,No,No,18671
South Dakota,2020/6/21,11.48206939,72,0,6297,81,No,No,18671
South Dakota,2020/6/22,11.48206939,29,0,6326,81,No,No,18671
South Dakota,2020/6/23,11.48206939,27,2,6353,83,No,No,18671
South Dakota,2020/6/24,11.48206939,66,1,6419,84,No,No,18338
South Dakota,2020/6/25,11.48206939,60,3,6479,87,No,No,18338
South Dakota,2020/6/26,11.48206939,56,1,6535,88,No,No,18338
South Dakota,2020/6/27,11.48206939,91,3,6626,91,No,No,18338
South Dakota,2020/6/28,11.48206939,55,0,6681,91,No,No,18338
South Dakota,2020/6/29,11.48206939,35,0,6716,91,No,No,18338
South Dakota,2020/6/30,11.48206939,48,0,6764,91,No,No,18338
South Dakota,2020/7/1,11.48206939,62,2,6826,93,No,No,19056
South Dakota,2020/7/2,11.48206939,67,4,6893,97,No,No,19056
South Dakota,2020/7/3,11.48206939,85,0,6978,97,No,No,19056
South Dakota,2020/7/4,11.48206939,50,0,7028,97,No,No,19056
South Dakota,2020/7/5,11.48206939,35,0,7063,97,No,No,19056
South Dakota,2020/7/6,11.48206939,42,0,7105,97,No,No,19056
South Dakota,2020/7/7,11.48206939,58,1,7163,98,No,No,19056
South Dakota,2020/7/8,11.48206939,79,0,7242,98,No,No,20563
South Dakota,2020/7/9,11.48206939,94,3,7336,101,No,No,20563
South Dakota,2020/7/10,11.48206939,65,6,7401,107,No,No,20563
South Dakota,2020/7/11,11.48206939,53,2,7454,109,No,No,20563
South Dakota,2020/7/12,11.48206939,45,0,7499,109,No,No,20563
South Dakota,2020/7/13,11.48206939,25,0,7524,109,No,No,20563
South Dakota,2020/7/14,11.48206939,48,0,7572,109,No,No,20563
South Dakota,2020/7/15,11.48206939,80,2,7652,111,No,No,23676
South Dakota,2020/7/16,11.48206939,42,4,7694,115,No,No,23676
South Dakota,2020/7/17,11.48206939,95,1,7789,116,No,No,23676
South Dakota,2020/7/18,11.48206939,73,0,7862,116,No,No,23676
South Dakota,2020/7/19,11.48206939,44,2,7906,118,No,No,23676
South Dakota,2020/7/20,11.48206939,37,0,7943,118,No,No,23676
South Dakota,2020/7/21,11.48206939,76,0,8019,118,No,No,23676
South Dakota,2020/7/22,11.48206939,58,1,8077,119,No,No,17437
South Dakota,2020/7/23,11.48206939,66,2,8143,121,No,No,17437
South Dakota,2020/7/24,11.48206939,57,1,8200,122,No,No,17437
South Dakota,2020/7/25,11.48206939,105,0,8305,122,No,No,17437
South Dakota,2020/7/26,11.48206939,90,1,8395,123,No,No,17437
South Dakota,2020/7/27,11.48206939,49,0,8444,123,No,No,17437
South Dakota,2020/7/28,11.48206939,48,0,8492,123,No,No,17437
South Dakota,2020/7/29,11.48206939,149,6,8641,129,No,No,11690
South Dakota,2020/7/30,11.48206939,44,0,8685,129,No,No,11690
South Dakota,2020/7/31,11.48206939,79,1,8764,130,No,No,11690
South Dakota,2020/8/1,11.48206939,103,4,8867,134,No,No,11690
South Dakota,2020/8/2,11.48206939,88,1,8955,135,No,No,11690
South Dakota,2020/8/3,11.48206939,65,0,9020,135,No,No,11690
South Dakota,2020/8/4,11.48206939,59,1,9079,136,No,No,11690
South Dakota,2020/8/5,11.48206939,89,1,9168,137,No,No,9467
South Dakota,2020/8/6,11.48206939,105,4,9273,141,No,No,9467
South Dakota,2020/8/7,11.48206939,98,3,9371,144,No,No,9467
South Dakota,2020/8/8,11.48206939,106,2,9477,146,No,No,9467
South Dakota,2020/8/9,11.48206939,128,0,9605,146,No,No,9467
South Dakota,2020/8/10,11.48206939,58,0,9663,146,No,No,9467
South Dakota,2020/8/11,11.48206939,50,0,9713,146,No,No,9467
South Dakota,2020/8/12,11.48206939,102,1,9815,147,No,No,11047
South Dakota,2020/8/13,11.48206939,82,1,9897,148,No,No,11047
South Dakota,2020/8/14,11.48206939,127,2,10024,150,No,No,11047
South Dakota,2020/8/15,11.48206939,94,2,10118,152,No,No,11047
South Dakota,2020/8/16,11.48206939,156,1,10274,153,No,No,11047
South Dakota,2020/8/17,11.48206939,86,0,10360,153,No,No,11047
South Dakota,2020/8/18,11.48206939,83,1,10443,154,No,No,11047
South Dakota,2020/8/19,11.48206939,123,1,10566,155,No,No,8676
South Dakota,2020/8/20,11.48206939,125,2,10691,157,No,No,8676
South Dakota,2020/8/21,11.48206939,193,2,10884,159,No,No,8676
South Dakota,2020/8/22,11.48206939,251,1,11135,160,No,No,8676
South Dakota,2020/8/23,11.48206939,141,1,11276,161,No,No,8676
South Dakota,2020/8/24,11.48206939,149,0,11425,161,No,No,8676
South Dakota,2020/8/25,11.48206939,134,0,11559,161,No,No,8676
South Dakota,2020/8/26,11.48206939,292,1,11851,162,No,No,8511
South Dakota,2020/8/27,11.48206939,343,0,12194,162,No,No,8511
South Dakota,2020/8/28,11.48206939,323,3,12517,165,No,No,8511
South Dakota,2020/8/29,11.48206939,425,2,12942,167,No,No,8511
South Dakota,2020/8/30,11.48206939,380,0,13322,167,No,No,8511
South Dakota,2020/8/31,11.48206939,187,0,13509,167,No,No,8511
South Dakota,2020/9/1,11.48206939,240,0,13749,167,No,No,8511
South Dakota,2020/9/2,11.48206939,254,2,14003,169,No,No,8901
South Dakota,2020/9/3,11.48206939,334,0,14337,169,No,No,8901
South Dakota,2020/9/4,11.48206939,259,1,14596,170,No,No,8901
South Dakota,2020/9/5,11.48206939,293,3,14889,173,No,No,8901
South Dakota,2020/9/6,11.48206939,220,0,15109,173,No,No,8901
South Dakota,2020/9/7,11.48206939,191,0,15300,173,No,No,8901
South Dakota,2020/9/8,11.48206939,103,0,15403,173,No,No,8901
South Dakota,2020/9/9,11.48206939,168,0,15571,173,No,No,8848
South Dakota,2020/9/10,11.48206939,263,4,15834,177,No,No,8848
South Dakota,2020/9/11,11.48206939,283,0,16117,177,No,No,8848
South Dakota,2020/9/12,11.48206939,320,6,16437,183,No,No,8848
South Dakota,2020/9/13,11.48206939,201,1,16638,184,No,No,8848
South Dakota,2020/9/14,11.48206939,163,0,16801,184,No,No,8848
South Dakota,2020/9/15,11.48206939,193,0,16994,184,No,No,8848
South Dakota,2020/9/16,11.48206939,297,8,17291,192,No,No,8679
South Dakota,2020/9/17,11.48206939,395,1,17686,193,No,No,8679
South Dakota,2020/9/18,11.48206939,389,5,18075,198,No,No,8679
South Dakota,2020/9/19,11.48206939,369,2,18444,200,No,No,8679
South Dakota,2020/9/20,11.48206939,252,2,18696,202,No,No,8679
South Dakota,2020/9/21,11.48206939,173,0,18869,202,No,No,8679
South Dakota,2020/9/22,11.48206939,320,0,19189,202,No,No,8679
South Dakota,2020/9/23,11.48206939,445,0,19634,202,No,No,8805
South Dakota,2020/9/24,11.48206939,463,8,20097,210,No,No,8805
South Dakota,2020/9/25,11.48206939,457,6,20554,216,No,No,8805
South Dakota,2020/9/26,11.48206939,579,2,21133,218,No,No,8805
South Dakota,2020/9/27,11.48206939,408,0,21541,218,No,No,8805
South Dakota,2020/9/28,11.48206939,197,0,21738,218,No,No,8805
South Dakota,2020/9/29,11.48206939,259,5,21997,223,No,No,8805
South Dakota,2020/9/30,11.48206939,392,0,22389,223,No,No,7732
South Dakota,2020/10/1,11.48206939,747,13,23136,236,No,No,7732
South Dakota,2020/10/2,11.48206939,386,1,23522,237,No,No,7732
South Dakota,2020/10/3,11.48206939,464,11,23986,248,No,No,7732
South Dakota,2020/10/4,11.48206939,432,0,24418,248,No,No,7732
South Dakota,2020/10/5,11.48206939,180,0,24598,248,No,No,7732
South Dakota,2020/10/6,11.48206939,278,0,24876,248,No,No,7732
South Dakota,2020/10/7,11.48206939,1030,10,25906,258,No,No,8581
South Dakota,2020/10/8,11.48206939,535,14,26441,272,No,No,8581
South Dakota,2020/10/9,11.48206939,774,5,27215,277,No,No,8581
South Dakota,2020/10/10,11.48206939,732,9,27947,286,No,No,8581
South Dakota,2020/10/11,11.48206939,617,0,28564,286,No,No,8581
South Dakota,2020/10/12,11.48206939,361,2,28925,288,No,No,8581
South Dakota,2020/10/13,11.48206939,414,0,29339,288,No,No,8581
South Dakota,2020/10/14,11.48206939,876,3,30215,291,No,No,7964
South Dakota,2020/10/15,11.48206939,797,13,31012,304,No,No,7964
South Dakota,2020/10/16,11.48206939,793,3,31805,307,No,No,7964
South Dakota,2020/10/17,11.48206939,806,8,32611,315,No,No,7964
South Dakota,2020/10/18,11.48206939,658,8,33269,323,No,No,7964
South Dakota,2020/10/19,11.48206939,567,0,33836,323,No,No,7964
South Dakota,2020/10/20,11.48206939,621,7,34457,330,No,No,7964
South Dakota,2020/10/21,11.48206939,587,3,35044,333,No,No,7126
South Dakota,2020/10/22,11.48206939,973,14,36017,347,No,No,7126
South Dakota,2020/10/23,11.48206939,1185,9,37202,356,No,No,7126
South Dakota,2020/10/24,11.48206939,939,10,38141,366,No,No,7126
South Dakota,2020/10/25,11.48206939,1062,9,39203,375,No,No,7126
South Dakota,2020/10/26,11.48206939,538,0,39741,375,No,No,7126
South Dakota,2020/10/27,11.48206939,989,0,40730,375,No,No,7126
South Dakota,2020/10/28,11.48206939,1270,9,42000,384,No,No,7060
South Dakota,2020/10/29,11.48206939,1000,19,43000,403,No,No,7060
South Dakota,2020/10/30,11.48206939,1559,12,44559,415,No,No,7060
South Dakota,2020/10/31,11.48206939,1433,10,45992,425,No,No,7060
South Dakota,2020/11/1,11.48206939,1332,12,47324,437,No,No,7060
South Dakota,2020/11/2,11.48206939,526,1,47850,438,No,No,7060
South Dakota,2020/11/3,11.48206939,1004,8,48854,446,No,No,7060
South Dakota,2020/11/4,11.48206939,937,14,49791,460,No,No,8764
South Dakota,2020/11/5,11.48206939,1360,22,51151,482,No,No,8764
South Dakota,2020/11/6,11.48206939,1488,28,52639,510,No,No,8764
South Dakota,2020/11/7,11.48206939,1337,13,53976,523,No,No,8764
South Dakota,2020/11/8,11.48206939,1428,13,55404,536,No,No,8764
South Dakota,2020/11/9,11.48206939,907,1,56311,537,No,No,8764
South Dakota,2020/11/10,11.48206939,1023,3,57334,540,No,No,8764
South Dakota,2020/11/11,11.48206939,1362,27,58696,567,No,No,9262
South Dakota,2020/11/12,11.48206939,2020,0,60716,567,No,No,9262
South Dakota,2020/11/13,11.48206939,1611,1,62327,568,No,No,9262
South Dakota,2020/11/14,11.48206939,1855,53,64182,621,No,No,9262
South Dakota,2020/11/15,11.48206939,1199,23,65381,644,No,No,9262
South Dakota,2020/11/16,11.48206939,897,0,66278,644,No,No,9262
South Dakota,2020/11/17,11.48206939,1006,0,67284,644,No,No,9262
South Dakota,2020/11/18,11.48206939,1387,30,68671,674,No,No,11813
South Dakota,2020/11/19,11.48206939,1071,31,69742,705,No,No,11813
South Dakota,2020/11/20,11.48206939,1328,36,71070,741,No,No,11813
South Dakota,2020/11/21,11.48206939,1144,36,72214,777,No,No,11813
South Dakota,2020/11/22,11.48206939,851,42,73065,819,No,No,11813
South Dakota,2020/11/23,11.48206939,783,0,73848,819,No,No,11813
South Dakota,2020/11/24,11.48206939,1011,2,74859,821,No,No,11813
South Dakota,2020/11/25,11.48206939,1283,28,76142,849,No,No,7061
South Dakota,2020/11/26,11.48206939,0,0,76142,849,No,No,7061
South Dakota,2020/11/27,11.48206939,2138,39,78280,888,No,No,7061
South Dakota,2020/11/28,11.48206939,819,54,79099,942,No,No,7061
South Dakota,2020/11/29,11.48206939,801,1,79900,943,No,No,7061
South Dakota,2020/11/30,11.48206939,564,3,80464,946,No,No,7061
South Dakota,2020/12/1,11.48206939,448,2,80912,948,No,No,7061
South Dakota,2020/12/2,11.48206939,1291,47,82203,995,No,No,7656
South Dakota,2020/12/3,11.48206939,1145,38,83348,1033,No,No,7656
South Dakota,2020/12/4,11.48206939,1050,31,84398,1064,No,No,7656
South Dakota,2020/12/5,11.48206939,906,27,85304,1091,No,No,7656
South Dakota,2020/12/6,11.48206939,687,19,85991,1110,No,No,7656
South Dakota,2020/12/7,11.48206939,509,0,86500,1110,No,No,7656
South Dakota,2020/12/8,11.48206939,538,1,87038,1111,No,No,7656
South Dakota,2020/12/9,11.48206939,985,36,88023,1147,No,No,7568
South Dakota,2020/12/10,11.48206939,704,30,88727,1177,No,No,7568
South Dakota,2020/12/11,11.48206939,945,33,89672,1210,No,No,7568
South Dakota,2020/12/12,11.48206939,735,33,90407,1243,No,No,7568
South Dakota,2020/12/13,11.48206939,631,16,91038,1259,No,No,7568
South Dakota,2020/12/14,11.48206939,316,0,91354,1259,No,No,7568
South Dakota,2020/12/15,11.48206939,345,2,91699,1261,No,No,7568
South Dakota,2020/12/16,11.48206939,905,39,92604,1300,No,No,7543
South Dakota,2020/12/17,11.48206939,593,1,93197,1301,No,No,7543
South Dakota,2020/12/18,11.48206939,575,29,93772,1330,No,No,7543
South Dakota,2020/12/19,11.48206939,564,20,94336,1350,No,No,7543
South Dakota,2020/12/20,11.48206939,391,11,94727,1361,No,No,7543
South Dakota,2020/12/21,11.48206939,347,20,95074,1381,No,No,7543
South Dakota,2020/12/22,11.48206939,435,0,95509,1381,No,No,7543
South Dakota,2020/12/23,11.48206939,531,8,96040,1389,No,No,5506
South Dakota,2020/12/24,11.48206939,506,41,96546,1430,No,No,5506
South Dakota,2020/12/25,11.48206939,0,0,96546,1430,No,No,5506
South Dakota,2020/12/26,11.48206939,417,16,96963,1446,No,No,5506
South Dakota,2020/12/27,11.48206939,427,0,97390,1446,No,No,5506
South Dakota,2020/12/28,11.48206939,268,0,97658,1446,No,No,5506
South Dakota,2020/12/29,11.48206939,500,0,98158,1446,No,No,5506
South Dakota,2020/12/30,11.48206939,562,18,98720,1464,No,No,10986
South Dakota,2020/12/31,11.48206939,444,24,99164,1488,No,No,10986
South Dakota,2021/1/1,11.48206939,0,0,99164,1488,No,No,10986
South Dakota,2021/1/2,11.48206939,665,13,99829,1501,No,No,10986
South Dakota,2021/1/3,11.48206939,703,12,100532,1513,No,No,10986
South Dakota,2021/1/4,11.48206939,111,0,100643,1513,No,No,10986
South Dakota,2021/1/5,11.48206939,433,0,101076,1513,No,No,10986
South Dakota,2021/1/6,11.48206939,608,6,101684,1519,No,No,14084
South Dakota,2021/1/7,11.48206939,448,25,102132,1544,No,No,14084
South Dakota,2021/1/8,11.48206939,448,12,102580,1556,No,No,14084
South Dakota,2021/1/9,11.48206939,321,14,102901,1570,No,No,14084
South Dakota,2021/1/10,11.48206939,417,15,103318,1585,No,No,14084
South Dakota,2021/1/11,11.48206939,181,0,103499,1585,No,No,14084
South Dakota,2021/1/12,11.48206939,244,0,103743,1585,No,No,14084
South Dakota,2021/1/13,11.48206939,452,19,104195,1604,No,No,11980
South Dakota,2021/1/14,11.48206939,317,10,104512,1614,No,No,11980
South Dakota,2021/1/15,11.48206939,425,15,104937,1629,No,No,11980
South Dakota,2021/1/16,11.48206939,341,4,105278,1633,No,No,11980
South Dakota,2021/1/17,11.48206939,266,23,105544,1656,No,No,11980
South Dakota,2021/1/18,11.48206939,115,11,105659,1667,No,No,11980
South Dakota,2021/1/19,11.48206939,127,0,105786,1667,No,No,11980
South Dakota,2021/1/20,11.48206939,277,0,106063,1667,No,No,11615
South Dakota,2021/1/21,11.48206939,337,6,106400,1673,No,No,11615
South Dakota,2021/1/22,11.48206939,316,11,106716,1684,No,No,11615
South Dakota,2021/1/23,11.48206939,247,12,106963,1696,No,No,11615
South Dakota,2021/1/24,11.48206939,185,9,107148,1705,No,No,11615
South Dakota,2021/1/25,11.48206939,32,0,107180,1705,No,No,11615
South Dakota,2021/1/26,11.48206939,200,0,107380,1705,No,No,11615
South Dakota,2021/1/27,11.48206939,228,34,107608,1739,No,No,12664
South Dakota,2021/1/28,11.48206939,187,24,107795,1763,No,No,12664
South Dakota,2021/1/29,11.48206939,160,5,107955,1768,No,No,12664
South Dakota,2021/1/30,11.48206939,115,7,108070,1775,No,No,12664
South Dakota,2021/1/31,11.48206939,180,3,108250,1778,No,No,12664
South Dakota,2021/2/1,11.48206939,65,0,108315,1778,No,No,12664
South Dakota,2021/2/2,11.48206939,116,1,108431,1779,No,No,12664
South Dakota,2021/2/3,11.48206939,208,3,108639,1782,No,No,13464
South Dakota,2021/2/4,11.48206939,174,6,108813,1788,No,No,13464
South Dakota,2021/2/5,11.48206939,131,10,108944,1798,No,No,13464
South Dakota,2021/2/6,11.48206939,188,6,109132,1804,No,No,13464
South Dakota,2021/2/7,11.48206939,97,5,109229,1809,No,No,13464
South Dakota,2021/2/8,11.48206939,54,0,109283,1809,No,No,13464
South Dakota,2021/2/9,11.48206939,122,0,109405,1809,No,No,13464
South Dakota,2021/2/10,11.48206939,175,6,109580,1815,No,No,12087
South Dakota,2021/2/11,11.48206939,279,14,109859,1829,No,No,12087
South Dakota,2021/2/12,11.48206939,209,2,110068,1831,No,No,12087
South Dakota,2021/2/13,11.48206939,137,7,110205,1838,No,No,12087
South Dakota,2021/2/14,11.48206939,110,6,110315,1844,No,No,12087
South Dakota,2021/2/15,11.48206939,61,0,110376,1844,No,No,12087
South Dakota,2021/2/16,11.48206939,217,0,110593,1844,No,No,12087
South Dakota,2021/2/17,11.48206939,92,0,110685,1844,No,No,11395
South Dakota,2021/2/18,11.48206939,186,3,110871,1847,No,No,11395
South Dakota,2021/2/19,11.48206939,147,6,111018,1853,No,No,11395
South Dakota,2021/2/20,11.48206939,147,6,111165,1859,No,No,11395
South Dakota,2021/2/21,11.48206939,139,4,111304,1863,No,No,11395
South Dakota,2021/2/22,11.48206939,30,0,111334,1863,No,No,11395
South Dakota,2021/2/23,11.48206939,212,0,111546,1863,No,No,11395
South Dakota,2021/2/24,11.48206939,262,1,111808,1864,No,No,11395
South Dakota,2021/2/25,11.48206939,156,8,111964,1872,No,No,11395
South Dakota,2021/2/26,11.48206939,143,7,112107,1879,No,No,11395
South Dakota,2021/2/27,11.48206939,186,7,112293,1886,No,No,11395
South Dakota,2021/2/28,11.48206939,134,2,112427,1888,No,No,11395
South Dakota,2021/3/1,11.48206939,43,0,112470,1888,No,No,11395
South Dakota,2021/3/2,11.48206939,182,0,112652,1888,No,No,11395
South Dakota,2021/3/3,11.48206939,181,5,112833,1893,No,No,11395
South Dakota,2021/3/4,11.48206939,232,3,113065,1896,No,No,11395
Tennessee,2020/3/1,161.6602121,0,0,0,0,No,No,1575
Tennessee,2020/3/2,161.6602121,0,0,0,0,No,No,1575
Tennessee,2020/3/3,161.6602121,0,0,0,0,No,No,1575
Tennessee,2020/3/4,161.6602121,0,0,0,0,No,No,1663
Tennessee,2020/3/5,161.6602121,1,0,1,0,No,No,1663
Tennessee,2020/3/6,161.6602121,0,0,1,0,No,No,1663
Tennessee,2020/3/7,161.6602121,0,0,1,0,No,No,1663
Tennessee,2020/3/8,161.6602121,2,0,3,0,No,No,1663
Tennessee,2020/3/9,161.6602121,1,0,4,0,No,No,1663
Tennessee,2020/3/10,161.6602121,3,0,7,0,No,No,1663
Tennessee,2020/3/11,161.6602121,1,0,8,0,No,No,1819
Tennessee,2020/3/12,161.6602121,10,0,18,0,No,No,1819
Tennessee,2020/3/13,161.6602121,8,0,26,0,No,No,1819
Tennessee,2020/3/14,161.6602121,6,0,32,0,No,No,1819
Tennessee,2020/3/15,161.6602121,7,0,39,0,No,No,1819
Tennessee,2020/3/16,161.6602121,13,0,52,0,No,No,1819
Tennessee,2020/3/17,161.6602121,21,0,73,0,No,No,1819
Tennessee,2020/3/18,161.6602121,25,0,98,0,No,No,10892
Tennessee,2020/3/19,161.6602121,57,0,155,0,No,No,10892
Tennessee,2020/3/20,161.6602121,82,0,237,0,No,No,10892
Tennessee,2020/3/21,161.6602121,75,2,312,2,No,No,10892
Tennessee,2020/3/22,161.6602121,112,0,424,2,No,No,10892
Tennessee,2020/3/23,161.6602121,98,0,522,2,No,No,10892
Tennessee,2020/3/24,161.6602121,156,0,678,2,No,No,10892
Tennessee,2020/3/25,161.6602121,128,1,806,3,No,No,80984
Tennessee,2020/3/26,161.6602121,175,0,981,3,No,No,80984
Tennessee,2020/3/27,161.6602121,199,3,1180,6,No,No,80984
Tennessee,2020/3/28,161.6602121,183,0,1363,6,No,No,80984
Tennessee,2020/3/29,161.6602121,206,1,1569,7,No,No,80984
Tennessee,2020/3/30,161.6602121,152,6,1721,13,No,No,80984
Tennessee,2020/3/31,161.6602121,328,0,2049,13,Yes,No,80984
Tennessee,2020/4/1,161.6602121,640,10,2689,23,Yes,No,106739
Tennessee,2020/4/2,161.6602121,179,9,2868,32,Yes,No,106739
Tennessee,2020/4/3,161.6602121,164,6,3032,38,Yes,No,106739
Tennessee,2020/4/4,161.6602121,233,9,3265,47,Yes,No,106739
Tennessee,2020/4/5,161.6602121,273,3,3538,50,Yes,No,106739
Tennessee,2020/4/6,161.6602121,215,15,3753,65,Yes,No,106739
Tennessee,2020/4/7,161.6602121,257,7,4010,72,Yes,No,106739
Tennessee,2020/4/8,161.6602121,236,11,4246,83,Yes,No,77515
Tennessee,2020/4/9,161.6602121,210,12,4456,95,Yes,No,77515
Tennessee,2020/4/10,161.6602121,337,9,4793,104,Yes,No,77515
Tennessee,2020/4/11,161.6602121,190,3,4983,107,Yes,No,77515
Tennessee,2020/4/12,161.6602121,161,0,5144,107,Yes,No,77515
Tennessee,2020/4/13,161.6602121,339,7,5483,114,Yes,No,77515
Tennessee,2020/4/14,161.6602121,171,9,5654,123,Yes,No,77515
Tennessee,2020/4/15,161.6602121,210,12,5864,135,Yes,No,66432
Tennessee,2020/4/16,161.6602121,213,7,6077,142,Yes,No,66432
Tennessee,2020/4/17,161.6602121,346,4,6423,146,Yes,No,66432
Tennessee,2020/4/18,161.6602121,201,2,6624,148,Yes,No,66432
Tennessee,2020/4/19,161.6602121,200,3,6824,151,Yes,No,66432
Tennessee,2020/4/20,161.6602121,170,5,6994,156,Yes,No,66432
Tennessee,2020/4/21,161.6602121,323,3,7317,159,Yes,No,66432
Tennessee,2020/4/22,161.6602121,364,10,7681,169,Yes,No,74966
Tennessee,2020/4/23,161.6602121,488,3,8169,172,Yes,No,74966
Tennessee,2020/4/24,161.6602121,449,0,8618,172,Yes,No,74966
Tennessee,2020/4/25,161.6602121,300,7,8918,179,Yes,No,74966
Tennessee,2020/4/26,161.6602121,517,3,9435,182,Yes,No,74966
Tennessee,2020/4/27,161.6602121,304,2,9739,184,Yes,No,74966
Tennessee,2020/4/28,161.6602121,235,6,9974,190,Yes,No,74966
Tennessee,2020/4/29,161.6602121,281,6,10255,196,Yes,No,28985
Tennessee,2020/4/30,161.6602121,251,4,10506,200,Yes,No,28985
Tennessee,2020/5/1,161.6602121,1275,5,11781,205,No,No,28985
Tennessee,2020/5/2,161.6602121,595,5,12376,210,No,No,28985
Tennessee,2020/5/3,161.6602121,495,1,12871,211,No,No,28985
Tennessee,2020/5/4,161.6602121,412,5,13283,216,No,No,28985
Tennessee,2020/5/5,161.6602121,272,9,13555,225,No,No,28985
Tennessee,2020/5/6,161.6602121,182,12,13737,237,No,No,26666
Tennessee,2020/5/7,161.6602121,371,1,14108,238,No,No,26666
Tennessee,2020/5/8,161.6602121,168,2,14276,240,No,No,26666
Tennessee,2020/5/9,161.6602121,399,1,14675,241,No,No,26666
Tennessee,2020/5/10,161.6602121,385,1,15060,242,No,No,26666
Tennessee,2020/5/11,161.6602121,363,6,15423,248,No,No,26666
Tennessee,2020/5/12,161.6602121,354,16,15777,264,No,No,26666
Tennessee,2020/5/13,161.6602121,484,7,16261,271,No,No,25150
Tennessee,2020/5/14,161.6602121,327,13,16588,284,No,No,25150
Tennessee,2020/5/15,161.6602121,329,4,16917,288,No,No,25150
Tennessee,2020/5/16,161.6602121,287,4,17204,292,No,No,25150
Tennessee,2020/5/17,161.6602121,187,1,17391,293,No,No,25150
Tennessee,2020/5/18,161.6602121,376,3,17767,296,No,No,25150
Tennessee,2020/5/19,161.6602121,534,5,18301,301,No,No,25150
Tennessee,2020/5/20,161.6602121,233,8,18534,309,No,No,27919
Tennessee,2020/5/21,161.6602121,436,4,18970,313,No,No,27919
Tennessee,2020/5/22,161.6602121,394,2,19364,315,No,No,27919
Tennessee,2020/5/23,161.6602121,401,10,19765,325,No,No,27919
Tennessee,2020/5/24,161.6602121,351,7,20116,332,No,No,27919
Tennessee,2020/5/25,161.6602121,417,2,20533,334,No,No,27919
Tennessee,2020/5/26,161.6602121,427,5,20960,339,No,No,27919
Tennessee,2020/5/27,161.6602121,400,14,21360,353,No,No,21335
Tennessee,2020/5/28,161.6602121,403,-1,21763,352,No,No,21335
Tennessee,2020/5/29,161.6602121,436,4,22199,356,No,No,21335
Tennessee,2020/5/30,161.6602121,477,4,22676,360,No,No,21335
Tennessee,2020/5/31,161.6602121,156,0,22832,360,No,No,21335
Tennessee,2020/6/1,161.6602121,410,1,23242,361,No,No,21335
Tennessee,2020/6/2,161.6602121,1256,17,24498,378,No,No,21335
Tennessee,2020/6/3,161.6602121,526,8,25024,386,No,No,19949
Tennessee,2020/6/4,161.6602121,350,15,25374,401,No,No,19949
Tennessee,2020/6/5,161.6602121,425,4,25799,405,No,No,19949
Tennessee,2020/6/6,161.6602121,560,8,26359,413,No,No,19949
Tennessee,2020/6/7,161.6602121,452,1,26811,414,No,No,19949
Tennessee,2020/6/8,161.6602121,406,3,27217,417,No,No,19949
Tennessee,2020/6/9,161.6602121,648,13,27865,430,No,No,19949
Tennessee,2020/6/10,161.6602121,514,6,28379,436,No,No,18367
Tennessee,2020/6/11,161.6602121,387,5,28766,441,No,No,18367
Tennessee,2020/6/12,161.6602121,452,20,29218,461,No,No,18367
Tennessee,2020/6/13,161.6602121,398,4,29616,465,No,No,18367
Tennessee,2020/6/14,161.6602121,558,2,30174,467,No,No,18367
Tennessee,2020/6/15,161.6602121,771,10,30945,477,No,No,18367
Tennessee,2020/6/16,161.6602121,678,10,31623,487,No,No,18367
Tennessee,2020/6/17,161.6602121,489,6,32112,493,No,No,18671
Tennessee,2020/6/18,161.6602121,492,11,32604,504,No,No,18671
Tennessee,2020/6/19,161.6602121,999,4,33603,508,No,No,18671
Tennessee,2020/6/20,161.6602121,620,8,34223,516,No,No,18671
Tennessee,2020/6/21,161.6602121,496,3,34719,519,No,No,18671
Tennessee,2020/6/22,161.6602121,536,6,35255,525,No,No,18671
Tennessee,2020/6/23,161.6602121,763,10,36018,535,No,No,18671
Tennessee,2020/6/24,161.6602121,804,13,36822,548,No,No,18338
Tennessee,2020/6/25,161.6602121,873,10,37695,558,No,No,18338
Tennessee,2020/6/26,161.6602121,1107,11,38802,569,No,No,18338
Tennessee,2020/6/27,161.6602121,1011,8,39813,577,No,No,18338
Tennessee,2020/6/28,161.6602121,132,0,39945,577,No,No,18338
Tennessee,2020/6/29,161.6602121,1443,8,41388,585,No,No,18338
Tennessee,2020/6/30,161.6602121,1427,12,42815,597,No,No,18338
Tennessee,2020/7/1,161.6602121,1545,5,44360,602,No,No,19056
Tennessee,2020/7/2,161.6602121,1816,10,46176,612,No,No,19056
Tennessee,2020/7/3,161.6602121,1706,14,47882,626,No,Yes,19056
Tennessee,2020/7/4,161.6602121,1350,4,49232,630,No,Yes,19056
Tennessee,2020/7/5,161.6602121,1133,9,50365,639,No,Yes,19056
Tennessee,2020/7/6,161.6602121,1144,7,51509,646,No,Yes,19056
Tennessee,2020/7/7,161.6602121,1134,11,52643,657,No,Yes,19056
Tennessee,2020/7/8,161.6602121,2113,21,54756,678,No,Yes,20563
Tennessee,2020/7/9,161.6602121,1775,22,56531,700,No,Yes,20563
Tennessee,2020/7/10,161.6602121,1693,13,58224,713,No,Yes,20563
Tennessee,2020/7/11,161.6602121,1757,15,59981,728,No,Yes,20563
Tennessee,2020/7/12,161.6602121,1125,3,61106,731,No,Yes,20563
Tennessee,2020/7/13,161.6602121,2509,7,63615,738,No,Yes,20563
Tennessee,2020/7/14,161.6602121,1797,19,65412,757,No,Yes,20563
Tennessee,2020/7/15,161.6602121,2103,16,67515,773,No,Yes,23676
Tennessee,2020/7/16,161.6602121,2312,13,69827,786,No,Yes,23676
Tennessee,2020/7/17,161.6602121,2245,19,72072,805,No,Yes,23676
Tennessee,2020/7/18,161.6602121,2446,23,74518,828,No,Yes,23676
Tennessee,2020/7/19,161.6602121,1662,6,76180,834,No,Yes,23676
Tennessee,2020/7/20,161.6602121,1764,4,77944,838,No,Yes,23676
Tennessee,2020/7/21,161.6602121,2082,25,80026,863,No,Yes,23676
Tennessee,2020/7/22,161.6602121,2146,15,82172,878,No,Yes,17437
Tennessee,2020/7/23,161.6602121,2480,35,84652,913,No,Yes,17437
Tennessee,2020/7/24,161.6602121,2015,13,86667,926,No,Yes,17437
Tennessee,2020/7/25,161.6602121,1792,27,88459,953,No,Yes,17437
Tennessee,2020/7/26,161.6602121,2871,2,91330,955,No,Yes,17437
Tennessee,2020/7/27,161.6602121,2539,10,93869,965,No,Yes,17437
Tennessee,2020/7/28,161.6602121,2449,23,96318,988,No,Yes,17437
Tennessee,2020/7/29,161.6602121,1827,20,98145,1008,No,Yes,11690
Tennessee,2020/7/30,161.6602121,2021,14,100166,1022,No,Yes,11690
Tennessee,2020/7/31,161.6602121,2978,25,103144,1047,No,Yes,11690
Tennessee,2020/8/1,161.6602121,2311,9,105455,1056,No,Yes,11690
Tennessee,2020/8/2,161.6602121,1349,6,106804,1062,No,Yes,11690
Tennessee,2020/8/3,161.6602121,1096,16,107900,1078,No,Yes,11690
Tennessee,2020/8/4,161.6602121,1752,25,109652,1103,No,No,11690
Tennessee,2020/8/5,161.6602121,1653,27,111305,1130,No,No,9467
Tennessee,2020/8/6,161.6602121,2214,40,113519,1170,No,No,9467
Tennessee,2020/8/7,161.6602121,2421,20,115940,1190,No,No,9467
Tennessee,2020/8/8,161.6602121,1785,11,117725,1201,No,No,9467
Tennessee,2020/8/9,161.6602121,2063,8,119788,1209,No,No,9467
Tennessee,2020/8/10,161.6602121,1179,14,120967,1223,No,No,9467
Tennessee,2020/8/11,161.6602121,1036,36,122003,1259,No,No,9467
Tennessee,2020/8/12,161.6602121,1486,15,123489,1274,No,No,11047
Tennessee,2020/8/13,161.6602121,1998,26,125487,1300,No,No,11047
Tennessee,2020/8/14,161.6602121,1978,12,127465,1312,No,No,11047
Tennessee,2020/8/15,161.6602121,1306,19,128771,1331,No,No,11047
Tennessee,2020/8/16,161.6602121,1849,18,130620,1349,No,No,11047
Tennessee,2020/8/17,161.6602121,1122,21,131742,1370,No,No,11047
Tennessee,2020/8/18,161.6602121,1054,40,132796,1410,No,No,11047
Tennessee,2020/8/19,161.6602121,2014,27,134810,1437,No,No,8676
Tennessee,2020/8/20,161.6602121,1450,33,136260,1470,No,No,8676
Tennessee,2020/8/21,161.6602121,1672,58,137932,1528,No,No,8676
Tennessee,2020/8/22,161.6602121,1434,14,139366,1542,No,No,8676
Tennessee,2020/8/23,161.6602121,1634,5,141000,1547,No,No,8676
Tennessee,2020/8/24,161.6602121,675,31,141675,1578,No,No,8676
Tennessee,2020/8/25,161.6602121,826,27,142501,1605,No,No,8676
Tennessee,2020/8/26,161.6602121,1899,18,144400,1623,No,No,8511
Tennessee,2020/8/27,161.6602121,1783,27,146183,1650,No,No,8511
Tennessee,2020/8/28,161.6602121,1631,25,147814,1675,No,No,8511
Tennessee,2020/8/29,161.6602121,1496,25,149310,1700,No,No,8511
Tennessee,2020/8/30,161.6602121,939,22,150249,1722,No,No,8511
Tennessee,2020/8/31,161.6602121,1784,5,152033,1727,No,No,8511
Tennessee,2020/9/1,161.6602121,1241,26,153274,1753,No,No,8511
Tennessee,2020/9/2,161.6602121,1559,15,154833,1768,No,No,8901
Tennessee,2020/9/3,161.6602121,2195,23,157028,1791,No,No,8901
Tennessee,2020/9/4,161.6602121,1092,22,158120,1813,No,No,8901
Tennessee,2020/9/5,161.6602121,1773,25,159893,1838,No,No,8901
Tennessee,2020/9/6,161.6602121,1696,3,161589,1841,No,No,8901
Tennessee,2020/9/7,161.6602121,942,4,162531,1845,No,No,8901
Tennessee,2020/9/8,161.6602121,649,28,163180,1873,No,No,8901
Tennessee,2020/9/9,161.6602121,852,35,164032,1908,No,No,8848
Tennessee,2020/9/10,161.6602121,1879,55,165911,1963,No,No,8848
Tennessee,2020/9/11,161.6602121,1352,36,167263,1999,No,No,8848
Tennessee,2020/9/12,161.6602121,1289,41,168552,2040,No,No,8848
Tennessee,2020/9/13,161.6602121,758,15,169310,2055,No,No,8848
Tennessee,2020/9/14,161.6602121,2188,18,171498,2073,No,No,8848
Tennessee,2020/9/15,161.6602121,1194,29,172692,2102,No,No,8848
Tennessee,2020/9/16,161.6602121,1708,25,174400,2127,No,No,8679
Tennessee,2020/9/17,161.6602121,1302,14,175702,2141,No,No,8679
Tennessee,2020/9/18,161.6602121,2005,32,177707,2173,No,No,8679
Tennessee,2020/9/19,161.6602121,1310,20,179017,2193,No,No,8679
Tennessee,2020/9/20,161.6602121,1604,2,180621,2195,No,No,8679
Tennessee,2020/9/21,161.6602121,1104,14,181725,2209,No,No,8679
Tennessee,2020/9/22,161.6602121,821,27,182546,2236,No,No,8679
Tennessee,2020/9/23,161.6602121,1522,16,184068,2252,No,No,8805
Tennessee,2020/9/24,161.6602121,1053,35,185121,2287,No,No,8805
Tennessee,2020/9/25,161.6602121,1648,39,186769,2326,No,No,8805
Tennessee,2020/9/26,161.6602121,1436,21,188205,2347,No,No,8805
Tennessee,2020/9/27,161.6602121,1832,3,190037,2350,No,No,8805
Tennessee,2020/9/28,161.6602121,954,12,190991,2362,No,No,8805
Tennessee,2020/9/29,161.6602121,868,31,191859,2393,No,No,8805
Tennessee,2020/9/30,161.6602121,1498,36,193357,2429,No,No,7732
Tennessee,2020/10/1,161.6602121,1244,44,194601,2473,No,No,7732
Tennessee,2020/10/2,161.6602121,1079,16,195680,2489,No,No,7732
Tennessee,2020/10/3,161.6602121,1190,45,196870,2534,No,No,7732
Tennessee,2020/10/4,161.6602121,1392,16,198262,2550,No,No,7732
Tennessee,2020/10/5,161.6602121,2341,20,200603,2570,No,No,7732
Tennessee,2020/10/6,161.6602121,1654,24,202257,2594,No,No,7732
Tennessee,2020/10/7,161.6602121,2029,21,204286,2615,No,No,8581
Tennessee,2020/10/8,161.6602121,1979,61,206265,2676,No,No,8581
Tennessee,2020/10/9,161.6602121,1558,26,207823,2702,No,No,8581
Tennessee,2020/10/10,161.6602121,1770,27,209593,2729,No,No,8581
Tennessee,2020/10/11,161.6602121,1833,9,211426,2738,No,No,8581
Tennessee,2020/10/12,161.6602121,2819,7,214245,2745,No,No,8581
Tennessee,2020/10/13,161.6602121,1178,23,215423,2768,No,No,8581
Tennessee,2020/10/14,161.6602121,1717,33,217140,2801,No,No,7964
Tennessee,2020/10/15,161.6602121,2215,35,219355,2836,No,No,7964
Tennessee,2020/10/16,161.6602121,744,11,220099,2847,No,No,7964
Tennessee,2020/10/17,161.6602121,2509,28,222608,2875,No,No,7964
Tennessee,2020/10/18,161.6602121,2518,9,225126,2884,No,No,7964
Tennessee,2020/10/19,161.6602121,3141,12,228267,2896,No,No,7964
Tennessee,2020/10/20,161.6602121,1527,28,229794,2924,No,No,7964
Tennessee,2020/10/21,161.6602121,2306,22,232100,2946,No,No,7126
Tennessee,2020/10/22,161.6602121,1979,37,234079,2983,No,No,7126
Tennessee,2020/10/23,161.6602121,3528,60,237607,3043,No,No,7126
Tennessee,2020/10/24,161.6602121,2584,24,240191,3067,No,No,7126
Tennessee,2020/10/25,161.6602121,3317,38,243508,3105,No,No,7126
Tennessee,2020/10/26,161.6602121,2252,27,245760,3132,No,No,7126
Tennessee,2020/10/27,161.6602121,1928,44,247688,3176,No,No,7126
Tennessee,2020/10/28,161.6602121,2581,33,250269,3209,No,No,7060
Tennessee,2020/10/29,161.6602121,2458,20,252727,3229,No,No,7060
Tennessee,2020/10/30,161.6602121,2605,78,255332,3307,No,No,7060
Tennessee,2020/10/31,161.6602121,1591,15,256923,3322,No,No,7060
Tennessee,2020/11/1,161.6602121,735,0,257658,3322,No,No,7060
Tennessee,2020/11/2,161.6602121,2617,25,260275,3347,No,No,7060
Tennessee,2020/11/3,161.6602121,1778,72,262053,3419,No,No,7060
Tennessee,2020/11/4,161.6602121,3354,27,265407,3446,No,No,8764
Tennessee,2020/11/5,161.6602121,2150,28,267557,3474,No,No,8764
Tennessee,2020/11/6,161.6602121,1735,34,269292,3508,No,No,8764
Tennessee,2020/11/7,161.6602121,4311,48,273603,3556,No,No,8764
Tennessee,2020/11/8,161.6602121,3470,5,277073,3561,No,No,8764
Tennessee,2020/11/9,161.6602121,5673,16,282746,3577,No,No,8764
Tennessee,2020/11/10,161.6602121,1979,62,284725,3639,No,No,8764
Tennessee,2020/11/11,161.6602121,3586,88,288311,3727,No,No,9262
Tennessee,2020/11/12,161.6602121,3171,24,291482,3751,No,No,9262
Tennessee,2020/11/13,161.6602121,3653,63,295135,3814,No,No,9262
Tennessee,2020/11/14,161.6602121,4462,25,299597,3839,No,No,9262
Tennessee,2020/11/15,161.6602121,5614,17,305211,3856,No,No,9262
Tennessee,2020/11/16,161.6602121,7499,28,312710,3884,No,No,9262
Tennessee,2020/11/17,161.6602121,1843,69,314553,3953,No,No,9262
Tennessee,2020/11/18,161.6602121,4468,52,319021,4005,No,No,11813
Tennessee,2020/11/19,161.6602121,2811,77,321832,4082,No,No,11813
Tennessee,2020/11/20,161.6602121,3450,74,325282,4156,No,No,11813
Tennessee,2020/11/21,161.6602121,4208,7,329490,4163,No,No,11813
Tennessee,2020/11/22,161.6602121,4363,55,333853,4218,No,No,11813
Tennessee,2020/11/23,161.6602121,3784,36,337637,4254,No,No,11813
Tennessee,2020/11/24,161.6602121,1422,71,339059,4325,No,No,11813
Tennessee,2020/11/25,161.6602121,2397,90,341456,4415,No,No,7061
Tennessee,2020/11/26,161.6602121,3915,53,345371,4468,No,No,7061
Tennessee,2020/11/27,161.6602121,4135,7,349506,4475,No,No,7061
Tennessee,2020/11/28,161.6602121,6379,14,355885,4489,No,No,7061
Tennessee,2020/11/29,161.6602121,2924,11,358809,4500,No,No,7061
Tennessee,2020/11/30,161.6602121,7603,46,366412,4546,No,No,7061
Tennessee,2020/12/1,161.6602121,5568,38,371980,4584,No,No,7061
Tennessee,2020/12/2,161.6602121,4015,51,375995,4635,No,No,7656
Tennessee,2020/12/3,161.6602121,3684,92,379679,4727,No,No,7656
Tennessee,2020/12/4,161.6602121,4316,95,383995,4822,No,No,7656
Tennessee,2020/12/5,161.6602121,4820,29,388815,4851,No,No,7656
Tennessee,2020/12/6,161.6602121,2578,37,391393,4888,No,No,7656
Tennessee,2020/12/7,161.6602121,7930,65,399323,4953,No,No,7656
Tennessee,2020/12/8,161.6602121,5826,98,405149,5051,No,No,7656
Tennessee,2020/12/9,161.6602121,7894,62,413043,5113,No,No,7568
Tennessee,2020/12/10,161.6602121,5859,70,418902,5183,No,No,7568
Tennessee,2020/12/11,161.6602121,7052,88,425954,5271,No,No,7568
Tennessee,2020/12/12,161.6602121,6292,73,432246,5344,No,No,7568
Tennessee,2020/12/13,161.6602121,10461,62,442707,5406,No,No,7568
Tennessee,2020/12/14,161.6602121,9769,78,452476,5484,No,No,7568
Tennessee,2020/12/15,161.6602121,7978,73,460454,5557,No,No,7568
Tennessee,2020/12/16,161.6602121,10894,53,471348,5610,No,No,7543
Tennessee,2020/12/17,161.6602121,8877,173,480225,5783,No,No,7543
Tennessee,2020/12/18,161.6602121,10079,114,490304,5897,No,No,7543
Tennessee,2020/12/19,161.6602121,4193,56,494497,5953,No,No,7543
Tennessee,2020/12/20,161.6602121,11383,54,505880,6007,No,No,7543
Tennessee,2020/12/21,161.6602121,9265,65,515145,6072,No,No,7543
Tennessee,2020/12/22,161.6602121,4330,133,519475,6205,No,No,7543
Tennessee,2020/12/23,161.6602121,7851,111,527326,6316,No,No,5506
Tennessee,2020/12/24,161.6602121,5049,51,532375,6367,No,No,5506
Tennessee,2020/12/25,161.6602121,8892,0,541267,6367,No,No,5506
Tennessee,2020/12/26,161.6602121,4978,15,546245,6382,No,No,5506
Tennessee,2020/12/27,161.6602121,3054,69,549299,6451,No,No,5506
Tennessee,2020/12/28,161.6602121,3495,73,552794,6524,No,No,5506
Tennessee,2020/12/29,161.6602121,4760,123,557554,6647,No,No,5506
Tennessee,2020/12/30,161.6602121,8903,101,566457,6748,No,No,10986
Tennessee,2020/12/31,161.6602121,6122,98,572579,6846,No,No,10986
Tennessee,2021/1/1,161.6602121,0,0,572579,6846,No,No,10986
Tennessee,2021/1/2,161.6602121,16827,62,589406,6908,No,No,10986
Tennessee,2021/1/3,161.6602121,3957,54,593363,6962,No,No,10986
Tennessee,2021/1/4,161.6602121,3838,139,597201,7101,No,No,10986
Tennessee,2021/1/5,161.6602121,5196,99,602397,7200,No,No,10986
Tennessee,2021/1/6,161.6602121,7950,112,610347,7312,No,No,14084
Tennessee,2021/1/7,161.6602121,10210,112,620557,7424,No,No,14084
Tennessee,2021/1/8,161.6602121,7219,125,627776,7549,No,No,14084
Tennessee,2021/1/9,161.6602121,6446,85,634222,7634,No,No,14084
Tennessee,2021/1/10,161.6602121,6901,81,641123,7715,No,No,14084
Tennessee,2021/1/11,161.6602121,4255,80,645378,7795,No,No,14084
Tennessee,2021/1/12,161.6602121,3849,146,649227,7941,No,No,14084
Tennessee,2021/1/13,161.6602121,4341,131,653568,8072,No,No,11980
Tennessee,2021/1/14,161.6602121,4863,83,658431,8155,No,No,11980
Tennessee,2021/1/15,161.6602121,5055,78,663486,8233,No,No,11980
Tennessee,2021/1/16,161.6602121,4656,43,668142,8276,No,No,11980
Tennessee,2021/1/17,161.6602121,4150,36,672292,8312,No,No,11980
Tennessee,2021/1/18,161.6602121,2623,38,674915,8350,No,No,11980
Tennessee,2021/1/19,161.6602121,2510,41,677425,8391,No,No,11980
Tennessee,2021/1/20,161.6602121,4026,86,681451,8477,No,No,11615
Tennessee,2021/1/21,161.6602121,3586,129,685037,8606,No,No,11615
Tennessee,2021/1/22,161.6602121,3745,89,688782,8695,No,No,11615
Tennessee,2021/1/23,161.6602121,3266,41,692048,8736,No,No,11615
Tennessee,2021/1/24,161.6602121,2333,40,694381,8776,No,No,11615
Tennessee,2021/1/25,161.6602121,1554,111,695935,8887,No,No,11615
Tennessee,2021/1/26,161.6602121,3635,191,699570,9078,No,No,11615
Tennessee,2021/1/27,161.6602121,2427,152,701997,9230,No,No,12664
Tennessee,2021/1/28,161.6602121,2467,102,704464,9332,No,No,12664
Tennessee,2021/1/29,161.6602121,4257,42,708721,9374,No,No,12664
Tennessee,2021/1/30,161.6602121,2027,109,710748,9483,No,No,12664
Tennessee,2021/1/31,161.6602121,2542,74,713290,9557,No,No,12664
Tennessee,2021/2/1,161.6602121,2149,103,715439,9660,No,No,12664
Tennessee,2021/2/2,161.6602121,2033,146,717472,9806,No,No,12664
Tennessee,2021/2/3,161.6602121,1860,133,719332,9939,No,No,13464
Tennessee,2021/2/4,161.6602121,2956,168,722288,10107,No,No,13464
Tennessee,2021/2/5,161.6602121,2461,200,724749,10307,No,No,13464
Tennessee,2021/2/6,161.6602121,2679,58,727428,10365,No,No,13464
Tennessee,2021/2/7,161.6602121,1961,5,729389,10370,No,No,13464
Tennessee,2021/2/8,161.6602121,2065,95,731454,10465,No,No,13464
Tennessee,2021/2/9,161.6602121,1525,63,732979,10528,No,No,13464
Tennessee,2021/2/10,161.6602121,2618,98,735597,10626,No,No,12087
Tennessee,2021/2/11,161.6602121,2236,95,737833,10721,No,No,12087
Tennessee,2021/2/12,161.6602121,2163,81,739996,10802,No,No,12087
Tennessee,2021/2/13,161.6602121,1820,9,741816,10811,No,No,12087
Tennessee,2021/2/14,161.6602121,1450,31,743266,10842,No,No,12087
Tennessee,2021/2/15,161.6602121,1884,4,745150,10846,No,No,12087
Tennessee,2021/2/16,161.6602121,1033,16,746183,10862,No,No,12087
Tennessee,2021/2/17,161.6602121,934,30,747117,10892,No,No,11395
Tennessee,2021/2/18,161.6602121,1090,72,748207,10964,No,No,11395
Tennessee,2021/2/19,161.6602121,1305,7,749512,10971,No,No,11395
Tennessee,2021/2/20,161.6602121,1116,51,750628,11022,No,No,11395
Tennessee,2021/2/21,161.6602121,1035,18,751663,11040,No,No,11395
Tennessee,2021/2/22,161.6602121,1153,19,752816,11059,No,No,11395
Tennessee,2021/2/23,161.6602121,1345,49,754161,11108,No,No,11395
Tennessee,2021/2/24,161.6602121,1476,67,755637,11175,No,No,11395
Tennessee,2021/2/25,161.6602121,1868,53,757505,11228,No,No,11395
Tennessee,2021/2/26,161.6602121,1619,56,759124,11284,No,No,11395
Tennessee,2021/2/27,161.6602121,1165,15,760289,11299,No,No,11395
Tennessee,2021/2/28,161.6602121,943,18,761232,11317,No,No,11395
Tennessee,2021/3/1,161.6602121,659,10,761891,11327,No,No,11395
Tennessee,2021/3/2,161.6602121,1073,15,762964,11342,No,No,11395
Tennessee,2021/3/3,161.6602121,1333,23,764297,11365,No,No,11395
Tennessee,2021/3/4,161.6602121,1572,42,765869,11407,No,No,11395
Texas,2020/3/1,108.4610962,11,0,11,0,No,No,1575
Texas,2020/3/2,108.4610962,0,0,11,0,No,No,1575
Texas,2020/3/3,108.4610962,0,0,11,0,No,No,1575
Texas,2020/3/4,108.4610962,1,0,12,0,No,No,1663
Texas,2020/3/5,108.4610962,4,0,16,0,No,No,1663
Texas,2020/3/6,108.4610962,3,0,19,0,No,No,1663
Texas,2020/3/7,108.4610962,0,0,19,0,No,No,1663
Texas,2020/3/8,108.4610962,4,0,23,0,No,No,1663
Texas,2020/3/9,108.4610962,1,0,24,0,No,No,1663
Texas,2020/3/10,108.4610962,7,0,31,0,No,No,1663
Texas,2020/3/11,108.4610962,2,0,33,0,No,No,1819
Texas,2020/3/12,108.4610962,8,0,41,0,No,No,1819
Texas,2020/3/13,108.4610962,17,0,58,0,No,No,1819
Texas,2020/3/14,108.4610962,11,0,69,0,No,No,1819
Texas,2020/3/15,108.4610962,11,0,80,0,No,No,1819
Texas,2020/3/16,108.4610962,7,1,87,1,No,No,1819
Texas,2020/3/17,108.4610962,19,0,106,1,No,No,1819
Texas,2020/3/18,108.4610962,60,1,166,2,No,No,10892
Texas,2020/3/19,108.4610962,82,2,248,4,No,No,10892
Texas,2020/3/20,108.4610962,138,1,386,5,No,No,10892
Texas,2020/3/21,108.4610962,161,0,547,5,No,No,10892
Texas,2020/3/22,108.4610962,92,2,639,7,No,No,10892
Texas,2020/3/23,108.4610962,89,0,728,7,No,No,10892
Texas,2020/3/24,108.4610962,129,4,857,11,No,No,10892
Texas,2020/3/25,108.4610962,275,2,1132,13,No,No,80984
Texas,2020/3/26,108.4610962,410,8,1542,21,No,No,80984
Texas,2020/3/27,108.4610962,429,4,1971,25,No,No,80984
Texas,2020/3/28,108.4610962,410,5,2381,30,No,No,80984
Texas,2020/3/29,108.4610962,341,5,2722,35,No,No,80984
Texas,2020/3/30,108.4610962,343,11,3065,46,No,No,80984
Texas,2020/3/31,108.4610962,523,11,3588,57,No,No,80984
Texas,2020/4/1,108.4610962,814,8,4402,65,No,No,106739
Texas,2020/4/2,108.4610962,550,15,4952,80,Yes,No,106739
Texas,2020/4/3,108.4610962,821,18,5773,98,Yes,No,106739
Texas,2020/4/4,108.4610962,793,26,6566,124,Yes,No,106739
Texas,2020/4/5,108.4610962,551,12,7117,136,Yes,No,106739
Texas,2020/4/6,108.4610962,1033,23,8150,159,Yes,No,106739
Texas,2020/4/7,108.4610962,818,18,8968,177,Yes,No,106739
Texas,2020/4/8,108.4610962,929,18,9897,195,Yes,No,77515
Texas,2020/4/9,108.4610962,1475,33,11372,228,Yes,No,77515
Texas,2020/4/10,108.4610962,919,21,12291,249,Yes,No,77515
Texas,2020/4/11,108.4610962,917,16,13208,265,Yes,No,77515
Texas,2020/4/12,108.4610962,568,23,13776,288,Yes,No,77515
Texas,2020/4/13,108.4610962,711,32,14487,320,Yes,No,77515
Texas,2020/4/14,108.4610962,816,45,15303,365,Yes,No,77515
Texas,2020/4/15,108.4610962,803,30,16106,395,Yes,No,66432
Texas,2020/4/16,108.4610962,822,33,16928,428,Yes,No,66432
Texas,2020/4/17,108.4610962,1203,33,18131,461,Yes,No,66432
Texas,2020/4/18,108.4610962,796,26,18927,487,Yes,No,66432
Texas,2020/4/19,108.4610962,514,16,19441,503,Yes,No,66432
Texas,2020/4/20,108.4610962,594,20,20035,523,Yes,No,66432
Texas,2020/4/21,108.4610962,914,29,20949,552,Yes,No,66432
Texas,2020/4/22,108.4610962,820,19,21769,571,Yes,No,74966
Texas,2020/4/23,108.4610962,937,30,22706,601,Yes,No,74966
Texas,2020/4/24,108.4610962,944,24,23650,625,Yes,No,74966
Texas,2020/4/25,108.4610962,844,37,24494,662,Yes,No,74966
Texas,2020/4/26,108.4610962,715,14,25209,676,Yes,No,74966
Texas,2020/4/27,108.4610962,754,23,25963,699,Yes,No,74966
Texas,2020/4/28,108.4610962,905,39,26868,738,Yes,No,74966
Texas,2020/4/29,108.4610962,971,38,27839,776,Yes,No,28985
Texas,2020/4/30,108.4610962,1233,52,29072,828,Yes,No,28985
Texas,2020/5/1,108.4610962,1270,25,30342,853,No,No,28985
Texas,2020/5/2,108.4610962,1091,22,31433,875,No,No,28985
Texas,2020/5/3,108.4610962,866,15,32299,890,No,No,28985
Texas,2020/5/4,108.4610962,835,24,33134,914,No,No,28985
Texas,2020/5/5,108.4610962,1152,41,34286,955,No,No,28985
Texas,2020/5/6,108.4610962,1155,30,35441,985,No,No,26666
Texas,2020/5/7,108.4610962,1241,31,36682,1016,No,No,26666
Texas,2020/5/8,108.4610962,1261,43,37943,1059,No,No,26666
Texas,2020/5/9,108.4610962,906,27,38849,1086,No,No,26666
Texas,2020/5/10,108.4610962,1188,24,40037,1110,No,No,26666
Texas,2020/5/11,108.4610962,951,27,40988,1137,No,No,26666
Texas,2020/5/12,108.4610962,1360,32,42348,1169,No,No,26666
Texas,2020/5/13,108.4610962,1474,36,43822,1205,No,No,25150
Texas,2020/5/14,108.4610962,1347,51,45169,1256,No,No,25150
Texas,2020/5/15,108.4610962,1818,44,46987,1300,No,No,25150
Texas,2020/5/16,108.4610962,879,30,47866,1330,No,No,25150
Texas,2020/5/17,108.4610962,962,26,48828,1356,No,No,25150
Texas,2020/5/18,108.4610962,960,6,49788,1362,No,No,25150
Texas,2020/5/19,108.4610962,1292,43,51080,1405,No,No,25150
Texas,2020/5/20,108.4610962,1289,38,52369,1443,No,No,27919
Texas,2020/5/21,108.4610962,1072,37,53441,1480,No,No,27919
Texas,2020/5/22,108.4610962,928,18,54369,1498,No,No,27919
Texas,2020/5/23,108.4610962,1082,24,55451,1522,No,No,27919
Texas,2020/5/24,108.4610962,599,11,56050,1533,No,No,27919
Texas,2020/5/25,108.4610962,440,3,56490,1536,No,No,27919
Texas,2020/5/26,108.4610962,1083,16,57573,1552,No,No,27919
Texas,2020/5/27,108.4610962,1532,46,59105,1598,No,No,21335
Texas,2020/5/28,108.4610962,1715,20,60820,1618,No,No,21335
Texas,2020/5/29,108.4610962,1253,27,62073,1645,No,No,21335
Texas,2020/5/30,108.4610962,1323,31,63396,1676,No,No,21335
Texas,2020/5/31,108.4610962,1578,7,64974,1683,No,No,21335
Texas,2020/6/1,108.4610962,1107,12,66081,1695,No,No,21335
Texas,2020/6/2,108.4610962,1885,37,67966,1732,No,No,21335
Texas,2020/6/3,108.4610962,1580,34,69546,1766,No,No,19949
Texas,2020/6/4,108.4610962,1784,27,71330,1793,No,No,19949
Texas,2020/6/5,108.4610962,1993,28,73323,1821,No,No,19949
Texas,2020/6/6,108.4610962,1754,19,75077,1840,No,No,19949
Texas,2020/6/7,108.4610962,871,6,75948,1846,No,No,19949
Texas,2020/6/8,108.4610962,1378,10,77326,1856,No,No,19949
Texas,2020/6/9,108.4610962,1945,30,79271,1886,No,No,19949
Texas,2020/6/10,108.4610962,2500,30,81771,1916,No,No,18367
Texas,2020/6/11,108.4610962,2001,26,83772,1942,No,No,18367
Texas,2020/6/12,108.4610962,2259,23,86031,1965,No,No,18367
Texas,2020/6/13,108.4610962,2089,24,88120,1989,No,No,18367
Texas,2020/6/14,108.4610962,1422,6,89542,1995,No,No,18367
Texas,2020/6/15,108.4610962,2184,23,91726,2018,No,No,18367
Texas,2020/6/16,108.4610962,4247,39,95973,2057,No,No,18367
Texas,2020/6/17,108.4610962,3493,42,99466,2099,No,No,18671
Texas,2020/6/18,108.4610962,3211,38,102677,2137,No,No,18671
Texas,2020/6/19,108.4610962,4645,31,107322,2168,No,No,18671
Texas,2020/6/20,108.4610962,4272,18,111594,2186,No,No,18671
Texas,2020/6/21,108.4610962,3292,9,114886,2195,No,No,18671
Texas,2020/6/22,108.4610962,4760,18,119646,2213,No,No,18671
Texas,2020/6/23,108.4610962,5080,33,124726,2246,No,No,18671
Texas,2020/6/24,108.4610962,6584,46,131310,2292,No,No,18338
Texas,2020/6/25,108.4610962,5473,29,136783,2321,No,No,18338
Texas,2020/6/26,108.4610962,5799,41,142582,2362,No,No,18338
Texas,2020/6/27,108.4610962,6057,36,148639,2398,No,No,18338
Texas,2020/6/28,108.4610962,4227,10,152866,2408,No,No,18338
Texas,2020/6/29,108.4610962,5890,22,158756,2430,No,No,18338
Texas,2020/6/30,108.4610962,7947,52,166703,2482,No,No,18338
Texas,2020/7/1,108.4610962,8123,36,174826,2518,No,No,19056
Texas,2020/7/2,108.4610962,7434,44,182260,2562,No,No,19056
Texas,2020/7/3,108.4610962,7789,47,190049,2609,No,Yes,19056
Texas,2020/7/4,108.4610962,5658,37,195707,2646,No,Yes,19056
Texas,2020/7/5,108.4610962,4430,20,200137,2666,No,Yes,19056
Texas,2020/7/6,108.4610962,9213,60,209350,2726,No,Yes,19056
Texas,2020/7/7,108.4610962,9814,90,219164,2816,No,Yes,19056
Texas,2020/7/8,108.4610962,9952,119,229116,2935,No,Yes,20563
Texas,2020/7/9,108.4610962,10909,102,240025,3037,No,Yes,20563
Texas,2020/7/10,108.4610962,9923,92,249948,3129,No,Yes,20563
Texas,2020/7/11,108.4610962,8332,77,258280,3206,No,Yes,20563
Texas,2020/7/12,108.4610962,6531,40,264811,3246,No,Yes,20563
Texas,2020/7/13,108.4610962,8921,67,273732,3313,No,Yes,20563
Texas,2020/7/14,108.4610962,10906,136,284638,3449,No,Yes,20563
Texas,2020/7/15,108.4610962,11840,141,296478,3590,No,Yes,23676
Texas,2020/7/16,108.4610962,15038,154,311516,3744,No,Yes,23676
Texas,2020/7/17,108.4610962,9738,145,321254,3889,No,Yes,23676
Texas,2020/7/18,108.4610962,8805,83,330059,3972,No,Yes,23676
Texas,2020/7/19,108.4610962,7977,61,338036,4033,No,Yes,23676
Texas,2020/7/20,108.4610962,7636,127,345672,4160,No,Yes,23676
Texas,2020/7/21,108.4610962,9922,159,355594,4319,No,Yes,23676
Texas,2020/7/22,108.4610962,10967,203,366561,4522,No,Yes,17437
Texas,2020/7/23,108.4610962,9543,192,376104,4714,No,Yes,17437
Texas,2020/7/24,108.4610962,7558,162,383662,4876,No,Yes,17437
Texas,2020/7/25,108.4610962,7947,126,391609,5002,No,Yes,17437
Texas,2020/7/26,108.4610962,4129,88,395738,5090,No,Yes,17437
Texas,2020/7/27,108.4610962,6557,1202,402295,6292,No,Yes,17437
Texas,2020/7/28,108.4610962,10554,226,412849,6518,No,Yes,17437
Texas,2020/7/29,108.4610962,9042,316,421891,6834,No,Yes,11690
Texas,2020/7/30,108.4610962,10243,153,432134,6987,No,Yes,11690
Texas,2020/7/31,108.4610962,10956,286,443090,7273,No,Yes,11690
Texas,2020/8/1,108.4610962,5134,204,448224,7477,No,Yes,11690
Texas,2020/8/2,108.4610962,6535,43,454759,7520,No,Yes,11690
Texas,2020/8/3,108.4610962,8782,177,463541,7697,No,Yes,11690
Texas,2020/8/4,108.4610962,9564,254,473105,7951,No,Yes,11690
Texas,2020/8/5,108.4610962,9362,201,482467,8152,No,Yes,9467
Texas,2020/8/6,108.4610962,7635,248,490102,8400,No,Yes,9467
Texas,2020/8/7,108.4610962,8164,280,498266,8680,No,Yes,9467
Texas,2020/8/8,108.4610962,6339,205,504605,8885,No,Yes,9467
Texas,2020/8/9,108.4610962,5787,99,510392,8984,No,Yes,9467
Texas,2020/8/10,108.4610962,6790,80,517182,9064,No,Yes,9467
Texas,2020/8/11,108.4610962,7716,247,524898,9311,No,Yes,9467
Texas,2020/8/12,108.4610962,6927,334,531825,9645,No,Yes,11047
Texas,2020/8/13,108.4610962,6980,234,538805,9879,No,Yes,11047
Texas,2020/8/14,108.4610962,8865,316,547670,10195,No,Yes,11047
Texas,2020/8/15,108.4610962,7673,184,555343,10379,No,Yes,11047
Texas,2020/8/16,108.4610962,8121,119,563464,10498,No,Yes,11047
Texas,2020/8/17,108.4610962,5594,61,569058,10559,No,Yes,11047
Texas,2020/8/18,108.4610962,8162,239,577220,10798,No,Yes,11047
Texas,2020/8/19,108.4610962,5403,245,582623,11043,No,Yes,8676
Texas,2020/8/20,108.4610962,5277,205,587900,11248,No,Yes,8676
Texas,2020/8/21,108.4610962,5505,235,593405,11483,No,Yes,8676
Texas,2020/8/22,108.4610962,5751,167,599156,11650,No,Yes,8676
Texas,2020/8/23,108.4610962,2988,110,602144,11760,No,Yes,8676
Texas,2020/8/24,108.4610962,5477,64,607621,11824,No,Yes,8676
Texas,2020/8/25,108.4610962,6086,188,613707,12012,No,Yes,8676
Texas,2020/8/26,108.4610962,6129,200,619836,12212,No,Yes,8511
Texas,2020/8/27,108.4610962,3811,232,623647,12444,No,Yes,8511
Texas,2020/8/28,108.4610962,4845,171,628492,12615,No,Yes,8511
Texas,2020/8/29,108.4610962,5342,118,633834,12733,No,Yes,8511
Texas,2020/8/30,108.4610962,2713,74,636547,12807,No,Yes,8511
Texas,2020/8/31,108.4610962,3770,50,640317,12857,No,Yes,8511
Texas,2020/9/1,108.4610962,5217,147,645534,13004,No,Yes,8511
Texas,2020/9/2,108.4610962,4310,181,649844,13185,No,Yes,8901
Texas,2020/9/3,108.4610962,3477,202,653321,13387,No,Yes,8901
Texas,2020/9/4,108.4610962,5468,129,658789,13516,No,Yes,8901
Texas,2020/9/5,108.4610962,4457,144,663246,13660,No,Yes,8901
Texas,2020/9/6,108.4610962,2092,79,665338,13739,No,Yes,8901
Texas,2020/9/7,108.4610962,871,42,666209,13781,No,Yes,8901
Texas,2020/9/8,108.4610962,4218,74,670427,13855,No,Yes,8901
Texas,2020/9/9,108.4610962,4722,131,675149,13986,No,Yes,8848
Texas,2020/9/10,108.4610962,2739,12,677888,13998,No,Yes,8848
Texas,2020/9/11,108.4610962,5407,281,683295,14279,No,Yes,8848
Texas,2020/9/12,108.4610962,2626,105,685921,14384,No,Yes,8848
Texas,2020/9/13,108.4610962,4020,74,689941,14458,No,Yes,8848
Texas,2020/9/14,108.4610962,4606,50,694547,14508,No,Yes,8848
Texas,2020/9/15,108.4610962,6962,153,701509,14661,No,Yes,8848
Texas,2020/9/16,108.4610962,4525,142,706034,14803,No,Yes,8679
Texas,2020/9/17,108.4610962,4389,106,710423,14909,No,Yes,8679
Texas,2020/9/18,108.4610962,3229,128,713652,15037,No,Yes,8679
Texas,2020/9/19,108.4610962,3262,87,716914,15124,No,Yes,8679
Texas,2020/9/20,108.4610962,5546,35,722460,15159,No,Yes,8679
Texas,2020/9/21,108.4610962,22276,53,744736,15212,No,Yes,8679
Texas,2020/9/22,108.4610962,4333,110,749069,15322,No,Yes,8679
Texas,2020/9/23,108.4610962,4482,133,753551,15455,No,Yes,8805
Texas,2020/9/24,108.4610962,4828,132,758379,15587,No,Yes,8805
Texas,2020/9/25,108.4610962,3265,50,761644,15637,No,Yes,8805
Texas,2020/9/26,108.4610962,2998,155,764642,15792,No,Yes,8805
Texas,2020/9/27,108.4610962,5897,39,770539,15831,No,Yes,8805
Texas,2020/9/28,108.4610962,3140,67,773679,15898,No,Yes,8805
Texas,2020/9/29,108.4610962,6864,96,780543,15994,No,Yes,8805
Texas,2020/9/30,108.4610962,3484,108,784027,16102,No,Yes,7732
Texas,2020/10/1,108.4610962,4039,118,788066,16220,No,Yes,7732
Texas,2020/10/2,108.4610962,5896,87,793962,16307,No,Yes,7732
Texas,2020/10/3,108.4610962,5449,133,799411,16440,No,Yes,7732
Texas,2020/10/4,108.4610962,3029,31,802440,16471,No,Yes,7732
Texas,2020/10/5,108.4610962,4095,48,806535,16519,No,Yes,7732
Texas,2020/10/6,108.4610962,4656,103,811191,16622,No,Yes,7732
Texas,2020/10/7,108.4610962,5975,125,817166,16747,No,Yes,8581
Texas,2020/10/8,108.4610962,4566,106,821732,16853,No,Yes,8581
Texas,2020/10/9,108.4610962,4509,102,826241,16955,No,Yes,8581
Texas,2020/10/10,108.4610962,3517,64,829758,17019,No,Yes,8581
Texas,2020/10/11,108.4610962,2992,28,832750,17047,No,Yes,8581
Texas,2020/10/12,108.4610962,4057,26,836807,17073,No,Yes,8581
Texas,2020/10/13,108.4610962,5509,92,842316,17165,No,Yes,8581
Texas,2020/10/14,108.4610962,5852,111,848168,17276,No,Yes,7964
Texas,2020/10/15,108.4610962,5809,86,853977,17362,No,Yes,7964
Texas,2020/10/16,108.4610962,5590,92,859567,17454,No,Yes,7964
Texas,2020/10/17,108.4610962,4426,64,863993,17518,No,Yes,7964
Texas,2020/10/18,108.4610962,5383,23,869376,17541,No,Yes,7964
Texas,2020/10/19,108.4610962,4704,23,874080,17564,No,Yes,7964
Texas,2020/10/20,108.4610962,5869,80,879949,17644,No,Yes,7964
Texas,2020/10/21,108.4610962,6472,99,886421,17743,No,Yes,7126
Texas,2020/10/22,108.4610962,5293,17,891714,17760,No,Yes,7126
Texas,2020/10/23,108.4610962,7676,114,899390,17874,No,Yes,7126
Texas,2020/10/24,108.4610962,7267,124,906657,17998,No,Yes,7126
Texas,2020/10/25,108.4610962,3935,44,910592,18042,No,Yes,7126
Texas,2020/10/26,108.4610962,6648,35,917240,18077,No,Yes,7126
Texas,2020/10/27,108.4610962,7235,78,924475,18155,No,Yes,7126
Texas,2020/10/28,108.4610962,7770,96,932245,18251,No,Yes,7060
Texas,2020/10/29,108.4610962,7110,121,939355,18372,No,Yes,7060
Texas,2020/10/30,108.4610962,6668,105,946023,18477,No,Yes,7060
Texas,2020/10/31,108.4610962,7428,72,953451,18549,No,Yes,7060
Texas,2020/11/1,108.4610962,4338,33,957789,18582,No,Yes,7060
Texas,2020/11/2,108.4610962,7991,44,965780,18626,No,Yes,7060
Texas,2020/11/3,108.4610962,8512,96,974292,18722,No,Yes,7060
Texas,2020/11/4,108.4610962,10627,148,984919,18870,No,Yes,8764
Texas,2020/11/5,108.4610962,8975,130,993894,19000,No,Yes,8764
Texas,2020/11/6,108.4610962,10014,125,1003908,19125,No,Yes,8764
Texas,2020/11/7,108.4610962,5929,94,1009837,19219,No,Yes,8764
Texas,2020/11/8,108.4610962,6935,37,1016772,19256,No,Yes,8764
Texas,2020/11/9,108.4610962,9798,42,1026570,19298,No,Yes,8764
Texas,2020/11/10,108.4610962,11644,125,1038214,19423,No,Yes,8764
Texas,2020/11/11,108.4610962,12857,121,1051071,19544,No,Yes,9262
Texas,2020/11/12,108.4610962,9727,161,1060798,19705,No,Yes,9262
Texas,2020/11/13,108.4610962,12584,212,1073382,19917,No,Yes,9262
Texas,2020/11/14,108.4610962,9750,118,1083132,20035,No,Yes,9262
Texas,2020/11/15,108.4610962,7368,75,1090500,20110,No,Yes,9262
Texas,2020/11/16,108.4610962,11281,47,1101781,20157,No,Yes,9262
Texas,2020/11/17,108.4610962,10900,121,1112681,20278,No,Yes,9262
Texas,2020/11/18,108.4610962,13225,193,1125906,20471,No,Yes,11813
Texas,2020/11/19,108.4610962,13789,218,1139695,20689,No,Yes,11813
Texas,2020/11/20,108.4610962,13704,183,1153399,20872,No,Yes,11813
Texas,2020/11/21,108.4610962,10915,132,1164314,21004,No,Yes,11813
Texas,2020/11/22,108.4610962,8534,79,1172848,21083,No,Yes,11813
Texas,2020/11/23,108.4610962,11193,61,1184041,21144,No,Yes,11813
Texas,2020/11/24,108.4610962,20423,194,1204464,21338,No,Yes,11813
Texas,2020/11/25,108.4610962,14928,198,1219392,21536,No,Yes,7061
Texas,2020/11/26,108.4610962,4504,173,1223896,21709,No,Yes,7061
Texas,2020/11/27,108.4610962,4753,53,1228649,21762,No,Yes,7061
Texas,2020/11/28,108.4610962,6026,85,1234675,21847,No,Yes,7061
Texas,2020/11/29,108.4610962,12390,53,1247065,21900,No,Yes,7061
Texas,2020/11/30,108.4610962,15080,68,1262145,21968,No,Yes,7061
Texas,2020/12/1,108.4610962,13354,236,1275499,22204,No,Yes,7061
Texas,2020/12/2,108.4610962,18565,218,1294064,22422,No,Yes,7656
Texas,2020/12/3,108.4610962,17924,223,1311988,22645,No,Yes,7656
Texas,2020/12/4,108.4610962,14115,245,1326103,22890,No,Yes,7656
Texas,2020/12/5,108.4610962,11193,221,1337296,23111,No,Yes,7656
Texas,2020/12/6,108.4610962,9403,76,1346699,23187,No,Yes,7656
Texas,2020/12/7,108.4610962,14677,71,1361376,23258,No,Yes,7656
Texas,2020/12/8,108.4610962,13896,181,1375272,23439,No,Yes,7656
Texas,2020/12/9,108.4610962,15272,288,1390544,23727,No,Yes,7568
Texas,2020/12/10,108.4610962,13143,240,1403687,23967,No,Yes,7568
Texas,2020/12/11,108.4610962,58256,241,1461943,24208,No,Yes,7568
Texas,2020/12/12,108.4610962,11375,192,1473318,24400,No,Yes,7568
Texas,2020/12/13,108.4610962,6729,101,1480047,24501,No,Yes,7568
Texas,2020/12/14,108.4610962,13810,81,1493857,24582,No,Yes,7568
Texas,2020/12/15,108.4610962,19502,214,1513359,24796,No,Yes,7568
Texas,2020/12/16,108.4610962,21964,282,1535323,25078,No,Yes,7543
Texas,2020/12/17,108.4610962,17226,258,1552549,25336,No,Yes,7543
Texas,2020/12/18,108.4610962,19376,272,1571925,25608,No,Yes,7543
Texas,2020/12/19,108.4610962,13413,233,1585338,25841,No,Yes,7543
Texas,2020/12/20,108.4610962,7863,107,1593201,25948,No,Yes,7543
Texas,2020/12/21,108.4610962,16940,216,1610141,26164,No,Yes,7543
Texas,2020/12/22,108.4610962,22156,199,1632297,26363,No,Yes,7543
Texas,2020/12/23,108.4610962,20697,261,1652994,26624,No,Yes,5506
Texas,2020/12/24,108.4610962,8013,255,1661007,26879,No,Yes,5506
Texas,2020/12/25,108.4610962,2087,163,1663094,27042,No,Yes,5506
Texas,2020/12/26,108.4610962,5749,20,1668843,27062,No,Yes,5506
Texas,2020/12/27,108.4610962,22672,48,1691515,27110,No,Yes,5506
Texas,2020/12/28,108.4610962,20471,135,1711986,27245,No,Yes,5506
Texas,2020/12/29,108.4610962,23823,254,1735809,27499,No,Yes,5506
Texas,2020/12/30,108.4610962,19484,322,1755293,27821,No,Yes,10986
Texas,2020/12/31,108.4610962,16870,334,1772163,28155,No,Yes,10986
Texas,2021/1/1,108.4610962,7798,279,1779961,28434,No,Yes,10986
Texas,2021/1/2,108.4610962,13897,74,1793858,28508,No,Yes,10986
Texas,2021/1/3,108.4610962,16207,46,1810065,28554,No,Yes,10986
Texas,2021/1/4,108.4610962,23115,127,1833180,28681,No,Yes,10986
Texas,2021/1/5,108.4610962,31007,268,1864187,28949,No,Yes,10986
Texas,2021/1/6,108.4610962,25341,329,1889528,29278,No,Yes,14084
Texas,2021/1/7,108.4610962,22631,367,1912159,29645,No,Yes,14084
Texas,2021/1/8,108.4610962,23927,464,1936086,30109,No,Yes,14084
Texas,2021/1/9,108.4610962,17730,332,1953816,30441,No,Yes,14084
Texas,2021/1/10,108.4610962,14043,158,1967859,30599,No,Yes,14084
Texas,2021/1/11,108.4610962,23766,121,1991625,30720,No,Yes,14084
Texas,2021/1/12,108.4610962,27060,297,2018685,31017,No,Yes,14084
Texas,2021/1/13,108.4610962,23324,379,2042009,31396,No,Yes,11980
Texas,2021/1/14,108.4610962,29923,423,2071932,31819,No,Yes,11980
Texas,2021/1/15,108.4610962,24594,393,2096526,32212,No,Yes,11980
Texas,2021/1/16,108.4610962,18332,369,2114858,32581,No,Yes,11980
Texas,2021/1/17,108.4610962,12476,166,2127334,32747,No,Yes,11980
Texas,2021/1/18,108.4610962,11240,111,2138574,32858,No,Yes,11980
Texas,2021/1/19,108.4610962,21882,318,2160456,33176,No,Yes,11980
Texas,2021/1/20,108.4610962,28029,456,2188485,33632,No,Yes,11615
Texas,2021/1/21,108.4610962,21510,443,2209995,34075,No,Yes,11615
Texas,2021/1/22,108.4610962,18306,421,2228301,34496,No,Yes,11615
Texas,2021/1/23,108.4610962,13844,363,2242145,34859,No,Yes,11615
Texas,2021/1/24,108.4610962,7814,191,2249959,35050,No,Yes,11615
Texas,2021/1/25,108.4610962,20432,186,2270391,35236,No,Yes,11615
Texas,2021/1/26,108.4610962,20616,308,2291007,35544,No,Yes,11615
Texas,2021/1/27,108.4610962,19778,480,2310785,36024,No,Yes,12664
Texas,2021/1/28,108.4610962,19322,410,2330107,36434,No,Yes,12664
Texas,2021/1/29,108.4610962,18940,370,2349047,36804,No,Yes,12664
Texas,2021/1/30,108.4610962,13770,292,2362817,37096,No,Yes,12664
Texas,2021/1/31,108.4610962,12401,146,2375218,37242,No,Yes,12664
Texas,2021/2/1,108.4610962,39250,163,2414468,37405,No,Yes,12664
Texas,2021/2/2,108.4610962,18223,355,2432691,37760,No,Yes,12664
Texas,2021/2/3,108.4610962,18014,443,2450705,38203,No,Yes,13464
Texas,2021/2/4,108.4610962,13602,407,2464307,38610,No,Yes,13464
Texas,2021/2/5,108.4610962,14437,429,2478744,39039,No,Yes,13464
Texas,2021/2/6,108.4610962,8516,291,2487260,39330,No,Yes,13464
Texas,2021/2/7,108.4610962,7535,160,2494795,39490,No,Yes,13464
Texas,2021/2/8,108.4610962,10930,165,2505725,39655,No,Yes,13464
Texas,2021/2/9,108.4610962,13245,318,2518970,39973,No,Yes,13464
Texas,2021/2/10,108.4610962,13100,324,2532070,40297,No,Yes,12087
Texas,2021/2/11,108.4610962,11927,364,2543997,40661,No,Yes,12087
Texas,2021/2/12,108.4610962,12295,402,2556292,41063,No,Yes,12087
Texas,2021/2/13,108.4610962,8045,257,2564337,41320,No,Yes,12087
Texas,2021/2/14,108.4610962,4521,120,2568858,41440,No,Yes,12087
Texas,2021/2/15,108.4610962,2931,44,2571789,41484,No,Yes,12087
Texas,2021/2/16,108.4610962,3641,62,2575430,41546,No,Yes,12087
Texas,2021/2/17,108.4610962,4529,104,2579959,41650,No,Yes,11395
Texas,2021/2/18,108.4610962,2387,114,2582346,41764,No,Yes,11395
Texas,2021/2/19,108.4610962,5945,236,2588291,42000,No,Yes,11395
Texas,2021/2/20,108.4610962,5532,202,2593823,42202,No,Yes,11395
Texas,2021/2/21,108.4610962,6407,119,2600230,42321,No,Yes,11395
Texas,2021/2/22,108.4610962,7346,163,2607576,42484,No,Yes,11395
Texas,2021/2/23,108.4610962,10274,244,2617850,42728,No,Yes,11395
Texas,2021/2/24,108.4610962,7640,325,2625490,43053,No,Yes,11395
Texas,2021/2/25,108.4610962,7820,297,2633310,43350,No,Yes,11395
Texas,2021/2/26,108.4610962,10911,283,2644221,43633,No,Yes,11395
Texas,2021/2/27,108.4610962,5443,139,2649664,43772,No,Yes,11395
Texas,2021/2/28,108.4610962,3621,177,2653285,43949,No,Yes,11395
Texas,2021/3/1,108.4610962,8140,129,2661425,44078,No,Yes,11395
Texas,2021/3/2,108.4610962,7240,275,2668665,44353,No,Yes,11395
Texas,2021/3/3,108.4610962,7593,274,2676258,44627,No,Yes,11395
Texas,2021/3/4,108.4610962,7582,293,2683840,44920,No,Yes,11395
Utah,2020/3/1,37.75446323,1,0,1,0,No,No,1575
Utah,2020/3/2,37.75446323,0,0,1,0,No,No,1575
Utah,2020/3/3,37.75446323,0,0,1,0,No,No,1575
Utah,2020/3/4,37.75446323,0,0,1,0,No,No,1663
Utah,2020/3/5,37.75446323,0,0,1,0,No,No,1663
Utah,2020/3/6,37.75446323,2,0,3,0,No,No,1663
Utah,2020/3/7,37.75446323,0,0,3,0,No,No,1663
Utah,2020/3/8,37.75446323,0,0,3,0,No,No,1663
Utah,2020/3/9,37.75446323,0,0,3,0,No,No,1663
Utah,2020/3/10,37.75446323,1,0,4,0,No,No,1663
Utah,2020/3/11,37.75446323,1,0,5,0,No,No,1819
Utah,2020/3/12,37.75446323,2,0,7,0,No,No,1819
Utah,2020/3/13,37.75446323,0,0,7,0,No,No,1819
Utah,2020/3/14,37.75446323,14,0,21,0,No,No,1819
Utah,2020/3/15,37.75446323,8,0,29,0,No,No,1819
Utah,2020/3/16,37.75446323,11,0,40,0,No,No,1819
Utah,2020/3/17,37.75446323,11,0,51,0,No,No,1819
Utah,2020/3/18,37.75446323,14,0,65,0,No,No,10892
Utah,2020/3/19,37.75446323,15,0,80,0,No,No,10892
Utah,2020/3/20,37.75446323,32,0,112,0,No,No,10892
Utah,2020/3/21,37.75446323,26,0,138,0,No,No,10892
Utah,2020/3/22,37.75446323,44,1,182,1,No,No,10892
Utah,2020/3/23,37.75446323,75,0,257,1,No,No,10892
Utah,2020/3/24,37.75446323,42,0,299,1,No,No,10892
Utah,2020/3/25,37.75446323,47,0,346,1,No,No,80984
Utah,2020/3/26,37.75446323,56,0,402,1,No,No,80984
Utah,2020/3/27,37.75446323,78,1,480,2,No,No,80984
Utah,2020/3/28,37.75446323,128,0,608,2,No,No,80984
Utah,2020/3/29,37.75446323,111,0,719,2,No,No,80984
Utah,2020/3/30,37.75446323,87,2,806,4,No,No,80984
Utah,2020/3/31,37.75446323,81,1,887,5,No,No,80984
Utah,2020/4/1,37.75446323,125,2,1012,7,No,No,106739
Utah,2020/4/2,37.75446323,65,0,1077,7,No,No,106739
Utah,2020/4/3,37.75446323,171,0,1248,7,No,No,106739
Utah,2020/4/4,37.75446323,178,1,1426,8,No,No,106739
Utah,2020/4/5,37.75446323,192,0,1618,8,No,No,106739
Utah,2020/4/6,37.75446323,44,5,1662,13,No,No,106739
Utah,2020/4/7,37.75446323,75,0,1737,13,No,No,106739
Utah,2020/4/8,37.75446323,123,0,1860,13,No,No,77515
Utah,2020/4/9,37.75446323,120,0,1980,13,No,No,77515
Utah,2020/4/10,37.75446323,123,4,2103,17,No,No,77515
Utah,2020/4/11,37.75446323,105,1,2208,18,No,No,77515
Utah,2020/4/12,37.75446323,97,0,2305,18,No,No,77515
Utah,2020/4/13,37.75446323,63,0,2368,18,No,No,77515
Utah,2020/4/14,37.75446323,52,1,2420,19,No,No,77515
Utah,2020/4/15,37.75446323,129,1,2549,20,No,No,66432
Utah,2020/4/16,37.75446323,138,1,2687,21,No,No,66432
Utah,2020/4/17,37.75446323,126,2,2813,23,No,No,66432
Utah,2020/4/18,37.75446323,129,2,2942,25,No,No,66432
Utah,2020/4/19,37.75446323,129,2,3071,27,No,No,66432
Utah,2020/4/20,37.75446323,142,1,3213,28,No,No,66432
Utah,2020/4/21,37.75446323,88,4,3301,32,No,No,66432
Utah,2020/4/22,37.75446323,150,2,3451,34,No,No,74966
Utah,2020/4/23,37.75446323,170,1,3621,35,No,No,74966
Utah,2020/4/24,37.75446323,161,4,3782,39,No,No,74966
Utah,2020/4/25,37.75446323,168,2,3950,41,No,No,74966
Utah,2020/4/26,37.75446323,173,0,4123,41,No,No,74966
Utah,2020/4/27,37.75446323,113,0,4236,41,No,No,74966
Utah,2020/4/28,37.75446323,107,4,4343,45,No,No,74966
Utah,2020/4/29,37.75446323,156,0,4499,45,No,No,28985
Utah,2020/4/30,37.75446323,173,1,4672,46,No,No,28985
Utah,2020/5/1,37.75446323,157,0,4829,46,No,No,28985
Utah,2020/5/2,37.75446323,152,3,4981,49,No,No,28985
Utah,2020/5/3,37.75446323,194,1,5175,50,No,No,28985
Utah,2020/5/4,37.75446323,151,0,5326,50,No,No,28985
Utah,2020/5/5,37.75446323,123,6,5449,56,No,No,28985
Utah,2020/5/6,37.75446323,156,3,5605,59,No,No,26666
Utah,2020/5/7,37.75446323,119,2,5724,61,No,No,26666
Utah,2020/5/8,37.75446323,195,0,5919,61,No,No,26666
Utah,2020/5/9,37.75446323,184,5,6103,66,No,No,26666
Utah,2020/5/10,37.75446323,148,1,6251,67,No,No,26666
Utah,2020/5/11,37.75446323,113,1,6364,68,No,No,26666
Utah,2020/5/12,37.75446323,90,5,6454,73,No,No,26666
Utah,2020/5/13,37.75446323,170,3,6624,76,No,No,25150
Utah,2020/5/14,37.75446323,136,0,6760,76,No,No,25150
Utah,2020/5/15,37.75446323,170,1,6930,77,No,No,25150
Utah,2020/5/16,37.75446323,138,1,7068,78,No,No,25150
Utah,2020/5/17,37.75446323,170,2,7238,80,No,No,25150
Utah,2020/5/18,37.75446323,146,0,7384,80,No,No,25150
Utah,2020/5/19,37.75446323,146,8,7530,88,No,No,25150
Utah,2020/5/20,37.75446323,187,2,7717,90,No,No,27919
Utah,2020/5/21,37.75446323,159,2,7876,92,No,No,27919
Utah,2020/5/22,37.75446323,181,1,8057,93,No,No,27919
Utah,2020/5/23,37.75446323,203,4,8260,97,No,No,27919
Utah,2020/5/24,37.75446323,132,0,8392,97,No,No,27919
Utah,2020/5/25,37.75446323,129,1,8521,98,No,No,27919
Utah,2020/5/26,37.75446323,101,3,8622,101,No,No,27919
Utah,2020/5/27,37.75446323,88,4,8710,105,No,No,21335
Utah,2020/5/28,37.75446323,243,1,8953,106,No,No,21335
Utah,2020/5/29,37.75446323,329,1,9282,107,No,No,21335
Utah,2020/5/30,37.75446323,269,5,9551,112,No,No,21335
Utah,2020/5/31,37.75446323,278,1,9829,113,No,No,21335
Utah,2020/6/1,37.75446323,197,0,10026,113,No,No,21335
Utah,2020/6/2,37.75446323,211,0,10237,113,No,No,21335
Utah,2020/6/3,37.75446323,321,4,10558,117,No,No,19949
Utah,2020/6/4,37.75446323,300,0,10858,117,No,No,19949
Utah,2020/6/5,37.75446323,486,3,11344,120,No,No,19949
Utah,2020/6/6,37.75446323,522,1,11866,121,No,No,19949
Utah,2020/6/7,37.75446323,218,0,12084,121,No,No,19949
Utah,2020/6/8,37.75446323,294,3,12378,124,No,No,19949
Utah,2020/6/9,37.75446323,261,3,12639,127,No,No,19949
Utah,2020/6/10,37.75446323,343,1,12982,128,No,No,18367
Utah,2020/6/11,37.75446323,384,3,13366,131,No,No,18367
Utah,2020/6/12,37.75446323,315,8,13681,139,No,No,18367
Utah,2020/6/13,37.75446323,380,0,14061,139,No,No,18367
Utah,2020/6/14,37.75446323,252,0,14313,139,No,No,18367
Utah,2020/6/15,37.75446323,444,4,14757,143,No,No,18367
Utah,2020/6/16,37.75446323,320,2,15077,145,No,No,18367
Utah,2020/6/17,37.75446323,387,4,15464,149,No,No,18671
Utah,2020/6/18,37.75446323,551,3,16015,152,No,No,18671
Utah,2020/6/19,37.75446323,570,3,16585,155,No,No,18671
Utah,2020/6/20,37.75446323,588,0,17173,155,No,No,18671
Utah,2020/6/21,37.75446323,394,3,17567,158,No,No,18671
Utah,2020/6/22,37.75446323,468,0,18035,158,No,No,18671
Utah,2020/6/23,37.75446323,419,5,18454,163,No,No,18671
Utah,2020/6/24,37.75446323,461,0,18915,163,No,No,18338
Utah,2020/6/25,37.75446323,629,1,19544,164,No,No,18338
Utah,2020/6/26,37.75446323,674,2,20218,166,No,No,18338
Utah,2020/6/27,37.75446323,517,1,20735,167,No,No,18338
Utah,2020/6/28,37.75446323,420,0,21155,167,No,No,18338
Utah,2020/6/29,37.75446323,663,1,21818,168,No,No,18338
Utah,2020/6/30,37.75446323,546,4,22364,172,No,No,18338
Utah,2020/7/1,37.75446323,500,1,22864,173,No,No,19056
Utah,2020/7/2,37.75446323,602,3,23466,176,No,No,19056
Utah,2020/7/3,37.75446323,604,5,24070,181,No,No,19056
Utah,2020/7/4,37.75446323,647,0,24717,181,No,No,19056
Utah,2020/7/5,37.75446323,288,3,25005,184,No,No,19056
Utah,2020/7/6,37.75446323,648,6,25653,190,No,No,19056
Utah,2020/7/7,37.75446323,550,4,26203,194,No,No,19056
Utah,2020/7/8,37.75446323,718,7,26921,201,No,No,20563
Utah,2020/7/9,37.75446323,711,4,27632,205,No,No,20563
Utah,2020/7/10,37.75446323,820,2,28452,207,No,Yes,20563
Utah,2020/7/11,37.75446323,619,5,29071,212,No,Yes,20563
Utah,2020/7/12,37.75446323,481,3,29552,215,No,Yes,20563
Utah,2020/7/13,37.75446323,730,1,30282,216,No,Yes,20563
Utah,2020/7/14,37.75446323,492,10,30774,226,No,Yes,20563
Utah,2020/7/15,37.75446323,454,7,31228,233,No,Yes,23676
Utah,2020/7/16,37.75446323,680,1,31908,234,No,Yes,23676
Utah,2020/7/17,37.75446323,664,4,32572,238,No,Yes,23676
Utah,2020/7/18,37.75446323,858,5,33430,243,No,Yes,23676
Utah,2020/7/19,37.75446323,687,0,34117,243,No,Yes,23676
Utah,2020/7/20,37.75446323,409,6,34526,249,No,Yes,23676
Utah,2020/7/21,37.75446323,563,6,35089,255,No,Yes,23676
Utah,2020/7/22,37.75446323,588,7,35677,262,No,Yes,17437
Utah,2020/7/23,37.75446323,501,9,36178,271,No,Yes,17437
Utah,2020/7/24,37.75446323,885,6,37063,277,No,Yes,17437
Utah,2020/7/25,37.75446323,560,1,37623,278,No,Yes,17437
Utah,2020/7/26,37.75446323,350,0,37973,278,No,Yes,17437
Utah,2020/7/27,37.75446323,466,7,38439,285,No,Yes,17437
Utah,2020/7/28,37.75446323,438,5,38877,290,No,Yes,17437
Utah,2020/7/29,37.75446323,462,7,39339,297,No,Yes,11690
Utah,2020/7/30,37.75446323,375,6,39714,303,No,Yes,11690
Utah,2020/7/31,37.75446323,544,5,40258,308,No,Yes,11690
Utah,2020/8/1,37.75446323,496,4,40754,312,No,Yes,11690
Utah,2020/8/2,37.75446323,421,1,41175,313,No,Yes,11690
Utah,2020/8/3,37.75446323,396,4,41571,317,No,Yes,11690
Utah,2020/8/4,37.75446323,447,7,42018,324,No,Yes,11690
Utah,2020/8/5,37.75446323,460,6,42478,330,No,Yes,9467
Utah,2020/8/6,37.75446323,554,2,43032,332,No,Yes,9467
Utah,2020/8/7,37.75446323,498,5,43530,337,No,Yes,9467
Utah,2020/8/8,37.75446323,291,-1,43821,336,No,Yes,9467
Utah,2020/8/9,37.75446323,309,1,44130,337,No,Yes,9467
Utah,2020/8/10,37.75446323,357,9,44487,346,No,Yes,9467
Utah,2020/8/11,37.75446323,349,4,44836,350,No,Yes,9467
Utah,2020/8/12,37.75446323,345,5,45181,355,No,Yes,11047
Utah,2020/8/13,37.75446323,356,3,45537,358,No,Yes,11047
Utah,2020/8/14,37.75446323,511,4,46048,362,No,Yes,11047
Utah,2020/8/15,37.75446323,365,2,46413,364,No,Yes,11047
Utah,2020/8/16,37.75446323,239,0,46652,364,No,Yes,11047
Utah,2020/8/17,37.75446323,284,2,46936,366,No,Yes,11047
Utah,2020/8/18,37.75446323,349,6,47285,372,No,Yes,11047
Utah,2020/8/19,37.75446323,362,7,47647,379,No,Yes,8676
Utah,2020/8/20,37.75446323,456,5,48103,384,No,Yes,8676
Utah,2020/8/21,37.75446323,513,1,48616,385,No,Yes,8676
Utah,2020/8/22,37.75446323,334,2,48950,387,No,Yes,8676
Utah,2020/8/23,37.75446323,175,0,49125,387,No,Yes,8676
Utah,2020/8/24,37.75446323,326,4,49451,391,No,Yes,8676
Utah,2020/8/25,37.75446323,419,7,49870,398,No,Yes,8676
Utah,2020/8/26,37.75446323,428,6,50298,404,No,Yes,8511
Utah,2020/8/27,37.75446323,370,0,50668,404,No,Yes,8511
Utah,2020/8/28,37.75446323,403,4,51071,408,No,Yes,8511
Utah,2020/8/29,37.75446323,415,0,51486,408,No,Yes,8511
Utah,2020/8/30,37.75446323,368,0,51854,408,No,Yes,8511
Utah,2020/8/31,37.75446323,312,1,52166,409,No,Yes,8511
Utah,2020/9/1,37.75446323,339,1,52505,410,No,Yes,8511
Utah,2020/9/2,37.75446323,445,4,52950,414,No,Yes,8901
Utah,2020/9/3,37.75446323,462,2,53412,416,No,Yes,8901
Utah,2020/9/4,37.75446323,528,4,53940,420,No,Yes,8901
Utah,2020/9/5,37.75446323,424,1,54364,421,No,Yes,8901
Utah,2020/9/6,37.75446323,296,2,54660,423,No,Yes,8901
Utah,2020/9/7,37.75446323,392,1,55052,424,No,Yes,8901
Utah,2020/9/8,37.75446323,372,2,55424,426,No,Yes,8901
Utah,2020/9/9,37.75446323,306,2,55730,428,No,Yes,8848
Utah,2020/9/10,37.75446323,452,3,56182,431,No,Yes,8848
Utah,2020/9/11,37.75446323,607,2,56789,433,No,Yes,8848
Utah,2020/9/12,37.75446323,487,1,57276,434,No,Yes,8848
Utah,2020/9/13,37.75446323,616,0,57892,434,No,Yes,8848
Utah,2020/9/14,37.75446323,559,2,58451,436,No,Yes,8848
Utah,2020/9/15,37.75446323,566,0,59017,436,No,Yes,8848
Utah,2020/9/16,37.75446323,753,1,59770,437,No,Yes,8679
Utah,2020/9/17,37.75446323,892,0,60662,437,No,Yes,8679
Utah,2020/9/18,37.75446323,1124,0,61786,437,No,Yes,8679
Utah,2020/9/19,37.75446323,1107,3,62893,440,No,Yes,8679
Utah,2020/9/20,37.75446323,881,0,63774,440,No,Yes,8679
Utah,2020/9/21,37.75446323,630,1,64404,441,No,Yes,8679
Utah,2020/9/22,37.75446323,654,2,65058,443,No,Yes,8679
Utah,2020/9/23,37.75446323,890,1,65948,444,No,Yes,8805
Utah,2020/9/24,37.75446323,1219,0,67167,444,No,Yes,8805
Utah,2020/9/25,37.75446323,1370,4,68537,448,No,Yes,8805
Utah,2020/9/26,37.75446323,1019,0,69556,448,No,Yes,8805
Utah,2020/9/27,37.75446323,1060,5,70616,453,No,Yes,8805
Utah,2020/9/28,37.75446323,826,0,71442,453,No,Yes,8805
Utah,2020/9/29,37.75446323,694,4,72136,457,No,Yes,8805
Utah,2020/9/30,37.75446323,917,3,73053,460,No,Yes,7732
Utah,2020/10/1,37.75446323,1046,0,74099,460,No,Yes,7732
Utah,2020/10/2,37.75446323,1076,14,75175,474,No,Yes,7732
Utah,2020/10/3,37.75446323,1056,2,76231,476,No,Yes,7732
Utah,2020/10/4,37.75446323,1387,2,77618,478,No,Yes,7732
Utah,2020/10/5,37.75446323,1115,5,78733,483,No,Yes,7732
Utah,2020/10/6,37.75446323,716,6,79449,489,No,Yes,7732
Utah,2020/10/7,37.75446323,1073,10,80522,499,No,Yes,8581
Utah,2020/10/8,37.75446323,1453,5,81975,504,No,Yes,8581
Utah,2020/10/9,37.75446323,1332,4,83307,508,No,Yes,8581
Utah,2020/10/10,37.75446323,1390,4,84697,512,No,Yes,8581
Utah,2020/10/11,37.75446323,1147,6,85844,518,No,Yes,8581
Utah,2020/10/12,37.75446323,1035,6,86879,524,No,Yes,8581
Utah,2020/10/13,37.75446323,946,0,87825,524,No,Yes,8581
Utah,2020/10/14,37.75446323,1193,5,89018,529,No,Yes,7964
Utah,2020/10/15,37.75446323,1470,2,90488,531,No,Yes,7964
Utah,2020/10/16,37.75446323,1478,8,91966,539,No,Yes,7964
Utah,2020/10/17,37.75446323,1331,2,93297,541,No,Yes,7964
Utah,2020/10/18,37.75446323,1097,3,94394,544,No,Yes,7964
Utah,2020/10/19,37.75446323,1178,3,95572,547,No,Yes,7964
Utah,2020/10/20,37.75446323,1071,5,96643,552,No,Yes,7964
Utah,2020/10/21,37.75446323,1394,6,98037,558,No,Yes,7126
Utah,2020/10/22,37.75446323,1526,5,99563,563,No,Yes,7126
Utah,2020/10/23,37.75446323,2011,4,101574,567,No,Yes,7126
Utah,2020/10/24,37.75446323,1563,1,103137,568,No,Yes,7126
Utah,2020/10/25,37.75446323,1916,4,105053,572,No,Yes,7126
Utah,2020/10/26,37.75446323,1030,3,106083,575,No,Yes,7126
Utah,2020/10/27,37.75446323,1163,4,107246,579,No,Yes,7126
Utah,2020/10/28,37.75446323,1617,9,108863,588,No,Yes,7060
Utah,2020/10/29,37.75446323,1803,10,110666,598,No,Yes,7060
Utah,2020/10/30,37.75446323,2266,3,112932,601,No,Yes,7060
Utah,2020/10/31,37.75446323,1738,3,114670,604,No,Yes,7060
Utah,2020/11/1,37.75446323,1840,10,116510,614,No,Yes,7060
Utah,2020/11/2,37.75446323,1257,0,117767,614,No,Yes,7060
Utah,2020/11/3,37.75446323,1608,6,119375,620,No,Yes,7060
Utah,2020/11/4,37.75446323,2188,5,121563,625,No,Yes,8764
Utah,2020/11/5,37.75446323,2803,7,124366,632,No,Yes,8764
Utah,2020/11/6,37.75446323,2928,17,127294,649,No,Yes,8764
Utah,2020/11/7,37.75446323,2944,9,130238,658,No,Yes,8764
Utah,2020/11/8,37.75446323,2383,1,132621,659,No,Yes,8764
Utah,2020/11/9,37.75446323,2247,2,134868,661,No,Yes,8764
Utah,2020/11/10,37.75446323,2655,11,137523,672,No,Yes,8764
Utah,2020/11/11,37.75446323,2292,6,139815,678,No,Yes,9262
Utah,2020/11/12,37.75446323,3824,11,143639,689,No,Yes,9262
Utah,2020/11/13,37.75446323,2516,14,146155,703,No,Yes,9262
Utah,2020/11/14,37.75446323,4986,9,151141,712,No,Yes,9262
Utah,2020/11/15,37.75446323,2667,6,153808,718,No,Yes,9262
Utah,2020/11/16,37.75446323,1971,7,155779,725,No,Yes,9262
Utah,2020/11/17,37.75446323,3227,9,159006,734,No,Yes,9262
Utah,2020/11/18,37.75446323,3085,8,162091,742,No,Yes,11813
Utah,2020/11/19,37.75446323,3949,16,166040,758,No,Yes,11813
Utah,2020/11/20,37.75446323,4604,18,170644,776,No,Yes,11813
Utah,2020/11/21,37.75446323,3343,13,173987,789,No,Yes,11813
Utah,2020/11/22,37.75446323,3189,4,177176,793,No,Yes,11813
Utah,2020/11/23,37.75446323,2244,6,179420,799,No,Yes,11813
Utah,2020/11/24,37.75446323,2701,11,182121,810,No,Yes,11813
Utah,2020/11/25,37.75446323,1839,24,183960,834,No,Yes,7061
Utah,2020/11/26,37.75446323,422,0,184382,834,No,Yes,7061
Utah,2020/11/27,37.75446323,5662,15,190044,849,No,Yes,7061
Utah,2020/11/28,37.75446323,2043,14,192087,863,No,Yes,7061
Utah,2020/11/29,37.75446323,1722,5,193809,868,No,Yes,7061
Utah,2020/11/30,37.75446323,1935,3,195744,871,No,Yes,7061
Utah,2020/12/1,37.75446323,2516,19,198260,890,No,Yes,7061
Utah,2020/12/2,37.75446323,3960,16,202220,906,No,Yes,7656
Utah,2020/12/3,37.75446323,4035,12,206255,918,No,Yes,7656
Utah,2020/12/4,37.75446323,3003,8,209258,926,No,Yes,7656
Utah,2020/12/5,37.75446323,3586,13,212844,939,No,Yes,7656
Utah,2020/12/6,37.75446323,2563,0,215407,939,No,Yes,7656
Utah,2020/12/7,37.75446323,2231,10,217638,949,No,Yes,7656
Utah,2020/12/8,37.75446323,2333,23,219971,972,No,Yes,7656
Utah,2020/12/9,37.75446323,2574,23,222545,995,No,Yes,7568
Utah,2020/12/10,37.75446323,3401,21,225946,1016,No,Yes,7568
Utah,2020/12/11,37.75446323,2200,11,228146,1027,No,Yes,7568
Utah,2020/12/12,37.75446323,3675,12,231821,1039,No,Yes,7568
Utah,2020/12/13,37.75446323,2083,16,233904,1055,No,Yes,7568
Utah,2020/12/14,37.75446323,1968,10,235872,1065,No,Yes,7568
Utah,2020/12/15,37.75446323,1915,13,237787,1078,No,Yes,7568
Utah,2020/12/16,37.75446323,2928,24,240715,1102,No,Yes,7543
Utah,2020/12/17,37.75446323,3203,24,243918,1126,No,Yes,7543
Utah,2020/12/18,37.75446323,2644,14,246562,1140,No,Yes,7543
Utah,2020/12/19,37.75446323,2408,8,248970,1148,No,Yes,7543
Utah,2020/12/20,37.75446323,1994,7,250964,1155,No,Yes,7543
Utah,2020/12/21,37.75446323,1819,8,252783,1163,No,Yes,7543
Utah,2020/12/22,37.75446323,2302,12,255085,1175,No,Yes,7543
Utah,2020/12/23,37.75446323,2612,21,257697,1196,No,Yes,5506
Utah,2020/12/24,37.75446323,2892,9,260589,1205,No,Yes,5506
Utah,2020/12/25,37.75446323,0,0,260589,1205,No,Yes,5506
Utah,2020/12/26,37.75446323,3489,7,264078,1212,No,Yes,5506
Utah,2020/12/27,37.75446323,796,2,264874,1214,No,Yes,5506
Utah,2020/12/28,37.75446323,1716,9,266590,1223,No,Yes,5506
Utah,2020/12/29,37.75446323,2736,15,269326,1238,No,Yes,5506
Utah,2020/12/30,37.75446323,2614,21,271940,1259,No,Yes,10986
Utah,2020/12/31,37.75446323,4672,11,276612,1270,No,Yes,10986
Utah,2021/1/1,37.75446323,0,3,276612,1273,No,No,10986
Utah,2021/1/2,37.75446323,5135,21,281747,1294,No,No,10986
Utah,2021/1/3,37.75446323,1726,7,283473,1301,No,No,10986
Utah,2021/1/4,37.75446323,2160,6,285633,1307,No,No,10986
Utah,2021/1/5,37.75446323,3318,7,288951,1314,No,No,10986
Utah,2021/1/6,37.75446323,3769,19,292720,1333,No,No,14084
Utah,2021/1/7,37.75446323,4597,29,297317,1362,No,No,14084
Utah,2021/1/8,37.75446323,3793,21,301110,1383,No,No,14084
Utah,2021/1/9,37.75446323,2613,9,303723,1392,No,No,14084
Utah,2021/1/10,37.75446323,2276,1,305999,1393,No,No,14084
Utah,2021/1/11,37.75446323,1503,7,307502,1400,No,No,14084
Utah,2021/1/12,37.75446323,2127,22,309629,1422,No,No,14084
Utah,2021/1/13,37.75446323,5188,27,314817,1449,No,No,11980
Utah,2021/1/14,37.75446323,2742,12,317559,1461,No,No,11980
Utah,2021/1/15,37.75446323,2616,14,320175,1475,No,No,11980
Utah,2021/1/16,37.75446323,2077,11,322252,1486,No,No,11980
Utah,2021/1/17,37.75446323,1585,7,323837,1493,No,No,11980
Utah,2021/1/18,37.75446323,1082,7,324919,1500,No,No,11980
Utah,2021/1/19,37.75446323,1302,7,326221,1507,No,No,11980
Utah,2021/1/20,37.75446323,2159,11,328380,1518,No,No,11615
Utah,2021/1/21,37.75446323,2089,30,330469,1548,No,No,11615
Utah,2021/1/22,37.75446323,2649,23,333118,1571,No,No,11615
Utah,2021/1/23,37.75446323,1771,11,334889,1582,No,No,11615
Utah,2021/1/24,37.75446323,1516,13,336405,1595,No,No,11615
Utah,2021/1/25,37.75446323,864,4,337269,1599,No,No,11615
Utah,2021/1/26,37.75446323,1406,15,338675,1614,No,No,11615
Utah,2021/1/27,37.75446323,2009,6,340684,1620,No,No,12664
Utah,2021/1/28,37.75446323,1761,0,342445,1620,No,No,12664
Utah,2021/1/29,37.75446323,1517,36,343962,1656,No,No,12664
Utah,2021/1/30,37.75446323,1468,8,345430,1664,No,No,12664
Utah,2021/1/31,37.75446323,1194,1,346624,1665,No,No,12664
Utah,2021/2/1,37.75446323,586,4,347210,1669,No,No,12664
Utah,2021/2/2,37.75446323,1199,18,348409,1687,No,No,12664
Utah,2021/2/3,37.75446323,1591,12,350000,1699,No,No,13464
Utah,2021/2/4,37.75446323,1273,12,351273,1711,No,No,13464
Utah,2021/2/5,37.75446323,1216,18,352489,1729,No,No,13464
Utah,2021/2/6,37.75446323,1211,4,353700,1733,No,No,13464
Utah,2021/2/7,37.75446323,908,3,354608,1736,No,No,13464
Utah,2021/2/8,37.75446323,514,3,355122,1739,No,No,13464
Utah,2021/2/9,37.75446323,918,9,356040,1748,No,No,13464
Utah,2021/2/10,37.75446323,1299,18,357339,1766,No,No,12087
Utah,2021/2/11,37.75446323,1242,10,358581,1776,No,No,12087
Utah,2021/2/12,37.75446323,1060,10,359641,1786,No,No,12087
Utah,2021/2/13,37.75446323,943,5,360584,1791,No,No,12087
Utah,2021/2/14,37.75446323,710,3,361294,1794,No,No,12087
Utah,2021/2/15,37.75446323,462,2,361756,1796,No,No,12087
Utah,2021/2/16,37.75446323,591,1,362347,1797,No,No,12087
Utah,2021/2/17,37.75446323,901,9,363248,1806,No,No,11395
Utah,2021/2/18,37.75446323,1151,7,364399,1813,No,No,11395
Utah,2021/2/19,37.75446323,874,21,365273,1834,No,No,11395
Utah,2021/2/20,37.75446323,761,8,366034,1842,No,No,11395
Utah,2021/2/21,37.75446323,701,10,366735,1852,No,No,11395
Utah,2021/2/22,37.75446323,338,1,367073,1853,No,No,11395
Utah,2021/2/23,37.75446323,716,12,367789,1865,No,No,11395
Utah,2021/2/24,37.75446323,812,14,368601,1879,No,No,11395
Utah,2021/2/25,37.75446323,832,11,369433,1890,No,No,11395
Utah,2021/2/26,37.75446323,651,17,370084,1907,No,No,11395
Utah,2021/2/27,37.75446323,686,22,370770,1929,No,No,11395
Utah,2021/2/28,37.75446323,465,6,371235,1935,No,No,11395
Utah,2021/3/1,37.75446323,257,5,371492,1940,No,No,11395
Utah,2021/3/2,37.75446323,487,9,371979,1949,No,No,11395
Utah,2021/3/3,37.75446323,729,6,372708,1955,No,No,11395
Utah,2021/3/4,37.75446323,611,10,373319,1965,No,No,11395
Vermont,2020/3/1,64.93797482,0,0,0,0,No,No,1575
Vermont,2020/3/2,64.93797482,0,0,0,0,No,No,1575
Vermont,2020/3/3,64.93797482,0,0,0,0,No,No,1575
Vermont,2020/3/4,64.93797482,0,0,0,0,No,No,1663
Vermont,2020/3/5,64.93797482,0,0,0,0,No,No,1663
Vermont,2020/3/6,64.93797482,0,0,0,0,No,No,1663
Vermont,2020/3/7,64.93797482,1,0,1,0,No,No,1663
Vermont,2020/3/8,64.93797482,0,0,1,0,No,No,1663
Vermont,2020/3/9,64.93797482,0,0,1,0,No,No,1663
Vermont,2020/3/10,64.93797482,0,0,1,0,No,No,1663
Vermont,2020/3/11,64.93797482,1,0,2,0,No,No,1819
Vermont,2020/3/12,64.93797482,0,0,2,0,No,No,1819
Vermont,2020/3/13,64.93797482,0,0,2,0,No,No,1819
Vermont,2020/3/14,64.93797482,3,0,5,0,No,No,1819
Vermont,2020/3/15,64.93797482,3,0,8,0,No,No,1819
Vermont,2020/3/16,64.93797482,4,0,12,0,No,No,1819
Vermont,2020/3/17,64.93797482,2,0,14,0,No,No,1819
Vermont,2020/3/18,64.93797482,5,0,19,0,No,No,10892
Vermont,2020/3/19,64.93797482,3,2,22,2,No,No,10892
Vermont,2020/3/20,64.93797482,7,0,29,2,No,No,10892
Vermont,2020/3/21,64.93797482,20,0,49,2,No,No,10892
Vermont,2020/3/22,64.93797482,3,0,52,2,No,No,10892
Vermont,2020/3/23,64.93797482,23,0,75,2,No,No,10892
Vermont,2020/3/24,64.93797482,20,5,95,7,Yes,No,10892
Vermont,2020/3/25,64.93797482,28,1,123,8,Yes,No,80984
Vermont,2020/3/26,64.93797482,35,1,158,9,Yes,No,80984
Vermont,2020/3/27,64.93797482,26,1,184,10,Yes,No,80984
Vermont,2020/3/28,64.93797482,27,2,211,12,Yes,No,80984
Vermont,2020/3/29,64.93797482,24,0,235,12,Yes,No,80984
Vermont,2020/3/30,64.93797482,21,0,256,12,Yes,No,80984
Vermont,2020/3/31,64.93797482,37,1,293,13,Yes,No,80984
Vermont,2020/4/1,64.93797482,28,3,321,16,Yes,No,106739
Vermont,2020/4/2,64.93797482,17,1,338,17,Yes,No,106739
Vermont,2020/4/3,64.93797482,51,0,389,17,Yes,No,106739
Vermont,2020/4/4,64.93797482,72,3,461,20,Yes,No,106739
Vermont,2020/4/5,64.93797482,51,2,512,22,Yes,No,106739
Vermont,2020/4/6,64.93797482,31,1,543,23,Yes,No,106739
Vermont,2020/4/7,64.93797482,32,0,575,23,Yes,No,106739
Vermont,2020/4/8,64.93797482,30,0,605,23,Yes,No,77515
Vermont,2020/4/9,64.93797482,23,0,628,23,Yes,No,77515
Vermont,2020/4/10,64.93797482,51,1,679,24,Yes,No,77515
Vermont,2020/4/11,64.93797482,32,0,711,24,Yes,No,77515
Vermont,2020/4/12,64.93797482,16,2,727,26,Yes,No,77515
Vermont,2020/4/13,64.93797482,21,1,748,27,Yes,No,77515
Vermont,2020/4/14,64.93797482,4,1,752,28,Yes,No,77515
Vermont,2020/4/15,64.93797482,7,1,759,29,Yes,No,66432
Vermont,2020/4/16,64.93797482,9,5,768,34,Yes,No,66432
Vermont,2020/4/17,64.93797482,11,0,779,34,Yes,No,66432
Vermont,2020/4/18,64.93797482,24,2,803,36,Yes,No,66432
Vermont,2020/4/19,64.93797482,9,0,812,36,Yes,No,66432
Vermont,2020/4/20,64.93797482,4,1,816,37,Yes,No,66432
Vermont,2020/4/21,64.93797482,2,2,818,39,Yes,No,66432
Vermont,2020/4/22,64.93797482,5,0,823,39,Yes,No,74966
Vermont,2020/4/23,64.93797482,2,3,825,42,Yes,No,74966
Vermont,2020/4/24,64.93797482,2,1,827,43,Yes,No,74966
Vermont,2020/4/25,64.93797482,16,2,843,45,Yes,No,74966
Vermont,2020/4/26,64.93797482,8,0,851,45,Yes,No,74966
Vermont,2020/4/27,64.93797482,4,1,855,46,Yes,No,74966
Vermont,2020/4/28,64.93797482,7,0,862,46,Yes,No,74966
Vermont,2020/4/29,64.93797482,0,0,862,46,Yes,No,28985
Vermont,2020/4/30,64.93797482,4,2,866,48,Yes,No,28985
Vermont,2020/5/1,64.93797482,13,1,879,49,Yes,No,28985
Vermont,2020/5/2,64.93797482,7,1,886,50,Yes,No,28985
Vermont,2020/5/3,64.93797482,11,2,897,52,Yes,No,28985
Vermont,2020/5/4,64.93797482,5,0,902,52,Yes,No,28985
Vermont,2020/5/5,64.93797482,5,0,907,52,Yes,No,28985
Vermont,2020/5/6,64.93797482,1,0,908,52,Yes,No,26666
Vermont,2020/5/7,64.93797482,8,1,916,53,Yes,No,26666
Vermont,2020/5/8,64.93797482,3,0,919,53,Yes,No,26666
Vermont,2020/5/9,64.93797482,2,0,921,53,Yes,No,26666
Vermont,2020/5/10,64.93797482,5,0,926,53,Yes,No,26666
Vermont,2020/5/11,64.93797482,0,0,926,53,Yes,No,26666
Vermont,2020/5/12,64.93797482,1,0,927,53,Yes,No,26666
Vermont,2020/5/13,64.93797482,2,0,929,53,Yes,No,25150
Vermont,2020/5/14,64.93797482,3,0,932,53,Yes,No,25150
Vermont,2020/5/15,64.93797482,1,0,933,53,Yes,No,25150
Vermont,2020/5/16,64.93797482,1,0,934,53,No,No,25150
Vermont,2020/5/17,64.93797482,6,1,940,54,No,No,25150
Vermont,2020/5/18,64.93797482,0,0,940,54,No,No,25150
Vermont,2020/5/19,64.93797482,4,0,944,54,No,No,25150
Vermont,2020/5/20,64.93797482,0,0,944,54,No,No,27919
Vermont,2020/5/21,64.93797482,6,0,950,54,No,No,27919
Vermont,2020/5/22,64.93797482,2,0,952,54,No,No,27919
Vermont,2020/5/23,64.93797482,2,0,954,54,No,No,27919
Vermont,2020/5/24,64.93797482,2,0,956,54,No,No,27919
Vermont,2020/5/25,64.93797482,6,0,962,54,No,No,27919
Vermont,2020/5/26,64.93797482,5,0,967,54,No,No,27919
Vermont,2020/5/27,64.93797482,4,0,971,54,No,No,21335
Vermont,2020/5/28,64.93797482,3,1,974,55,No,No,21335
Vermont,2020/5/29,64.93797482,1,0,975,55,No,No,21335
Vermont,2020/5/30,64.93797482,2,0,977,55,No,No,21335
Vermont,2020/5/31,64.93797482,4,0,981,55,No,No,21335
Vermont,2020/6/1,64.93797482,2,0,983,55,No,No,21335
Vermont,2020/6/2,64.93797482,5,0,988,55,No,No,21335
Vermont,2020/6/3,64.93797482,2,0,990,55,No,No,19949
Vermont,2020/6/4,64.93797482,36,0,1026,55,No,No,19949
Vermont,2020/6/5,64.93797482,1,0,1027,55,No,No,19949
Vermont,2020/6/6,64.93797482,19,0,1046,55,No,No,19949
Vermont,2020/6/7,64.93797482,17,0,1063,55,No,No,19949
Vermont,2020/6/8,64.93797482,12,0,1075,55,No,No,19949
Vermont,2020/6/9,64.93797482,9,0,1084,55,No,No,19949
Vermont,2020/6/10,64.93797482,11,0,1095,55,No,No,18367
Vermont,2020/6/11,64.93797482,15,0,1110,55,No,No,18367
Vermont,2020/6/12,64.93797482,9,0,1119,55,No,No,18367
Vermont,2020/6/13,64.93797482,6,0,1125,55,No,No,18367
Vermont,2020/6/14,64.93797482,2,0,1127,55,No,No,18367
Vermont,2020/6/15,64.93797482,3,0,1130,55,No,No,18367
Vermont,2020/6/16,64.93797482,0,0,1130,55,No,No,18367
Vermont,2020/6/17,64.93797482,0,0,1130,55,No,No,18671
Vermont,2020/6/18,64.93797482,5,1,1135,56,No,No,18671
Vermont,2020/6/19,64.93797482,9,0,1144,56,No,No,18671
Vermont,2020/6/20,64.93797482,3,0,1147,56,No,No,18671
Vermont,2020/6/21,64.93797482,12,0,1159,56,No,No,18671
Vermont,2020/6/22,64.93797482,4,0,1163,56,No,No,18671
Vermont,2020/6/23,64.93797482,1,0,1164,56,No,No,18671
Vermont,2020/6/24,64.93797482,20,0,1184,56,No,No,18338
Vermont,2020/6/25,64.93797482,7,0,1191,56,No,No,18338
Vermont,2020/6/26,64.93797482,7,0,1198,56,No,No,18338
Vermont,2020/6/27,64.93797482,2,0,1200,56,No,No,18338
Vermont,2020/6/28,64.93797482,2,0,1202,56,No,No,18338
Vermont,2020/6/29,64.93797482,6,0,1208,56,No,No,18338
Vermont,2020/6/30,64.93797482,0,0,1208,56,No,No,18338
Vermont,2020/7/1,64.93797482,2,0,1210,56,No,No,19056
Vermont,2020/7/2,64.93797482,17,0,1227,56,No,No,19056
Vermont,2020/7/3,64.93797482,9,0,1236,56,No,No,19056
Vermont,2020/7/4,64.93797482,2,0,1238,56,No,No,19056
Vermont,2020/7/5,64.93797482,11,0,1249,56,No,No,19056
Vermont,2020/7/6,64.93797482,2,0,1251,56,No,No,19056
Vermont,2020/7/7,64.93797482,3,0,1254,56,No,No,19056
Vermont,2020/7/8,64.93797482,2,0,1256,56,No,No,20563
Vermont,2020/7/9,64.93797482,16,0,1272,56,No,No,20563
Vermont,2020/7/10,64.93797482,5,0,1277,56,No,No,20563
Vermont,2020/7/11,64.93797482,6,0,1283,56,No,No,20563
Vermont,2020/7/12,64.93797482,13,0,1296,56,No,No,20563
Vermont,2020/7/13,64.93797482,5,0,1301,56,No,No,20563
Vermont,2020/7/14,64.93797482,4,0,1305,56,No,No,20563
Vermont,2020/7/15,64.93797482,13,0,1318,56,No,No,23676
Vermont,2020/7/16,64.93797482,7,0,1325,56,No,No,23676
Vermont,2020/7/17,64.93797482,9,0,1334,56,No,No,23676
Vermont,2020/7/18,64.93797482,4,0,1338,56,No,No,23676
Vermont,2020/7/19,64.93797482,12,0,1350,56,No,No,23676
Vermont,2020/7/20,64.93797482,10,0,1360,56,No,No,23676
Vermont,2020/7/21,64.93797482,6,0,1366,56,No,No,23676
Vermont,2020/7/22,64.93797482,0,0,1366,56,No,No,17437
Vermont,2020/7/23,64.93797482,11,0,1377,56,No,No,17437
Vermont,2020/7/24,64.93797482,8,0,1385,56,No,No,17437
Vermont,2020/7/25,64.93797482,11,0,1396,56,No,No,17437
Vermont,2020/7/26,64.93797482,4,0,1400,56,No,No,17437
Vermont,2020/7/27,64.93797482,2,0,1402,56,No,No,17437
Vermont,2020/7/28,64.93797482,3,0,1405,56,No,No,17437
Vermont,2020/7/29,64.93797482,1,0,1406,56,No,No,11690
Vermont,2020/7/30,64.93797482,1,1,1407,57,No,No,11690
Vermont,2020/7/31,64.93797482,7,0,1414,57,No,No,11690
Vermont,2020/8/1,64.93797482,7,0,1421,57,No,Yes,11690
Vermont,2020/8/2,64.93797482,5,0,1426,57,No,Yes,11690
Vermont,2020/8/3,64.93797482,1,0,1427,57,No,Yes,11690
Vermont,2020/8/4,64.93797482,4,0,1431,57,No,Yes,11690
Vermont,2020/8/5,64.93797482,5,0,1436,57,No,Yes,9467
Vermont,2020/8/6,64.93797482,9,1,1445,58,No,Yes,9467
Vermont,2020/8/7,64.93797482,3,0,1448,58,No,Yes,9467
Vermont,2020/8/8,64.93797482,6,0,1454,58,No,Yes,9467
Vermont,2020/8/9,64.93797482,5,0,1459,58,No,Yes,9467
Vermont,2020/8/10,64.93797482,3,0,1462,58,No,Yes,9467
Vermont,2020/8/11,64.93797482,10,0,1472,58,No,Yes,9467
Vermont,2020/8/12,64.93797482,6,0,1478,58,No,Yes,11047
Vermont,2020/8/13,64.93797482,6,0,1484,58,No,Yes,11047
Vermont,2020/8/14,64.93797482,17,0,1501,58,No,Yes,11047
Vermont,2020/8/15,64.93797482,8,0,1509,58,No,Yes,11047
Vermont,2020/8/16,64.93797482,6,0,1515,58,No,No,11047
Vermont,2020/8/17,64.93797482,12,0,1527,58,No,No,11047
Vermont,2020/8/18,64.93797482,3,0,1530,58,No,No,11047
Vermont,2020/8/19,64.93797482,3,0,1533,58,No,No,8676
Vermont,2020/8/20,64.93797482,4,0,1537,58,No,No,8676
Vermont,2020/8/21,64.93797482,4,0,1541,58,No,No,8676
Vermont,2020/8/22,64.93797482,12,0,1553,58,No,No,8676
Vermont,2020/8/23,64.93797482,4,0,1557,58,No,No,8676
Vermont,2020/8/24,64.93797482,9,0,1566,58,No,No,8676
Vermont,2020/8/25,64.93797482,6,0,1572,58,No,No,8676
Vermont,2020/8/26,64.93797482,5,0,1577,58,No,No,8511
Vermont,2020/8/27,64.93797482,9,0,1586,58,No,No,8511
Vermont,2020/8/28,64.93797482,3,0,1589,58,No,No,8511
Vermont,2020/8/29,64.93797482,16,0,1605,58,No,No,8511
Vermont,2020/8/30,64.93797482,11,0,1616,58,No,No,8511
Vermont,2020/8/31,64.93797482,8,0,1624,58,No,No,8511
Vermont,2020/9/1,64.93797482,11,0,1635,58,No,No,8511
Vermont,2020/9/2,64.93797482,2,0,1637,58,No,No,8901
Vermont,2020/9/3,64.93797482,0,0,1637,58,No,No,8901
Vermont,2020/9/4,64.93797482,5,0,1642,58,No,No,8901
Vermont,2020/9/5,64.93797482,5,0,1647,58,No,No,8901
Vermont,2020/9/6,64.93797482,1,0,1648,58,No,No,8901
Vermont,2020/9/7,64.93797482,3,0,1651,58,No,No,8901
Vermont,2020/9/8,64.93797482,3,0,1654,58,No,No,8901
Vermont,2020/9/9,64.93797482,2,0,1656,58,No,No,8848
Vermont,2020/9/10,64.93797482,5,0,1661,58,No,No,8848
Vermont,2020/9/11,64.93797482,7,0,1668,58,No,No,8848
Vermont,2020/9/12,64.93797482,9,0,1677,58,No,No,8848
Vermont,2020/9/13,64.93797482,7,0,1684,58,No,No,8848
Vermont,2020/9/14,64.93797482,12,0,1696,58,No,No,8848
Vermont,2020/9/15,64.93797482,6,0,1702,58,No,No,8848
Vermont,2020/9/16,64.93797482,0,0,1702,58,No,No,8679
Vermont,2020/9/17,64.93797482,3,0,1705,58,No,No,8679
Vermont,2020/9/18,64.93797482,1,0,1706,58,No,No,8679
Vermont,2020/9/19,64.93797482,4,0,1710,58,No,No,8679
Vermont,2020/9/20,64.93797482,5,0,1715,58,No,No,8679
Vermont,2020/9/21,64.93797482,4,0,1719,58,No,No,8679
Vermont,2020/9/22,64.93797482,2,0,1721,58,No,No,8679
Vermont,2020/9/23,64.93797482,1,0,1722,58,No,No,8805
Vermont,2020/9/24,64.93797482,2,0,1724,58,No,No,8805
Vermont,2020/9/25,64.93797482,7,0,1731,58,No,No,8805
Vermont,2020/9/26,64.93797482,8,0,1739,58,No,No,8805
Vermont,2020/9/27,64.93797482,3,0,1742,58,No,No,8805
Vermont,2020/9/28,64.93797482,3,0,1745,58,No,No,8805
Vermont,2020/9/29,64.93797482,4,0,1749,58,No,No,8805
Vermont,2020/9/30,64.93797482,3,0,1752,58,No,No,7732
Vermont,2020/10/1,64.93797482,3,0,1755,58,No,No,7732
Vermont,2020/10/2,64.93797482,13,0,1768,58,No,No,7732
Vermont,2020/10/3,64.93797482,10,0,1778,58,No,No,7732
Vermont,2020/10/4,64.93797482,7,0,1785,58,No,No,7732
Vermont,2020/10/5,64.93797482,32,0,1817,58,No,No,7732
Vermont,2020/10/6,64.93797482,4,0,1821,58,No,No,7732
Vermont,2020/10/7,64.93797482,6,0,1827,58,No,No,8581
Vermont,2020/10/8,64.93797482,11,0,1838,58,No,No,8581
Vermont,2020/10/9,64.93797482,8,0,1846,58,No,No,8581
Vermont,2020/10/10,64.93797482,11,0,1857,58,No,No,8581
Vermont,2020/10/11,64.93797482,11,0,1868,58,No,No,8581
Vermont,2020/10/12,64.93797482,8,0,1876,58,No,No,8581
Vermont,2020/10/13,64.93797482,10,0,1886,58,No,No,8581
Vermont,2020/10/14,64.93797482,3,0,1889,58,No,No,7964
Vermont,2020/10/15,64.93797482,14,0,1903,58,No,No,7964
Vermont,2020/10/16,64.93797482,12,0,1915,58,No,No,7964
Vermont,2020/10/17,64.93797482,11,0,1926,58,No,No,7964
Vermont,2020/10/18,64.93797482,11,0,1937,58,No,No,7964
Vermont,2020/10/19,64.93797482,9,0,1946,58,No,No,7964
Vermont,2020/10/20,64.93797482,10,0,1956,58,No,No,7964
Vermont,2020/10/21,64.93797482,15,0,1971,58,No,No,7126
Vermont,2020/10/22,64.93797482,16,0,1987,58,No,No,7126
Vermont,2020/10/23,64.93797482,29,0,2016,58,No,No,7126
Vermont,2020/10/24,64.93797482,27,0,2043,58,No,No,7126
Vermont,2020/10/25,64.93797482,30,0,2073,58,No,No,7126
Vermont,2020/10/26,64.93797482,10,0,2083,58,No,No,7126
Vermont,2020/10/27,64.93797482,30,0,2113,58,No,No,7126
Vermont,2020/10/28,64.93797482,7,0,2120,58,No,No,7060
Vermont,2020/10/29,64.93797482,21,0,2141,58,No,No,7060
Vermont,2020/10/30,64.93797482,14,0,2155,58,No,No,7060
Vermont,2020/10/31,64.93797482,24,0,2179,58,No,No,7060
Vermont,2020/11/1,64.93797482,17,0,2196,58,No,No,7060
Vermont,2020/11/2,64.93797482,23,0,2219,58,No,No,7060
Vermont,2020/11/3,64.93797482,18,0,2237,58,No,No,7060
Vermont,2020/11/4,64.93797482,30,0,2267,58,No,No,8764
Vermont,2020/11/5,64.93797482,36,0,2303,58,No,No,8764
Vermont,2020/11/6,64.93797482,23,0,2326,58,No,No,8764
Vermont,2020/11/7,64.93797482,21,1,2347,59,No,No,8764
Vermont,2020/11/8,64.93797482,45,0,2392,59,No,No,8764
Vermont,2020/11/9,64.93797482,23,0,2415,59,No,No,8764
Vermont,2020/11/10,64.93797482,47,0,2462,59,No,No,8764
Vermont,2020/11/11,64.93797482,73,0,2535,59,No,No,9262
Vermont,2020/11/12,64.93797482,116,0,2651,59,No,No,9262
Vermont,2020/11/13,64.93797482,92,0,2743,59,No,No,9262
Vermont,2020/11/14,64.93797482,100,0,2843,59,No,No,9262
Vermont,2020/11/15,64.93797482,46,0,2889,59,No,No,9262
Vermont,2020/11/16,64.93797482,119,0,3008,59,No,No,9262
Vermont,2020/11/17,64.93797482,96,0,3104,59,No,No,9262
Vermont,2020/11/18,64.93797482,57,1,3161,60,No,No,11813
Vermont,2020/11/19,64.93797482,149,1,3310,61,No,No,11813
Vermont,2020/11/20,64.93797482,149,1,3459,62,No,No,11813
Vermont,2020/11/21,64.93797482,87,1,3546,63,No,No,11813
Vermont,2020/11/22,64.93797482,83,0,3629,63,No,No,11813
Vermont,2020/11/23,64.93797482,85,0,3714,63,No,No,11813
Vermont,2020/11/24,64.93797482,48,1,3762,64,No,No,11813
Vermont,2020/11/25,64.93797482,65,0,3827,64,No,No,7061
Vermont,2020/11/26,64.93797482,0,0,3827,64,No,No,7061
Vermont,2020/11/27,64.93797482,178,3,4005,67,No,No,7061
Vermont,2020/11/28,64.93797482,28,0,4033,67,No,No,7061
Vermont,2020/11/29,64.93797482,67,0,4100,67,No,No,7061
Vermont,2020/11/30,64.93797482,72,2,4172,69,No,No,7061
Vermont,2020/12/1,64.93797482,67,3,4239,72,No,No,7061
Vermont,2020/12/2,64.93797482,222,2,4461,74,No,No,7656
Vermont,2020/12/3,64.93797482,181,1,4642,75,No,No,7656
Vermont,2020/12/4,64.93797482,121,2,4763,77,No,No,7656
Vermont,2020/12/5,64.93797482,131,2,4894,79,No,No,7656
Vermont,2020/12/6,64.93797482,121,0,5015,79,No,No,7656
Vermont,2020/12/7,64.93797482,65,2,5080,81,No,No,7656
Vermont,2020/12/8,64.93797482,100,4,5180,85,No,No,7656
Vermont,2020/12/9,64.93797482,105,1,5285,86,No,No,7568
Vermont,2020/12/10,64.93797482,128,3,5413,89,No,No,7568
Vermont,2020/12/11,64.93797482,128,4,5541,93,No,No,7568
Vermont,2020/12/12,64.93797482,85,2,5626,95,No,No,7568
Vermont,2020/12/13,64.93797482,127,0,5753,95,No,No,7568
Vermont,2020/12/14,64.93797482,104,1,5857,96,No,No,7568
Vermont,2020/12/15,64.93797482,66,4,5923,100,No,No,7568
Vermont,2020/12/16,64.93797482,86,5,6009,105,No,No,7543
Vermont,2020/12/17,64.93797482,140,0,6149,105,No,No,7543
Vermont,2020/12/18,64.93797482,94,2,6243,107,No,No,7543
Vermont,2020/12/19,64.93797482,100,1,6343,108,No,No,7543
Vermont,2020/12/20,64.93797482,100,3,6443,111,No,No,7543
Vermont,2020/12/21,64.93797482,91,0,6534,111,No,No,7543
Vermont,2020/12/22,64.93797482,74,1,6608,112,No,No,7543
Vermont,2020/12/23,64.93797482,72,5,6680,117,No,No,5506
Vermont,2020/12/24,64.93797482,101,3,6781,120,No,No,5506
Vermont,2020/12/25,64.93797482,0,0,6781,120,No,No,5506
Vermont,2020/12/26,64.93797482,185,1,6966,121,No,No,5506
Vermont,2020/12/27,64.93797482,63,6,7029,127,No,No,5506
Vermont,2020/12/28,64.93797482,91,2,7120,129,No,No,5506
Vermont,2020/12/29,64.93797482,82,1,7202,130,No,No,5506
Vermont,2020/12/30,64.93797482,74,4,7276,134,No,No,10986
Vermont,2020/12/31,64.93797482,136,2,7412,136,No,No,10986
Vermont,2021/1/1,64.93797482,0,0,7412,136,No,No,10986
Vermont,2021/1/2,64.93797482,277,3,7689,139,No,No,10986
Vermont,2021/1/3,64.93797482,104,1,7793,140,No,No,10986
Vermont,2021/1/4,64.93797482,80,4,7873,144,No,No,10986
Vermont,2021/1/5,64.93797482,165,5,8038,149,No,No,10986
Vermont,2021/1/6,64.93797482,120,3,8158,152,No,No,14084
Vermont,2021/1/7,64.93797482,245,3,8403,155,No,No,14084
Vermont,2021/1/8,64.93797482,216,1,8619,156,No,No,14084
Vermont,2021/1/9,64.93797482,171,0,8790,156,No,No,14084
Vermont,2021/1/10,64.93797482,177,0,8967,156,No,No,14084
Vermont,2021/1/11,64.93797482,111,0,9078,156,No,No,14084
Vermont,2021/1/12,64.93797482,169,2,9247,158,No,No,14084
Vermont,2021/1/13,64.93797482,121,0,9368,158,No,No,11980
Vermont,2021/1/14,64.93797482,205,4,9573,162,No,No,11980
Vermont,2021/1/15,64.93797482,161,1,9734,163,No,No,11980
Vermont,2021/1/16,64.93797482,181,0,9915,163,No,No,11980
Vermont,2021/1/17,64.93797482,142,0,10057,163,No,No,11980
Vermont,2021/1/18,64.93797482,163,0,10220,163,No,No,11980
Vermont,2021/1/19,64.93797482,101,0,10321,163,No,No,11980
Vermont,2021/1/20,64.93797482,150,2,10471,165,No,No,11615
Vermont,2021/1/21,64.93797482,109,3,10580,168,No,No,11615
Vermont,2021/1/22,64.93797482,179,1,10759,169,No,No,11615
Vermont,2021/1/23,64.93797482,149,1,10908,170,No,No,11615
Vermont,2021/1/24,64.93797482,125,0,11033,170,No,No,11615
Vermont,2021/1/25,64.93797482,132,1,11165,171,No,No,11615
Vermont,2021/1/26,64.93797482,120,0,11285,171,No,No,11615
Vermont,2021/1/27,64.93797482,94,1,11379,172,No,No,12664
Vermont,2021/1/28,64.93797482,144,0,11523,172,No,No,12664
Vermont,2021/1/29,64.93797482,135,0,11658,172,No,No,12664
Vermont,2021/1/30,64.93797482,173,1,11831,173,No,No,12664
Vermont,2021/1/31,64.93797482,134,1,11965,174,No,No,12664
Vermont,2021/2/1,64.93797482,118,1,12083,175,No,No,12664
Vermont,2021/2/2,64.93797482,113,1,12196,176,No,No,12664
Vermont,2021/2/3,64.93797482,133,3,12329,179,No,No,13464
Vermont,2021/2/4,64.93797482,174,2,12503,181,No,No,13464
Vermont,2021/2/5,64.93797482,109,0,12612,181,No,No,13464
Vermont,2021/2/6,64.93797482,154,1,12766,182,No,No,13464
Vermont,2021/2/7,64.93797482,134,1,12900,183,No,No,13464
Vermont,2021/2/8,64.93797482,146,0,13046,183,No,No,13464
Vermont,2021/2/9,64.93797482,59,3,13105,186,No,No,13464
Vermont,2021/2/10,64.93797482,17,1,13122,187,No,No,12087
Vermont,2021/2/11,64.93797482,127,1,13249,188,No,No,12087
Vermont,2021/2/12,64.93797482,166,1,13415,189,No,No,12087
Vermont,2021/2/13,64.93797482,146,0,13561,189,No,No,12087
Vermont,2021/2/14,64.93797482,116,0,13677,189,No,No,12087
Vermont,2021/2/15,64.93797482,185,1,13862,190,No,No,12087
Vermont,2021/2/16,64.93797482,55,1,13917,191,No,No,12087
Vermont,2021/2/17,64.93797482,79,0,13996,191,No,No,11395
Vermont,2021/2/18,64.93797482,153,2,14149,193,No,No,11395
Vermont,2021/2/19,64.93797482,102,0,14251,193,No,No,11395
Vermont,2021/2/20,64.93797482,108,3,14359,196,No,No,11395
Vermont,2021/2/21,64.93797482,134,1,14493,197,No,No,11395
Vermont,2021/2/22,64.93797482,115,1,14608,198,No,No,11395
Vermont,2021/2/23,64.93797482,83,1,14691,199,No,No,11395
Vermont,2021/2/24,64.93797482,77,2,14768,201,No,No,11395
Vermont,2021/2/25,64.93797482,72,2,14840,203,No,No,11395
Vermont,2021/2/26,64.93797482,123,1,14963,204,No,No,11395
Vermont,2021/2/27,64.93797482,135,0,15098,204,No,No,11395
Vermont,2021/2/28,64.93797482,100,0,15198,204,No,No,11395
Vermont,2021/3/1,64.93797482,86,1,15284,205,No,No,11395
Vermont,2021/3/2,64.93797482,88,1,15372,206,No,No,11395
Vermont,2021/3/3,64.93797482,115,1,15487,207,No,No,11395
Vermont,2021/3/4,64.93797482,199,0,15686,207,No,No,11395
Virginia,2020/3/1,209.1270121,0,0,0,0,No,No,1575
Virginia,2020/3/2,209.1270121,0,0,0,0,No,No,1575
Virginia,2020/3/3,209.1270121,0,0,0,0,No,No,1575
Virginia,2020/3/4,209.1270121,0,0,0,0,No,No,1663
Virginia,2020/3/5,209.1270121,0,0,0,0,No,No,1663
Virginia,2020/3/6,209.1270121,0,0,0,0,No,No,1663
Virginia,2020/3/7,209.1270121,1,0,1,0,No,No,1663
Virginia,2020/3/8,209.1270121,1,0,2,0,No,No,1663
Virginia,2020/3/9,209.1270121,3,0,5,0,No,No,1663
Virginia,2020/3/10,209.1270121,3,0,8,0,No,No,1663
Virginia,2020/3/11,209.1270121,2,0,10,0,No,No,1819
Virginia,2020/3/12,209.1270121,7,0,17,0,No,No,1819
Virginia,2020/3/13,209.1270121,13,0,30,0,No,No,1819
Virginia,2020/3/14,209.1270121,12,1,42,1,No,No,1819
Virginia,2020/3/15,209.1270121,3,0,45,1,No,No,1819
Virginia,2020/3/16,209.1270121,6,0,51,1,No,No,1819
Virginia,2020/3/17,209.1270121,16,1,67,2,No,No,1819
Virginia,2020/3/18,209.1270121,11,0,78,2,No,No,10892
Virginia,2020/3/19,209.1270121,16,0,94,2,No,No,10892
Virginia,2020/3/20,209.1270121,21,0,115,2,No,No,10892
Virginia,2020/3/21,209.1270121,37,1,152,3,No,No,10892
Virginia,2020/3/22,209.1270121,67,3,219,6,No,No,10892
Virginia,2020/3/23,209.1270121,35,0,254,6,No,No,10892
Virginia,2020/3/24,209.1270121,37,1,291,7,No,No,10892
Virginia,2020/3/25,209.1270121,99,2,390,9,No,No,80984
Virginia,2020/3/26,209.1270121,213,5,603,14,No,No,80984
Virginia,2020/3/27,209.1270121,2,0,605,14,No,No,80984
Virginia,2020/3/28,209.1270121,134,3,739,17,No,No,80984
Virginia,2020/3/29,209.1270121,150,5,889,22,No,No,80984
Virginia,2020/3/30,209.1270121,131,4,1020,26,Yes,No,80984
Virginia,2020/3/31,209.1270121,229,1,1249,27,Yes,No,80984
Virginia,2020/4/1,209.1270121,262,-9,1511,18,Yes,No,106739
Virginia,2020/4/2,209.1270121,195,0,1706,18,Yes,No,106739
Virginia,2020/4/3,209.1270121,305,28,2011,46,Yes,No,106739
Virginia,2020/4/4,209.1270121,397,6,2408,52,Yes,No,106739
Virginia,2020/4/5,209.1270121,228,0,2636,52,Yes,No,106739
Virginia,2020/4/6,209.1270121,241,2,2877,54,Yes,No,106739
Virginia,2020/4/7,209.1270121,455,15,3332,69,Yes,No,106739
Virginia,2020/4/8,209.1270121,312,-9,3644,60,Yes,No,77515
Virginia,2020/4/9,209.1270121,397,49,4041,109,Yes,No,77515
Virginia,2020/4/10,209.1270121,468,12,4509,121,Yes,No,77515
Virginia,2020/4/11,209.1270121,567,9,5076,130,Yes,No,77515
Virginia,2020/4/12,209.1270121,197,11,5273,141,Yes,No,77515
Virginia,2020/4/13,209.1270121,473,8,5746,149,Yes,No,77515
Virginia,2020/4/14,209.1270121,427,5,6173,154,Yes,No,77515
Virginia,2020/4/15,209.1270121,329,41,6502,195,Yes,No,66432
Virginia,2020/4/16,209.1270121,389,13,6891,208,Yes,No,66432
Virginia,2020/4/17,209.1270121,601,30,7492,238,Yes,No,66432
Virginia,2020/4/18,209.1270121,561,20,8053,258,Yes,No,66432
Virginia,2020/4/19,209.1270121,483,19,8536,277,Yes,No,66432
Virginia,2020/4/20,209.1270121,453,23,8989,300,Yes,No,66432
Virginia,2020/4/21,209.1270121,640,25,9629,325,Yes,No,66432
Virginia,2020/4/22,209.1270121,636,24,10265,349,Yes,No,74966
Virginia,2020/4/23,209.1270121,734,26,10999,375,Yes,No,74966
Virginia,2020/4/24,209.1270121,596,38,11595,413,Yes,No,74966
Virginia,2020/4/25,209.1270121,770,23,12365,436,Yes,No,74966
Virginia,2020/4/26,209.1270121,604,12,12969,448,Yes,No,74966
Virginia,2020/4/27,209.1270121,565,10,13534,458,Yes,No,74966
Virginia,2020/4/28,209.1270121,804,34,14338,492,Yes,No,74966
Virginia,2020/4/29,209.1270121,623,30,14961,522,Yes,No,28985
Virginia,2020/4/30,209.1270121,885,30,15846,552,Yes,No,28985
Virginia,2020/5/1,209.1270121,1055,29,16901,581,Yes,No,28985
Virginia,2020/5/2,209.1270121,830,35,17731,616,Yes,No,28985
Virginia,2020/5/3,209.1270121,940,44,18671,660,Yes,No,28985
Virginia,2020/5/4,209.1270121,821,24,19492,684,Yes,No,28985
Virginia,2020/5/5,209.1270121,764,29,20256,713,Yes,No,28985
Virginia,2020/5/6,209.1270121,0,0,20256,713,Yes,No,26666
Virginia,2020/5/7,209.1270121,1314,56,21570,769,Yes,No,26666
Virginia,2020/5/8,209.1270121,772,43,22342,812,Yes,No,26666
Virginia,2020/5/9,209.1270121,854,15,23196,827,Yes,No,26666
Virginia,2020/5/10,209.1270121,885,12,24081,839,Yes,No,26666
Virginia,2020/5/11,209.1270121,989,11,25070,850,Yes,No,26666
Virginia,2020/5/12,209.1270121,730,41,25800,891,Yes,No,26666
Virginia,2020/5/13,209.1270121,946,36,26746,927,Yes,No,25150
Virginia,2020/5/14,209.1270121,1067,28,27813,955,Yes,No,25150
Virginia,2020/5/15,209.1270121,859,22,28672,977,Yes,No,25150
Virginia,2020/5/16,209.1270121,1011,25,29683,1002,Yes,No,25150
Virginia,2020/5/17,209.1270121,705,7,30388,1009,Yes,No,25150
Virginia,2020/5/18,209.1270121,752,5,31140,1014,Yes,No,25150
Virginia,2020/5/19,209.1270121,1005,27,32145,1041,Yes,No,25150
Virginia,2020/5/20,209.1270121,763,33,32908,1074,Yes,No,27919
Virginia,2020/5/21,209.1270121,1229,25,34137,1099,Yes,No,27919
Virginia,2020/5/22,209.1270121,813,37,34950,1136,Yes,No,27919
Virginia,2020/5/23,209.1270121,799,23,35749,1159,Yes,No,27919
Virginia,2020/5/24,209.1270121,495,12,36244,1171,Yes,No,27919
Virginia,2020/5/25,209.1270121,1483,37,37727,1208,Yes,No,27919
Virginia,2020/5/26,209.1270121,1615,28,39342,1236,Yes,No,27919
Virginia,2020/5/27,209.1270121,907,45,40249,1281,Yes,No,21335
Virginia,2020/5/28,209.1270121,1152,57,41401,1338,Yes,No,21335
Virginia,2020/5/29,209.1270121,1132,20,42533,1358,Yes,No,21335
Virginia,2020/5/30,209.1270121,1078,12,43611,1370,No,No,21335
Virginia,2020/5/31,209.1270121,996,5,44607,1375,No,No,21335
Virginia,2020/6/1,209.1270121,791,17,45398,1392,No,No,21335
Virginia,2020/6/2,209.1270121,841,15,46239,1407,No,No,21335
Virginia,2020/6/3,209.1270121,666,21,46905,1428,No,No,19949
Virginia,2020/6/4,209.1270121,951,17,47856,1445,No,No,19949
Virginia,2020/6/5,209.1270121,676,8,48532,1453,No,No,19949
Virginia,2020/6/6,209.1270121,865,7,49397,1460,No,No,19949
Virginia,2020/6/7,209.1270121,1284,12,50681,1472,No,No,19949
Virginia,2020/6/8,209.1270121,570,5,51251,1477,No,No,19949
Virginia,2020/6/9,209.1270121,487,19,51738,1496,No,No,19949
Virginia,2020/6/10,209.1270121,439,18,52177,1514,No,No,18367
Virginia,2020/6/11,209.1270121,470,6,52647,1520,No,No,18367
Virginia,2020/6/12,209.1270121,564,14,53211,1534,No,No,18367
Virginia,2020/6/13,209.1270121,658,7,53869,1541,No,No,18367
Virginia,2020/6/14,209.1270121,637,5,54506,1546,No,No,18367
Virginia,2020/6/15,209.1270121,380,6,54886,1552,No,No,18367
Virginia,2020/6/16,209.1270121,445,18,55331,1570,No,No,18367
Virginia,2020/6/17,209.1270121,444,13,55775,1583,No,No,18671
Virginia,2020/6/18,209.1270121,463,3,56238,1586,No,No,18671
Virginia,2020/6/19,209.1270121,555,16,56793,1602,No,No,18671
Virginia,2020/6/20,209.1270121,650,5,57443,1607,No,No,18671
Virginia,2020/6/21,209.1270121,551,4,57994,1611,No,No,18671
Virginia,2020/6/22,209.1270121,471,9,58465,1620,No,No,18671
Virginia,2020/6/23,209.1270121,529,25,58994,1645,No,No,18671
Virginia,2020/6/24,209.1270121,520,16,59514,1661,No,No,18338
Virginia,2020/6/25,209.1270121,432,14,59946,1675,No,No,18338
Virginia,2020/6/26,209.1270121,624,25,60570,1700,No,No,18338
Virginia,2020/6/27,209.1270121,677,24,61247,1724,No,No,18338
Virginia,2020/6/28,209.1270121,489,8,61736,1732,No,No,18338
Virginia,2020/6/29,209.1270121,453,8,62189,1740,No,No,18338
Virginia,2020/6/30,209.1270121,598,23,62787,1763,No,No,18338
Virginia,2020/7/1,209.1270121,416,23,63203,1786,No,No,19056
Virginia,2020/7/2,209.1270121,532,30,63735,1816,No,No,19056
Virginia,2020/7/3,209.1270121,658,29,64393,1845,No,No,19056
Virginia,2020/7/4,209.1270121,716,4,65109,1849,No,No,19056
Virginia,2020/7/5,209.1270121,639,4,65748,1853,No,No,19056
Virginia,2020/7/6,209.1270121,354,0,66102,1853,No,No,19056
Virginia,2020/7/7,209.1270121,638,28,66740,1881,No,No,19056
Virginia,2020/7/8,209.1270121,635,24,67375,1905,No,No,20563
Virginia,2020/7/9,209.1270121,613,32,67988,1937,No,No,20563
Virginia,2020/7/10,209.1270121,943,21,68931,1958,No,No,20563
Virginia,2020/7/11,209.1270121,851,4,69782,1962,No,No,20563
Virginia,2020/7/12,209.1270121,888,4,70670,1966,No,No,20563
Virginia,2020/7/13,209.1270121,972,2,71642,1968,No,No,20563
Virginia,2020/7/14,209.1270121,801,9,72443,1977,No,No,20563
Virginia,2020/7/15,209.1270121,1084,15,73527,1992,No,No,23676
Virginia,2020/7/16,209.1270121,904,15,74431,2007,No,No,23676
Virginia,2020/7/17,209.1270121,1002,6,75433,2013,No,No,23676
Virginia,2020/7/18,209.1270121,940,12,76373,2025,No,No,23676
Virginia,2020/7/19,209.1270121,1057,2,77430,2027,No,No,23676
Virginia,2020/7/20,209.1270121,945,4,78375,2031,No,No,23676
Virginia,2020/7/21,209.1270121,996,17,79371,2048,No,No,23676
Virginia,2020/7/22,209.1270121,1022,3,80393,2051,No,No,17437
Virginia,2020/7/23,209.1270121,844,3,81237,2054,No,No,17437
Virginia,2020/7/24,209.1270121,1127,13,82364,2067,No,No,17437
Virginia,2020/7/25,209.1270121,1245,8,83609,2075,No,No,17437
Virginia,2020/7/26,209.1270121,958,3,84567,2078,No,No,17437
Virginia,2020/7/27,209.1270121,1505,4,86072,2082,No,No,17437
Virginia,2020/7/28,209.1270121,922,13,86994,2095,No,No,17437
Virginia,2020/7/29,209.1270121,999,30,87993,2125,No,No,11690
Virginia,2020/7/30,209.1270121,911,16,88904,2141,No,No,11690
Virginia,2020/7/31,209.1270121,984,33,89888,2174,No,No,11690
Virginia,2020/8/1,209.1270121,913,41,90801,2215,No,No,11690
Virginia,2020/8/2,209.1270121,981,3,91782,2218,No,No,11690
Virginia,2020/8/3,209.1270121,1324,0,93106,2218,No,No,11690
Virginia,2020/8/4,209.1270121,1145,26,94251,2244,No,No,11690
Virginia,2020/8/5,209.1270121,798,30,95049,2274,No,No,9467
Virginia,2020/8/6,209.1270121,818,25,95867,2299,No,No,9467
Virginia,2020/8/7,209.1270121,2015,18,97882,2317,No,No,9467
Virginia,2020/8/8,209.1270121,1307,5,99189,2322,No,No,9467
Virginia,2020/8/9,209.1270121,897,4,100086,2326,No,No,9467
Virginia,2020/8/10,209.1270121,663,1,100749,2327,No,No,9467
Virginia,2020/8/11,209.1270121,996,17,101745,2344,No,No,9467
Virginia,2020/8/12,209.1270121,776,8,102521,2352,No,No,11047
Virginia,2020/8/13,209.1270121,1101,11,103622,2363,No,No,11047
Virginia,2020/8/14,209.1270121,1216,7,104838,2370,No,No,11047
Virginia,2020/8/15,209.1270121,912,11,105750,2381,No,No,11047
Virginia,2020/8/16,209.1270121,937,0,106687,2381,No,No,11047
Virginia,2020/8/17,209.1270121,734,4,107421,2385,No,No,11047
Virginia,2020/8/18,209.1270121,861,11,108282,2396,No,No,11047
Virginia,2020/8/19,209.1270121,737,14,109019,2410,No,No,8676
Virginia,2020/8/20,209.1270121,863,17,109882,2427,No,No,8676
Virginia,2020/8/21,209.1270121,978,9,110860,2436,No,No,8676
Virginia,2020/8/22,209.1270121,1212,7,112072,2443,No,No,8676
Virginia,2020/8/23,209.1270121,894,24,112966,2467,No,No,8676
Virginia,2020/8/24,209.1270121,664,4,113630,2471,No,No,8676
Virginia,2020/8/25,209.1270121,1005,23,114635,2494,No,No,8676
Virginia,2020/8/26,209.1270121,823,21,115458,2515,No,No,8511
Virginia,2020/8/27,209.1270121,1121,12,116579,2527,No,No,8511
Virginia,2020/8/28,209.1270121,1013,23,117592,2550,No,No,8511
Virginia,2020/8/29,209.1270121,1217,18,118809,2568,No,No,8511
Virginia,2020/8/30,209.1270121,938,1,119747,2569,No,No,8511
Virginia,2020/8/31,209.1270121,847,11,120594,2580,No,No,8511
Virginia,2020/9/1,209.1270121,1021,32,121615,2612,No,No,8511
Virginia,2020/9/2,209.1270121,927,29,122542,2641,No,No,8901
Virginia,2020/9/3,209.1270121,1126,11,123668,2652,No,No,8901
Virginia,2020/9/4,209.1270121,1111,10,124779,2662,No,No,8901
Virginia,2020/9/5,209.1270121,948,15,125727,2677,No,No,8901
Virginia,2020/9/6,209.1270121,1199,1,126926,2678,No,No,8901
Virginia,2020/9/7,209.1270121,645,6,127571,2684,No,No,8901
Virginia,2020/9/8,209.1270121,836,2,128407,2686,No,No,8901
Virginia,2020/9/9,209.1270121,882,11,129289,2697,No,No,8848
Virginia,2020/9/10,209.1270121,1236,11,130525,2708,No,No,8848
Virginia,2020/9/11,209.1270121,1115,3,131640,2711,No,No,8848
Virginia,2020/9/12,209.1270121,1300,11,132940,2722,No,No,8848
Virginia,2020/9/13,209.1270121,874,2,133814,2724,No,No,8848
Virginia,2020/9/14,209.1270121,757,19,134571,2743,No,No,8848
Virginia,2020/9/15,209.1270121,943,96,135514,2839,No,No,8848
Virginia,2020/9/16,209.1270121,845,45,136359,2884,No,No,8679
Virginia,2020/9/17,209.1270121,1101,36,137460,2920,No,No,8679
Virginia,2020/9/18,209.1270121,1242,29,138702,2949,No,No,8679
Virginia,2020/9/19,209.1270121,953,41,139655,2990,No,No,8679
Virginia,2020/9/20,209.1270121,856,25,140511,3015,No,No,8679
Virginia,2020/9/21,209.1270121,627,6,141138,3021,No,No,8679
Virginia,2020/9/22,209.1270121,872,39,142010,3060,No,No,8679
Virginia,2020/9/23,209.1270121,580,29,142590,3089,No,No,8805
Virginia,2020/9/24,209.1270121,902,24,143492,3113,No,No,8805
Virginia,2020/9/25,209.1270121,941,23,144433,3136,No,No,8805
Virginia,2020/9/26,209.1270121,975,8,145408,3144,No,No,8805
Virginia,2020/9/27,209.1270121,736,15,146144,3159,No,No,8805
Virginia,2020/9/28,209.1270121,449,13,146593,3172,No,No,8805
Virginia,2020/9/29,209.1270121,923,15,147516,3187,No,No,8805
Virginia,2020/9/30,209.1270121,755,21,148271,3208,No,No,7732
Virginia,2020/10/1,209.1270121,450,20,148721,3228,No,No,7732
Virginia,2020/10/2,209.1270121,966,22,149687,3250,No,No,7732
Virginia,2020/10/3,209.1270121,1116,20,150803,3270,No,No,7732
Virginia,2020/10/4,209.1270121,1067,3,151870,3273,No,No,7732
Virginia,2020/10/5,209.1270121,687,3,152557,3276,No,No,7732
Virginia,2020/10/6,209.1270121,625,15,153182,3291,No,No,7732
Virginia,2020/10/7,209.1270121,509,12,153691,3303,No,No,8581
Virginia,2020/10/8,209.1270121,1844,25,155535,3328,No,No,8581
Virginia,2020/10/9,209.1270121,1114,16,156649,3344,No,No,8581
Virginia,2020/10/10,209.1270121,1256,10,157905,3354,No,No,8581
Virginia,2020/10/11,209.1270121,811,4,158716,3358,No,No,8581
Virginia,2020/10/12,209.1270121,854,3,159570,3361,No,No,8581
Virginia,2020/10/13,209.1270121,1235,11,160805,3372,No,No,8581
Virginia,2020/10/14,209.1270121,805,9,161610,3381,No,No,7964
Virginia,2020/10/15,209.1270121,1331,7,162941,3388,No,No,7964
Virginia,2020/10/16,209.1270121,1183,20,164124,3408,No,No,7964
Virginia,2020/10/17,209.1270121,1114,14,165238,3422,No,No,7964
Virginia,2020/10/18,209.1270121,900,11,166138,3433,No,No,7964
Virginia,2020/10/19,209.1270121,690,24,166828,3457,No,No,7964
Virginia,2020/10/20,209.1270121,926,28,167754,3485,No,No,7964
Virginia,2020/10/21,209.1270121,1018,30,168772,3515,No,No,7126
Virginia,2020/10/22,209.1270121,1332,9,170104,3524,No,No,7126
Virginia,2020/10/23,209.1270121,1180,15,171284,3539,No,No,7126
Virginia,2020/10/24,209.1270121,1088,39,172372,3578,No,No,7126
Virginia,2020/10/25,209.1270121,999,1,173371,3579,No,No,7126
Virginia,2020/10/26,209.1270121,904,2,174275,3581,No,No,7126
Virginia,2020/10/27,209.1270121,1134,19,175409,3600,No,No,7126
Virginia,2020/10/28,209.1270121,1345,16,176754,3616,No,No,7060
Virginia,2020/10/29,209.1270121,1429,20,178183,3636,No,No,7060
Virginia,2020/10/30,209.1270121,1456,7,179639,3643,No,No,7060
Virginia,2020/10/31,209.1270121,1551,11,181190,3654,No,No,7060
Virginia,2020/11/1,209.1270121,1202,1,182392,3655,No,No,7060
Virginia,2020/11/2,209.1270121,1026,3,183418,3658,No,No,7060
Virginia,2020/11/3,209.1270121,1261,8,184679,3666,No,No,7060
Virginia,2020/11/4,209.1270121,1157,11,185836,3677,No,No,8764
Virginia,2020/11/5,209.1270121,1366,11,187202,3688,No,No,8764
Virginia,2020/11/6,209.1270121,1568,-6,188770,3682,No,No,8764
Virginia,2020/11/7,209.1270121,2103,22,190873,3704,No,No,8764
Virginia,2020/11/8,209.1270121,1302,3,192175,3707,No,No,8764
Virginia,2020/11/9,209.1270121,1302,6,193477,3713,No,No,8764
Virginia,2020/11/10,209.1270121,1435,13,194912,3726,No,No,8764
Virginia,2020/11/11,209.1270121,1594,15,196506,3741,No,No,9262
Virginia,2020/11/12,209.1270121,1521,17,198027,3758,No,No,9262
Virginia,2020/11/13,209.1270121,1235,27,199262,3785,No,No,9262
Virginia,2020/11/14,209.1270121,1537,14,200799,3799,No,No,9262
Virginia,2020/11/15,209.1270121,1161,1,201960,3800,No,No,9262
Virginia,2020/11/16,209.1270121,2677,6,204637,3806,No,No,9262
Virginia,2020/11/17,209.1270121,2125,29,206762,3835,No,No,9262
Virginia,2020/11/18,209.1270121,2071,25,208833,3860,No,No,11813
Virginia,2020/11/19,209.1270121,1954,36,210787,3896,No,No,11813
Virginia,2020/11/20,209.1270121,2544,16,213331,3912,No,No,11813
Virginia,2020/11/21,209.1270121,2348,26,215679,3938,No,No,11813
Virginia,2020/11/22,209.1270121,2117,0,217796,3938,No,No,11813
Virginia,2020/11/23,209.1270121,3242,4,221038,3942,No,No,11813
Virginia,2020/11/24,209.1270121,2544,37,223582,3979,No,No,11813
Virginia,2020/11/25,209.1270121,2718,29,226300,4008,No,No,7061
Virginia,2020/11/26,209.1270121,2600,21,228900,4029,No,No,7061
Virginia,2020/11/27,209.1270121,1544,15,230444,4044,No,No,7061
Virginia,2020/11/28,209.1270121,3173,10,233617,4054,No,No,7061
Virginia,2020/11/29,209.1270121,2325,4,235942,4058,No,No,7061
Virginia,2020/11/30,209.1270121,1893,4,237835,4062,No,No,7061
Virginia,2020/12/1,209.1270121,2228,31,240063,4093,No,No,7061
Virginia,2020/12/2,209.1270121,2417,20,242480,4113,No,No,7656
Virginia,2020/12/3,209.1270121,2023,34,244503,4147,No,No,7656
Virginia,2020/12/4,209.1270121,2877,13,247380,4160,No,No,7656
Virginia,2020/12/5,209.1270121,3793,37,251173,4197,No,No,7656
Virginia,2020/12/6,209.1270121,3880,3,255053,4200,No,No,7656
Virginia,2020/12/7,209.1270121,3817,8,258870,4208,No,No,7656
Virginia,2020/12/8,209.1270121,3860,52,262730,4260,No,No,7656
Virginia,2020/12/9,209.1270121,4398,21,267128,4281,No,No,7568
Virginia,2020/12/10,209.1270121,3915,54,271043,4335,No,No,7568
Virginia,2020/12/11,209.1270121,3395,35,274438,4370,No,No,7568
Virginia,2020/12/12,209.1270121,4177,39,278615,4409,No,No,7568
Virginia,2020/12/13,209.1270121,3294,2,281909,4411,No,No,7568
Virginia,2020/12/14,209.1270121,3240,3,285149,4414,No,No,7568
Virginia,2020/12/15,209.1270121,3160,56,288309,4470,No,No,7568
Virginia,2020/12/16,209.1270121,3931,38,292240,4508,No,No,7543
Virginia,2020/12/17,209.1270121,3853,45,296093,4553,No,No,7543
Virginia,2020/12/18,209.1270121,3295,45,299388,4598,No,No,7543
Virginia,2020/12/19,209.1270121,3584,45,302972,4643,No,No,7543
Virginia,2020/12/20,209.1270121,3876,7,306848,4650,No,No,7543
Virginia,2020/12/21,209.1270121,4042,4,310890,4654,No,No,7543
Virginia,2020/12/22,209.1270121,3591,51,314481,4705,No,No,7543
Virginia,2020/12/23,209.1270121,4652,55,319133,4760,No,No,5506
Virginia,2020/12/24,209.1270121,4782,31,323915,4791,No,No,5506
Virginia,2020/12/25,209.1270121,4078,29,327993,4820,No,No,5506
Virginia,2020/12/26,209.1270121,1584,20,329577,4840,No,No,5506
Virginia,2020/12/27,209.1270121,3999,14,333576,4854,No,No,5506
Virginia,2020/12/28,209.1270121,2599,7,336175,4861,No,No,5506
Virginia,2020/12/29,209.1270121,4122,59,340297,4920,No,No,5506
Virginia,2020/12/30,209.1270121,4048,64,344345,4984,No,No,10986
Virginia,2020/12/31,209.1270121,5239,48,349584,5032,No,No,10986
Virginia,2021/1/1,209.1270121,5182,49,354766,5081,No,No,10986
Virginia,2021/1/2,209.1270121,3989,36,358755,5117,No,No,10986
Virginia,2021/1/3,209.1270121,5010,7,363765,5124,No,No,10986
Virginia,2021/1/4,209.1270121,3771,8,367536,5132,No,No,10986
Virginia,2021/1/5,209.1270121,4377,59,371913,5191,No,No,10986
Virginia,2021/1/6,209.1270121,5387,35,377300,5226,No,No,14084
Virginia,2021/1/7,209.1270121,5379,49,382679,5275,No,No,14084
Virginia,2021/1/8,209.1270121,5238,37,387917,5312,No,No,14084
Virginia,2021/1/9,209.1270121,5798,69,393715,5381,No,No,14084
Virginia,2021/1/10,209.1270121,5141,2,398856,5383,No,No,14084
Virginia,2021/1/11,209.1270121,4530,10,403386,5393,No,No,14084
Virginia,2021/1/12,209.1270121,4561,84,407947,5477,No,No,14084
Virginia,2021/1/13,209.1270121,4598,75,412545,5552,No,No,11980
Virginia,2021/1/14,209.1270121,5294,74,417839,5626,No,No,11980
Virginia,2021/1/15,209.1270121,4795,30,422634,5656,No,No,11980
Virginia,2021/1/16,209.1270121,6757,50,429391,5706,No,No,11980
Virginia,2021/1/17,209.1270121,9914,23,439305,5729,No,No,11980
Virginia,2021/1/18,209.1270121,7245,10,446550,5739,No,No,11980
Virginia,2021/1/19,209.1270121,4526,59,451076,5798,No,No,11980
Virginia,2021/1/20,209.1270121,4515,63,455591,5861,No,No,11615
Virginia,2021/1/21,209.1270121,4013,79,459604,5940,No,No,11615
Virginia,2021/1/22,209.1270121,4147,62,463751,6002,No,No,11615
Virginia,2021/1/23,209.1270121,4904,77,468655,6079,No,No,11615
Virginia,2021/1/24,209.1270121,3792,-1,472447,6078,No,No,11615
Virginia,2021/1/25,209.1270121,6172,3,478619,6081,No,No,11615
Virginia,2021/1/26,209.1270121,4707,93,483326,6174,No,No,11615
Virginia,2021/1/27,209.1270121,5227,54,488553,6228,No,No,12664
Virginia,2021/1/28,209.1270121,5121,80,493674,6308,No,No,12664
Virginia,2021/1/29,209.1270121,4238,71,497912,6379,No,No,12664
Virginia,2021/1/30,209.1270121,4309,70,502221,6449,No,No,12664
Virginia,2021/1/31,209.1270121,2558,15,504779,6464,No,No,12664
Virginia,2021/2/1,209.1270121,2861,10,507640,6474,No,No,12664
Virginia,2021/2/2,209.1270121,2740,43,510380,6517,No,No,12664
Virginia,2021/2/3,209.1270121,2959,58,513339,6575,No,No,13464
Virginia,2021/2/4,209.1270121,3059,75,516398,6650,No,No,13464
Virginia,2021/2/5,209.1270121,5069,82,521467,6732,No,No,13464
Virginia,2021/2/6,209.1270121,4709,41,526176,6773,No,No,13464
Virginia,2021/2/7,209.1270121,2949,5,529125,6778,No,No,13464
Virginia,2021/2/8,209.1270121,1700,42,530825,6820,No,No,13464
Virginia,2021/2/9,209.1270121,3291,78,534116,6898,No,No,13464
Virginia,2021/2/10,209.1270121,3203,34,537319,6932,No,No,12087
Virginia,2021/2/11,209.1270121,3699,26,541018,6958,No,No,12087
Virginia,2021/2/12,209.1270121,3191,8,544209,6966,No,No,12087
Virginia,2021/2/13,209.1270121,3215,30,547424,6996,No,No,12087
Virginia,2021/2/14,209.1270121,2575,16,549999,7012,No,No,12087
Virginia,2021/2/15,209.1270121,1539,4,551538,7016,No,No,12087
Virginia,2021/2/16,209.1270121,1770,21,553308,7037,No,No,12087
Virginia,2021/2/17,209.1270121,2284,38,555592,7075,No,No,11395
Virginia,2021/2/18,209.1270121,2304,15,557896,7090,No,No,11395
Virginia,2021/2/19,209.1270121,2034,8,559930,7098,No,No,11395
Virginia,2021/2/20,209.1270121,1882,99,561812,7197,No,No,11395
Virginia,2021/2/21,209.1270121,2303,134,564115,7331,No,No,11395
Virginia,2021/2/22,209.1270121,1155,155,565270,7486,No,No,11395
Virginia,2021/2/23,209.1270121,1769,172,567039,7658,No,No,11395
Virginia,2021/2/24,209.1270121,1907,149,568946,7807,No,No,11395
Virginia,2021/2/25,209.1270121,2036,156,570982,7963,No,No,11395
Virginia,2021/2/26,209.1270121,1657,234,572639,8197,No,No,11395
Virginia,2021/2/27,209.1270121,1675,185,574314,8382,No,No,11395
Virginia,2021/2/28,209.1270121,1736,170,576050,8552,No,No,11395
Virginia,2021/3/1,209.1270121,1124,231,577174,8783,No,No,11395
Virginia,2021/3/2,209.1270121,1385,160,578559,8943,No,No,11395
Virginia,2021/3/3,209.1270121,1549,383,580108,9326,No,No,11395
Virginia,2021/3/4,209.1270121,1300,31,581408,9357,No,No,11395
Washington,2020/3/1,111.6684215,17,3,17,3,No,No,1575
Washington,2020/3/2,111.6684215,6,3,23,6,No,No,1575
Washington,2020/3/3,111.6684215,9,4,32,10,No,No,1575
Washington,2020/3/4,111.6684215,15,1,47,11,No,No,1663
Washington,2020/3/5,111.6684215,28,0,75,11,No,No,1663
Washington,2020/3/6,111.6684215,11,1,86,12,No,No,1663
Washington,2020/3/7,111.6684215,24,4,110,16,No,No,1663
Washington,2020/3/8,111.6684215,31,3,141,19,No,No,1663
Washington,2020/3/9,111.6684215,38,3,179,22,No,No,1663
Washington,2020/3/10,111.6684215,100,2,279,24,No,No,1663
Washington,2020/3/11,111.6684215,59,5,338,29,No,No,1819
Washington,2020/3/12,111.6684215,81,3,419,32,No,No,1819
Washington,2020/3/13,111.6684215,92,5,511,37,No,No,1819
Washington,2020/3/14,111.6684215,98,3,609,40,No,No,1819
Washington,2020/3/15,111.6684215,66,2,675,42,No,No,1819
Washington,2020/3/16,111.6684215,119,6,794,48,No,No,1819
Washington,2020/3/17,111.6684215,114,6,908,54,No,No,1819
Washington,2020/3/18,111.6684215,118,14,1026,68,No,No,10892
Washington,2020/3/19,111.6684215,202,7,1228,75,No,No,10892
Washington,2020/3/20,111.6684215,176,8,1404,83,No,No,10892
Washington,2020/3/21,111.6684215,251,12,1655,95,No,No,10892
Washington,2020/3/22,111.6684215,189,2,1844,97,No,No,10892
Washington,2020/3/23,111.6684215,257,13,2101,110,No,No,10892
Washington,2020/3/24,111.6684215,368,13,2469,123,Yes,No,10892
Washington,2020/3/25,111.6684215,116,7,2585,130,Yes,No,80984
Washington,2020/3/26,111.6684215,623,22,3208,152,Yes,No,80984
Washington,2020/3/27,111.6684215,562,27,3770,179,Yes,No,80984
Washington,2020/3/28,111.6684215,541,14,4311,193,Yes,No,80984
Washington,2020/3/29,111.6684215,586,16,4897,209,Yes,No,80984
Washington,2020/3/30,111.6684215,283,12,5180,221,Yes,No,80984
Washington,2020/3/31,111.6684215,113,5,5293,226,Yes,No,80984
Washington,2020/4/1,111.6684215,296,24,5589,250,Yes,No,106739
Washington,2020/4/2,111.6684215,997,22,6586,272,Yes,No,106739
Washington,2020/4/3,111.6684215,381,21,6967,293,Yes,No,106739
Washington,2020/4/4,111.6684215,532,25,7499,318,Yes,No,106739
Washington,2020/4/5,111.6684215,486,26,7985,344,Yes,No,106739
Washington,2020/4/6,111.6684215,400,39,8385,383,Yes,No,106739
Washington,2020/4/7,111.6684215,298,26,8683,409,Yes,No,106739
Washington,2020/4/8,111.6684215,415,21,9098,430,Yes,No,77515
Washington,2020/4/9,111.6684215,511,26,9609,456,Yes,No,77515
Washington,2020/4/10,111.6684215,279,27,9888,483,Yes,No,77515
Washington,2020/4/11,111.6684215,339,15,10227,498,Yes,No,77515
Washington,2020/4/12,111.6684215,187,13,10414,511,Yes,No,77515
Washington,2020/4/13,111.6684215,133,14,10547,525,Yes,No,77515
Washington,2020/4/14,111.6684215,164,27,10711,552,Yes,No,77515
Washington,2020/4/15,111.6684215,95,20,10806,572,Yes,No,66432
Washington,2020/4/16,111.6684215,374,16,11180,588,Yes,No,66432
Washington,2020/4/17,111.6684215,299,22,11479,610,Yes,No,66432
Washington,2020/4/18,111.6684215,371,19,11850,629,Yes,No,66432
Washington,2020/4/19,111.6684215,14,8,11864,637,Yes,No,66432
Washington,2020/4/20,111.6684215,391,24,12255,661,Yes,No,66432
Washington,2020/4/21,111.6684215,155,22,12410,683,Yes,No,66432
Washington,2020/4/22,111.6684215,196,13,12606,696,Yes,No,74966
Washington,2020/4/23,111.6684215,375,21,12981,717,Yes,No,74966
Washington,2020/4/24,111.6684215,216,14,13197,731,Yes,No,74966
Washington,2020/4/25,111.6684215,368,12,13565,743,Yes,No,74966
Washington,2020/4/26,111.6684215,179,14,13744,757,Yes,No,74966
Washington,2020/4/27,111.6684215,214,14,13958,771,Yes,No,74966
Washington,2020/4/28,111.6684215,207,21,14165,792,Yes,No,74966
Washington,2020/4/29,111.6684215,325,13,14490,805,Yes,No,28985
Washington,2020/4/30,111.6684215,324,17,14814,822,Yes,No,28985
Washington,2020/5/1,111.6684215,320,7,15134,829,Yes,No,28985
Washington,2020/5/2,111.6684215,249,4,15383,833,Yes,No,28985
Washington,2020/5/3,111.6684215,560,7,15943,840,Yes,No,28985
Washington,2020/5/4,111.6684215,104,6,16047,846,Yes,No,28985
Washington,2020/5/5,111.6684215,187,17,16234,863,Yes,No,28985
Washington,2020/5/6,111.6684215,639,18,16873,881,Yes,No,26666
Washington,2020/5/7,111.6684215,314,22,17187,903,Yes,No,26666
Washington,2020/5/8,111.6684215,290,12,17477,915,Yes,No,26666
Washington,2020/5/9,111.6684215,152,10,17629,925,Yes,No,26666
Washington,2020/5/10,111.6684215,152,14,17781,939,Yes,No,26666
Washington,2020/5/11,111.6684215,391,18,18172,957,Yes,No,26666
Washington,2020/5/12,111.6684215,210,15,18382,972,Yes,No,26666
Washington,2020/5/13,111.6684215,110,5,18492,977,Yes,No,25150
Washington,2020/5/14,111.6684215,369,14,18861,991,Yes,No,25150
Washington,2020/5/15,111.6684215,270,17,19131,1008,Yes,No,25150
Washington,2020/5/16,111.6684215,205,7,19336,1015,Yes,No,25150
Washington,2020/5/17,111.6684215,178,1,19514,1016,Yes,No,25150
Washington,2020/5/18,111.6684215,242,4,19756,1020,Yes,No,25150
Washington,2020/5/19,111.6684215,232,22,19988,1042,Yes,No,25150
Washington,2020/5/20,111.6684215,122,3,20110,1045,Yes,No,27919
Washington,2020/5/21,111.6684215,170,9,20280,1054,Yes,No,27919
Washington,2020/5/22,111.6684215,246,7,20526,1061,Yes,No,27919
Washington,2020/5/23,111.6684215,214,1,20740,1062,Yes,No,27919
Washington,2020/5/24,111.6684215,249,7,20989,1069,Yes,No,27919
Washington,2020/5/25,111.6684215,276,7,21265,1076,Yes,No,27919
Washington,2020/5/26,111.6684215,273,15,21538,1091,Yes,No,27919
Washington,2020/5/27,111.6684215,287,15,21825,1106,Yes,No,21335
Washington,2020/5/28,111.6684215,266,10,22091,1116,Yes,No,21335
Washington,2020/5/29,111.6684215,286,4,22377,1120,Yes,No,21335
Washington,2020/5/30,111.6684215,241,6,22618,1126,Yes,No,21335
Washington,2020/5/31,111.6684215,196,0,22814,1126,Yes,No,21335
Washington,2020/6/1,111.6684215,458,7,23272,1133,No,No,21335
Washington,2020/6/2,111.6684215,336,6,23608,1139,No,No,21335
Washington,2020/6/3,111.6684215,168,6,23776,1145,No,No,19949
Washington,2020/6/4,111.6684215,223,5,23999,1150,No,No,19949
Washington,2020/6/5,111.6684215,547,10,24546,1160,No,No,19949
Washington,2020/6/6,111.6684215,221,3,24767,1163,No,No,19949
Washington,2020/6/7,111.6684215,297,0,25064,1163,No,No,19949
Washington,2020/6/8,111.6684215,529,5,25593,1168,No,No,19949
Washington,2020/6/9,111.6684215,203,13,25796,1181,No,No,19949
Washington,2020/6/10,111.6684215,144,2,25940,1183,No,No,18367
Washington,2020/6/11,111.6684215,232,15,26172,1198,No,No,18367
Washington,2020/6/12,111.6684215,404,9,26576,1207,No,No,18367
Washington,2020/6/13,111.6684215,344,9,26920,1216,No,No,18367
Washington,2020/6/14,111.6684215,215,4,27135,1220,No,No,18367
Washington,2020/6/15,111.6684215,442,3,27577,1223,No,No,18367
Washington,2020/6/16,111.6684215,372,11,27949,1234,No,No,18367
Washington,2020/6/17,111.6684215,321,-5,28270,1229,No,No,18671
Washington,2020/6/18,111.6684215,393,17,28663,1246,No,No,18671
Washington,2020/6/19,111.6684215,382,12,29045,1258,No,No,18671
Washington,2020/6/20,111.6684215,421,10,29466,1268,No,No,18671
Washington,2020/6/21,111.6684215,331,3,29797,1271,No,No,18671
Washington,2020/6/22,111.6684215,646,6,30443,1277,No,No,18671
Washington,2020/6/23,111.6684215,335,8,30778,1285,No,No,18671
Washington,2020/6/24,111.6684215,622,9,31400,1294,No,No,18338
Washington,2020/6/25,111.6684215,598,7,31998,1301,No,No,18338
Washington,2020/6/26,111.6684215,491,4,32489,1305,No,No,18338
Washington,2020/6/27,111.6684215,542,6,33031,1311,No,No,18338
Washington,2020/6/28,111.6684215,310,0,33341,1311,No,No,18338
Washington,2020/6/29,111.6684215,695,10,34036,1321,No,No,18338
Washington,2020/6/30,111.6684215,505,12,34541,1333,No,No,18338
Washington,2020/7/1,111.6684215,717,7,35258,1340,No,No,19056
Washington,2020/7/2,111.6684215,663,3,35921,1343,No,No,19056
Washington,2020/7/3,111.6684215,496,10,36417,1353,No,No,19056
Washington,2020/7/4,111.6684215,382,2,36799,1355,No,No,19056
Washington,2020/7/5,111.6684215,669,5,37468,1360,No,No,19056
Washington,2020/7/6,111.6684215,1049,10,38517,1370,No,No,19056
Washington,2020/7/7,111.6684215,546,15,39063,1385,No,No,19056
Washington,2020/7/8,111.6684215,598,10,39661,1395,No,No,20563
Washington,2020/7/9,111.6684215,708,15,40369,1410,No,No,20563
Washington,2020/7/10,111.6684215,721,16,41090,1426,No,No,20563
Washington,2020/7/11,111.6684215,236,0,41326,1426,No,No,20563
Washington,2020/7/12,111.6684215,855,12,42181,1438,No,No,20563
Washington,2020/7/13,111.6684215,1357,1,43538,1439,No,No,20563
Washington,2020/7/14,111.6684215,719,26,44257,1465,No,No,20563
Washington,2020/7/15,111.6684215,747,21,45004,1486,No,No,23676
Washington,2020/7/16,111.6684215,1264,6,46268,1492,No,No,23676
Washington,2020/7/17,111.6684215,958,6,47226,1498,No,No,23676
Washington,2020/7/18,111.6684215,663,11,47889,1509,No,No,23676
Washington,2020/7/19,111.6684215,712,3,48601,1512,No,No,23676
Washington,2020/7/20,111.6684215,1348,9,49949,1521,No,No,23676
Washington,2020/7/21,111.6684215,797,10,50746,1531,No,No,23676
Washington,2020/7/22,111.6684215,696,3,51442,1534,No,No,17437
Washington,2020/7/23,111.6684215,813,14,52255,1548,No,No,17437
Washington,2020/7/24,111.6684215,1023,42,53278,1590,No,No,17437
Washington,2020/7/25,111.6684215,605,1,53883,1591,No,No,17437
Washington,2020/7/26,111.6684215,538,4,54421,1595,No,No,17437
Washington,2020/7/27,111.6684215,1126,15,55547,1610,No,No,17437
Washington,2020/7/28,111.6684215,1028,22,56575,1632,No,No,17437
Washington,2020/7/29,111.6684215,724,10,57299,1642,No,No,11690
Washington,2020/7/30,111.6684215,800,10,58099,1652,No,No,11690
Washington,2020/7/31,111.6684215,626,1,58725,1653,No,No,11690
Washington,2020/8/1,111.6684215,923,22,59648,1675,No,No,11690
Washington,2020/8/2,111.6684215,512,4,60160,1679,No,No,11690
Washington,2020/8/3,111.6684215,851,5,61011,1684,No,No,11690
Washington,2020/8/4,111.6684215,817,21,61828,1705,No,No,11690
Washington,2020/8/5,111.6684215,561,-1,62389,1704,No,No,9467
Washington,2020/8/6,111.6684215,667,11,63056,1715,No,No,9467
Washington,2020/8/7,111.6684215,919,28,63975,1743,No,No,9467
Washington,2020/8/8,111.6684215,371,8,64346,1751,No,No,9467
Washington,2020/8/9,111.6684215,902,22,65248,1773,No,No,9467
Washington,2020/8/10,111.6684215,977,7,66225,1780,No,No,9467
Washington,2020/8/11,111.6684215,394,5,66619,1785,No,No,9467
Washington,2020/8/12,111.6684215,551,3,67170,1788,No,No,11047
Washington,2020/8/13,111.6684215,925,34,68095,1822,No,No,11047
Washington,2020/8/14,111.6684215,486,3,68581,1825,No,No,11047
Washington,2020/8/15,111.6684215,555,17,69136,1842,No,No,11047
Washington,2020/8/16,111.6684215,758,19,69894,1861,No,No,11047
Washington,2020/8/17,111.6684215,615,8,70509,1869,No,No,11047
Washington,2020/8/18,111.6684215,523,26,71032,1895,No,No,11047
Washington,2020/8/19,111.6684215,562,15,71594,1910,No,No,8676
Washington,2020/8/20,111.6684215,690,14,72284,1924,No,No,8676
Washington,2020/8/21,111.6684215,503,13,72787,1937,No,No,8676
Washington,2020/8/22,111.6684215,566,7,73353,1944,No,No,8676
Washington,2020/8/23,111.6684215,392,4,73745,1948,No,No,8676
Washington,2020/8/24,111.6684215,547,5,74292,1953,No,No,8676
Washington,2020/8/25,111.6684215,342,9,74634,1962,No,No,8676
Washington,2020/8/26,111.6684215,573,6,75207,1968,No,No,8511
Washington,2020/8/27,111.6684215,545,9,75752,1977,No,No,8511
Washington,2020/8/28,111.6684215,645,15,76397,1992,No,No,8511
Washington,2020/8/29,111.6684215,437,0,76834,1992,No,No,8511
Washington,2020/8/30,111.6684215,288,0,77122,1992,No,No,8511
Washington,2020/8/31,111.6684215,596,10,77718,2002,No,No,8511
Washington,2020/9/1,111.6684215,343,16,78061,2018,No,No,8511
Washington,2020/9/2,111.6684215,493,7,78554,2025,No,No,8901
Washington,2020/9/3,111.6684215,566,8,79120,2033,No,No,8901
Washington,2020/9/4,111.6684215,601,9,79721,2042,No,No,8901
Washington,2020/9/5,111.6684215,179,0,79900,2042,No,No,8901
Washington,2020/9/6,111.6684215,469,1,80369,2043,No,No,8901
Washington,2020/9/7,111.6684215,116,0,80485,2043,No,No,8901
Washington,2020/9/8,111.6684215,563,2,81048,2045,No,No,8901
Washington,2020/9/9,111.6684215,480,21,81528,2066,No,No,8848
Washington,2020/9/10,111.6684215,597,7,82125,2073,No,No,8848
Washington,2020/9/11,111.6684215,465,6,82590,2079,No,No,8848
Washington,2020/9/12,111.6684215,367,0,82957,2079,No,No,8848
Washington,2020/9/13,111.6684215,220,0,83177,2079,No,No,8848
Washington,2020/9/14,111.6684215,684,16,83861,2095,No,No,8848
Washington,2020/9/15,111.6684215,361,12,84222,2107,No,No,8848
Washington,2020/9/16,111.6684215,492,6,84714,2113,No,No,8679
Washington,2020/9/17,111.6684215,387,10,85101,2123,No,No,8679
Washington,2020/9/18,111.6684215,482,7,85583,2130,No,No,8679
Washington,2020/9/19,111.6684215,303,0,85886,2130,No,No,8679
Washington,2020/9/20,111.6684215,283,0,86169,2130,No,No,8679
Washington,2020/9/21,111.6684215,634,7,86803,2137,No,No,8679
Washington,2020/9/22,111.6684215,430,26,87233,2163,No,No,8679
Washington,2020/9/23,111.6684215,809,12,88042,2175,No,No,8805
Washington,2020/9/24,111.6684215,555,0,88597,2175,No,No,8805
Washington,2020/9/25,111.6684215,552,18,89149,2193,No,No,8805
Washington,2020/9/26,111.6684215,365,3,89514,2196,No,No,8805
Washington,2020/9/27,111.6684215,308,0,89822,2196,No,No,8805
Washington,2020/9/28,111.6684215,774,3,90596,2199,No,No,8805
Washington,2020/9/29,111.6684215,415,19,91011,2218,No,No,8805
Washington,2020/9/30,111.6684215,549,4,91560,2222,No,No,7732
Washington,2020/10/1,111.6684215,606,5,92166,2227,No,No,7732
Washington,2020/10/2,111.6684215,561,12,92727,2239,No,No,7732
Washington,2020/10/3,111.6684215,433,-1,93160,2238,No,No,7732
Washington,2020/10/4,111.6684215,367,0,93527,2238,No,No,7732
Washington,2020/10/5,111.6684215,675,15,94202,2253,No,No,7732
Washington,2020/10/6,111.6684215,492,8,94694,2261,No,No,7732
Washington,2020/10/7,111.6684215,806,13,95500,2274,No,No,8581
Washington,2020/10/8,111.6684215,727,6,96227,2280,No,No,8581
Washington,2020/10/9,111.6684215,610,8,96837,2288,No,No,8581
Washington,2020/10/10,111.6684215,386,1,97223,2289,No,No,8581
Washington,2020/10/11,111.6684215,304,0,97527,2289,No,No,8581
Washington,2020/10/12,111.6684215,738,3,98265,2292,No,No,8581
Washington,2020/10/13,111.6684215,1046,19,99311,2311,No,No,8581
Washington,2020/10/14,111.6684215,757,8,100068,2319,No,No,7964
Washington,2020/10/15,111.6684215,770,12,100838,2331,No,No,7964
Washington,2020/10/16,111.6684215,695,7,101533,2338,No,No,7964
Washington,2020/10/17,111.6684215,521,1,102054,2339,No,No,7964
Washington,2020/10/18,111.6684215,349,0,102403,2339,No,No,7964
Washington,2020/10/19,111.6684215,920,18,103323,2357,No,No,7964
Washington,2020/10/20,111.6684215,522,23,103845,2380,No,No,7964
Washington,2020/10/21,111.6684215,779,4,104624,2384,No,No,7126
Washington,2020/10/22,111.6684215,740,5,105364,2389,No,No,7126
Washington,2020/10/23,111.6684215,825,7,106189,2396,No,No,7126
Washington,2020/10/24,111.6684215,583,0,106772,2396,No,No,7126
Washington,2020/10/25,111.6684215,498,0,107270,2396,No,No,7126
Washington,2020/10/26,111.6684215,1123,32,108393,2428,No,No,7126
Washington,2020/10/27,111.6684215,573,10,108966,2438,No,No,7126
Washington,2020/10/28,111.6684215,899,16,109865,2454,No,No,7060
Washington,2020/10/29,111.6684215,883,9,110748,2463,No,No,7060
Washington,2020/10/30,111.6684215,1145,5,111893,2468,No,No,7060
Washington,2020/10/31,111.6684215,687,0,112580,2468,No,No,7060
Washington,2020/11/1,111.6684215,529,0,113109,2468,No,No,7060
Washington,2020/11/2,111.6684215,1678,16,114787,2484,No,No,7060
Washington,2020/11/3,111.6684215,821,23,115608,2507,No,No,7060
Washington,2020/11/4,111.6684215,1483,19,117091,2526,No,No,8764
Washington,2020/11/5,111.6684215,1368,16,118459,2542,No,No,8764
Washington,2020/11/6,111.6684215,1664,10,120123,2552,No,No,8764
Washington,2020/11/7,111.6684215,1097,0,121220,2552,No,No,8764
Washington,2020/11/8,111.6684215,1090,0,122310,2552,No,No,8764
Washington,2020/11/9,111.6684215,2250,25,124560,2577,No,No,8764
Washington,2020/11/10,111.6684215,1531,17,126091,2594,No,No,8764
Washington,2020/11/11,111.6684215,795,1,126886,2595,No,No,9262
Washington,2020/11/12,111.6684215,2786,24,129672,2619,No,No,9262
Washington,2020/11/13,111.6684215,2511,15,132183,2634,No,No,9262
Washington,2020/11/14,111.6684215,1429,4,133612,2638,No,No,9262
Washington,2020/11/15,111.6684215,1753,0,135365,2638,No,No,9262
Washington,2020/11/16,111.6684215,3237,23,138602,2661,No,No,9262
Washington,2020/11/17,111.6684215,2321,25,140923,2686,No,No,9262
Washington,2020/11/18,111.6684215,1588,18,142511,2704,No,No,11813
Washington,2020/11/19,111.6684215,2457,13,144968,2717,No,No,11813
Washington,2020/11/20,111.6684215,2283,21,147251,2738,No,No,11813
Washington,2020/11/21,111.6684215,1440,0,148691,2738,No,No,11813
Washington,2020/11/22,111.6684215,1012,0,149703,2738,No,No,11813
Washington,2020/11/23,111.6684215,5633,37,155336,2775,No,No,11813
Washington,2020/11/24,111.6684215,2898,32,158234,2807,No,No,11813
Washington,2020/11/25,111.6684215,2973,18,161207,2825,No,No,7061
Washington,2020/11/26,111.6684215,704,0,161911,2825,No,No,7061
Washington,2020/11/27,111.6684215,3319,3,165230,2828,No,No,7061
Washington,2020/11/28,111.6684215,1506,0,166736,2828,No,No,7061
Washington,2020/11/29,111.6684215,1597,0,168333,2828,No,No,7061
Washington,2020/11/30,111.6684215,3842,67,172175,2895,No,No,7061
Washington,2020/12/1,111.6684215,2794,32,174969,2927,No,No,7061
Washington,2020/12/2,111.6684215,2960,52,177929,2979,No,No,7656
Washington,2020/12/3,111.6684215,2196,61,180125,3040,No,No,7656
Washington,2020/12/4,111.6684215,2633,22,182758,3062,No,No,7656
Washington,2020/12/5,111.6684215,1321,3,184079,3065,No,No,7656
Washington,2020/12/6,111.6684215,1426,0,185505,3065,No,No,7656
Washington,2020/12/7,111.6684215,5963,15,191468,3080,No,No,7656
Washington,2020/12/8,111.6684215,3320,22,194788,3102,No,No,7656
Washington,2020/12/9,111.6684215,3185,44,197973,3146,No,No,7568
Washington,2020/12/10,111.6684215,3206,-71,201179,3075,No,No,7568
Washington,2020/12/11,111.6684215,3305,22,204484,3097,No,No,7568
Washington,2020/12/12,111.6684215,2915,-54,207399,3043,No,No,7568
Washington,2020/12/13,111.6684215,1986,2,209385,3045,No,No,7568
Washington,2020/12/14,111.6684215,2957,39,212342,3084,No,No,7568
Washington,2020/12/15,111.6684215,1743,39,214085,3123,No,No,7568
Washington,2020/12/16,111.6684215,1225,16,215310,3139,No,No,7543
Washington,2020/12/17,111.6684215,5318,31,220628,3170,No,No,7543
Washington,2020/12/18,111.6684215,3966,-2,224594,3168,No,No,7543
Washington,2020/12/19,111.6684215,1957,1,226551,3169,No,No,7543
Washington,2020/12/20,111.6684215,498,1,227049,3170,No,No,7543
Washington,2020/12/21,111.6684215,3593,16,230642,3186,No,No,7543
Washington,2020/12/22,111.6684215,1562,28,232204,3214,No,No,7543
Washington,2020/12/23,111.6684215,2628,31,234832,3245,No,No,5506
Washington,2020/12/24,111.6684215,2437,23,237269,3268,No,No,5506
Washington,2020/12/25,111.6684215,420,0,237689,3268,No,No,5506
Washington,2020/12/26,111.6684215,3074,15,240763,3283,No,No,5506
Washington,2020/12/27,111.6684215,273,0,241036,3283,No,No,5506
Washington,2020/12/28,111.6684215,2511,17,243547,3300,No,No,5506
Washington,2020/12/29,111.6684215,2145,133,245692,3433,No,No,5506
Washington,2020/12/30,111.6684215,1763,53,247455,3486,No,No,10986
Washington,2020/12/31,111.6684215,3609,37,251064,3523,No,No,10986
Washington,2021/1/1,111.6684215,521,0,251585,3523,No,No,10986
Washington,2021/1/2,111.6684215,1705,1,253290,3524,No,No,10986
Washington,2021/1/3,111.6684215,5267,0,258557,3524,No,No,10986
Washington,2021/1/4,111.6684215,2771,34,261328,3558,No,No,10986
Washington,2021/1/5,111.6684215,2385,53,263713,3611,No,No,10986
Washington,2021/1/6,111.6684215,2077,70,265790,3681,No,No,14084
Washington,2021/1/7,111.6684215,3243,38,269033,3719,No,No,14084
Washington,2021/1/8,111.6684215,4109,49,273142,3768,No,No,14084
Washington,2021/1/9,111.6684215,2690,7,275832,3775,No,No,14084
Washington,2021/1/10,111.6684215,501,1,276333,3776,No,No,14084
Washington,2021/1/11,111.6684215,4738,17,281071,3793,No,No,14084
Washington,2021/1/12,111.6684215,2292,76,283363,3869,No,No,14084
Washington,2021/1/13,111.6684215,2327,40,285690,3909,No,No,11980
Washington,2021/1/14,111.6684215,2437,40,288127,3949,No,No,11980
Washington,2021/1/15,111.6684215,2161,23,290288,3972,No,No,11980
Washington,2021/1/16,111.6684215,608,-1,290896,3971,No,No,11980
Washington,2021/1/17,111.6684215,2400,0,293296,3971,No,No,11980
Washington,2021/1/18,111.6684215,443,3,293739,3974,No,No,11980
Washington,2021/1/19,111.6684215,2780,46,296519,4020,No,No,11980
Washington,2021/1/20,111.6684215,1968,1,298487,4021,No,No,11615
Washington,2021/1/21,111.6684215,1933,110,300420,4131,No,No,11615
Washington,2021/1/22,111.6684215,2126,47,302546,4178,No,No,11615
Washington,2021/1/23,111.6684215,1561,4,304107,4182,No,No,11615
Washington,2021/1/24,111.6684215,416,0,304523,4182,No,No,11615
Washington,2021/1/25,111.6684215,1966,39,306489,4221,No,No,11615
Washington,2021/1/26,111.6684215,1391,24,307880,4245,No,No,11615
Washington,2021/1/27,111.6684215,1724,49,309604,4294,No,No,12664
Washington,2021/1/28,111.6684215,2438,34,312042,4328,No,No,12664
Washington,2021/1/29,111.6684215,1991,40,314033,4368,No,No,12664
Washington,2021/1/30,111.6684215,1415,0,315448,4368,No,No,12664
Washington,2021/1/31,111.6684215,321,1,315769,4369,No,No,12664
Washington,2021/2/1,111.6684215,1934,35,317703,4404,No,No,12664
Washington,2021/2/2,111.6684215,1264,-2,318967,4402,No,No,12664
Washington,2021/2/3,111.6684215,1535,64,320502,4466,No,No,13464
Washington,2021/2/4,111.6684215,1438,26,321940,4492,No,No,13464
Washington,2021/2/5,111.6684215,1394,34,323334,4526,No,No,13464
Washington,2021/2/6,111.6684215,414,1,323748,4527,No,No,13464
Washington,2021/2/7,111.6684215,199,4,323947,4531,No,No,13464
Washington,2021/2/8,111.6684215,2678,9,326625,4540,No,No,13464
Washington,2021/2/9,111.6684215,772,95,327397,4635,No,No,13464
Washington,2021/2/10,111.6684215,849,40,328246,4675,No,No,12087
Washington,2021/2/11,111.6684215,924,26,329170,4701,No,No,12087
Washington,2021/2/12,111.6684215,1257,38,330427,4739,No,No,12087
Washington,2021/2/13,111.6684215,606,0,331033,4739,No,No,12087
Washington,2021/2/14,111.6684215,131,0,331164,4739,No,No,12087
Washington,2021/2/15,111.6684215,141,0,331305,4739,No,No,12087
Washington,2021/2/16,111.6684215,1880,38,333185,4777,No,No,12087
Washington,2021/2/17,111.6684215,1099,47,334284,4824,No,No,11395
Washington,2021/2/18,111.6684215,1054,44,335338,4868,No,No,11395
Washington,2021/2/19,111.6684215,846,18,336184,4886,No,No,11395
Washington,2021/2/20,111.6684215,635,0,336819,4886,No,No,11395
Washington,2021/2/21,111.6684215,126,0,336945,4886,No,No,11395
Washington,2021/2/22,111.6684215,1364,38,338309,4924,No,No,11395
Washington,2021/2/23,111.6684215,742,23,339051,4947,No,No,11395
Washington,2021/2/24,111.6684215,862,41,339913,4988,No,No,11395
Washington,2021/2/25,111.6684215,1084,27,340997,5015,No,No,11395
Washington,2021/2/26,111.6684215,944,9,341941,5024,No,No,11395
Washington,2021/2/27,111.6684215,633,0,342574,5024,No,No,11395
Washington,2021/2/28,111.6684215,70,0,342644,5024,No,No,11395
Washington,2021/3/1,111.6684215,1079,14,343723,5038,No,No,11395
Washington,2021/3/2,111.6684215,793,18,344516,5056,No,No,11395
Washington,2021/3/3,111.6684215,677,19,345193,5075,No,No,11395
Washington,2021/3/4,111.6684215,837,23,346030,5098,No,No,11395
West Virginia,2020/3/1,74.11384972,0,0,0,0,No,No,1575
West Virginia,2020/3/2,74.11384972,0,0,0,0,No,No,1575
West Virginia,2020/3/3,74.11384972,0,0,0,0,No,No,1575
West Virginia,2020/3/4,74.11384972,0,0,0,0,No,No,1663
West Virginia,2020/3/5,74.11384972,0,0,0,0,No,No,1663
West Virginia,2020/3/6,74.11384972,0,0,0,0,No,No,1663
West Virginia,2020/3/7,74.11384972,0,0,0,0,No,No,1663
West Virginia,2020/3/8,74.11384972,0,0,0,0,No,No,1663
West Virginia,2020/3/9,74.11384972,0,0,0,0,No,No,1663
West Virginia,2020/3/10,74.11384972,0,0,0,0,No,No,1663
West Virginia,2020/3/11,74.11384972,0,0,0,0,No,No,1819
West Virginia,2020/3/12,74.11384972,0,0,0,0,No,No,1819
West Virginia,2020/3/13,74.11384972,0,0,0,0,No,No,1819
West Virginia,2020/3/14,74.11384972,0,0,0,0,No,No,1819
West Virginia,2020/3/15,74.11384972,0,0,0,0,No,No,1819
West Virginia,2020/3/16,74.11384972,0,0,0,0,No,No,1819
West Virginia,2020/3/17,74.11384972,1,0,1,0,No,No,1819
West Virginia,2020/3/18,74.11384972,1,0,2,0,No,No,10892
West Virginia,2020/3/19,74.11384972,3,0,5,0,No,No,10892
West Virginia,2020/3/20,74.11384972,3,0,8,0,No,No,10892
West Virginia,2020/3/21,74.11384972,4,0,12,0,No,No,10892
West Virginia,2020/3/22,74.11384972,4,0,16,0,No,No,10892
West Virginia,2020/3/23,74.11384972,0,0,16,0,No,No,10892
West Virginia,2020/3/24,74.11384972,23,0,39,0,Yes,No,10892
West Virginia,2020/3/25,74.11384972,12,0,51,0,Yes,No,80984
West Virginia,2020/3/26,74.11384972,25,0,76,0,Yes,No,80984
West Virginia,2020/3/27,74.11384972,20,0,96,0,Yes,No,80984
West Virginia,2020/3/28,74.11384972,17,0,113,0,Yes,No,80984
West Virginia,2020/3/29,74.11384972,11,1,124,1,Yes,No,80984
West Virginia,2020/3/30,74.11384972,21,0,145,1,Yes,No,80984
West Virginia,2020/3/31,74.11384972,17,0,162,1,Yes,No,80984
West Virginia,2020/4/1,74.11384972,29,1,191,2,Yes,No,106739
West Virginia,2020/4/2,74.11384972,26,0,217,2,Yes,No,106739
West Virginia,2020/4/3,74.11384972,25,0,242,2,Yes,No,106739
West Virginia,2020/4/4,74.11384972,40,0,282,2,Yes,No,106739
West Virginia,2020/4/5,74.11384972,43,1,325,3,Yes,No,106739
West Virginia,2020/4/6,74.11384972,22,1,347,4,Yes,No,106739
West Virginia,2020/4/7,74.11384972,66,0,413,4,Yes,No,106739
West Virginia,2020/4/8,74.11384972,70,0,483,4,Yes,No,77515
West Virginia,2020/4/9,74.11384972,41,1,524,5,Yes,No,77515
West Virginia,2020/4/10,74.11384972,13,0,537,5,Yes,No,77515
West Virginia,2020/4/11,74.11384972,56,1,593,6,Yes,No,77515
West Virginia,2020/4/12,74.11384972,22,2,615,8,Yes,No,77515
West Virginia,2020/4/13,74.11384972,23,1,638,9,Yes,No,77515
West Virginia,2020/4/14,74.11384972,59,1,697,10,Yes,No,77515
West Virginia,2020/4/15,74.11384972,28,2,725,12,Yes,No,66432
West Virginia,2020/4/16,74.11384972,14,1,739,13,Yes,No,66432
West Virginia,2020/4/17,74.11384972,37,3,776,16,Yes,No,66432
West Virginia,2020/4/18,74.11384972,49,2,825,18,Yes,No,66432
West Virginia,2020/4/19,74.11384972,65,2,890,20,Yes,No,66432
West Virginia,2020/4/20,74.11384972,18,6,908,26,Yes,No,66432
West Virginia,2020/4/21,74.11384972,21,0,929,26,Yes,No,66432
West Virginia,2020/4/22,74.11384972,10,3,939,29,Yes,No,74966
West Virginia,2020/4/23,74.11384972,42,2,981,31,Yes,No,74966
West Virginia,2020/4/24,74.11384972,29,1,1010,32,Yes,No,74966
West Virginia,2020/4/25,74.11384972,15,1,1025,33,Yes,No,74966
West Virginia,2020/4/26,74.11384972,29,1,1054,34,Yes,No,74966
West Virginia,2020/4/27,74.11384972,24,3,1078,37,Yes,No,74966
West Virginia,2020/4/28,74.11384972,18,1,1096,38,Yes,No,74966
West Virginia,2020/4/29,74.11384972,14,2,1110,40,Yes,No,28985
West Virginia,2020/4/30,74.11384972,16,4,1126,44,Yes,No,28985
West Virginia,2020/5/1,74.11384972,26,3,1152,47,Yes,No,28985
West Virginia,2020/5/2,74.11384972,33,3,1185,50,Yes,No,28985
West Virginia,2020/5/3,74.11384972,11,0,1196,50,Yes,No,28985
West Virginia,2020/5/4,74.11384972,29,0,1225,50,Yes,No,28985
West Virginia,2020/5/5,74.11384972,18,0,1243,50,No,No,28985
West Virginia,2020/5/6,74.11384972,34,1,1277,51,No,No,26666
West Virginia,2020/5/7,74.11384972,21,0,1298,51,No,No,26666
West Virginia,2020/5/8,74.11384972,26,1,1324,52,No,No,26666
West Virginia,2020/5/9,74.11384972,24,1,1348,53,No,No,26666
West Virginia,2020/5/10,74.11384972,15,1,1363,54,No,No,26666
West Virginia,2020/5/11,74.11384972,7,3,1370,57,No,No,26666
West Virginia,2020/5/12,74.11384972,9,1,1379,58,No,No,26666
West Virginia,2020/5/13,74.11384972,26,1,1405,59,No,No,25150
West Virginia,2020/5/14,74.11384972,30,3,1435,62,No,No,25150
West Virginia,2020/5/15,74.11384972,13,2,1448,64,No,No,25150
West Virginia,2020/5/16,74.11384972,22,1,1470,65,No,No,25150
West Virginia,2020/5/17,74.11384972,22,2,1492,67,No,No,25150
West Virginia,2020/5/18,74.11384972,10,1,1502,68,No,No,25150
West Virginia,2020/5/19,74.11384972,12,0,1514,68,No,No,25150
West Virginia,2020/5/20,74.11384972,53,1,1567,69,No,No,27919
West Virginia,2020/5/21,74.11384972,36,2,1603,71,No,No,27919
West Virginia,2020/5/22,74.11384972,102,1,1705,72,No,No,27919
West Virginia,2020/5/23,74.11384972,24,0,1729,72,No,No,27919
West Virginia,2020/5/24,74.11384972,42,0,1771,72,No,No,27919
West Virginia,2020/5/25,74.11384972,11,1,1782,73,No,No,27919
West Virginia,2020/5/26,74.11384972,72,1,1854,74,No,No,27919
West Virginia,2020/5/27,74.11384972,45,0,1899,74,No,No,21335
West Virginia,2020/5/28,74.11384972,36,0,1935,74,No,No,21335
West Virginia,2020/5/29,74.11384972,37,0,1972,74,No,No,21335
West Virginia,2020/5/30,74.11384972,17,1,1989,75,No,No,21335
West Virginia,2020/5/31,74.11384972,21,0,2010,75,No,No,21335
West Virginia,2020/6/1,74.11384972,18,1,2028,76,No,No,21335
West Virginia,2020/6/2,74.11384972,28,2,2056,78,No,No,21335
West Virginia,2020/6/3,74.11384972,21,0,2077,78,No,No,19949
West Virginia,2020/6/4,74.11384972,25,1,2102,79,No,No,19949
West Virginia,2020/6/5,74.11384972,17,5,2119,84,No,No,19949
West Virginia,2020/6/6,74.11384972,17,0,2136,84,No,No,19949
West Virginia,2020/6/7,74.11384972,8,0,2144,84,No,No,19949
West Virginia,2020/6/8,74.11384972,17,0,2161,84,No,No,19949
West Virginia,2020/6/9,74.11384972,18,0,2179,84,No,No,19949
West Virginia,2020/6/10,74.11384972,14,1,2193,85,No,No,18367
West Virginia,2020/6/11,74.11384972,24,1,2217,86,No,No,18367
West Virginia,2020/6/12,74.11384972,32,2,2249,88,No,No,18367
West Virginia,2020/6/13,74.11384972,25,0,2274,88,No,No,18367
West Virginia,2020/6/14,74.11384972,16,0,2290,88,No,No,18367
West Virginia,2020/6/15,74.11384972,32,0,2322,88,No,No,18367
West Virginia,2020/6/16,74.11384972,19,0,2341,88,No,No,18367
West Virginia,2020/6/17,74.11384972,35,0,2376,88,No,No,18671
West Virginia,2020/6/18,74.11384972,42,0,2418,88,No,No,18671
West Virginia,2020/6/19,74.11384972,50,0,2468,88,No,No,18671
West Virginia,2020/6/20,74.11384972,32,0,2500,88,No,No,18671
West Virginia,2020/6/21,74.11384972,43,1,2543,89,No,No,18671
West Virginia,2020/6/22,74.11384972,28,1,2571,90,No,No,18671
West Virginia,2020/6/23,74.11384972,22,2,2593,92,No,No,18671
West Virginia,2020/6/24,74.11384972,36,0,2629,92,No,No,18338
West Virginia,2020/6/25,74.11384972,64,0,2693,92,No,No,18338
West Virginia,2020/6/26,74.11384972,36,0,2729,92,No,No,18338
West Virginia,2020/6/27,74.11384972,52,1,2781,93,No,No,18338
West Virginia,2020/6/28,74.11384972,50,0,2831,93,No,No,18338
West Virginia,2020/6/29,74.11384972,38,0,2869,93,No,No,18338
West Virginia,2020/6/30,74.11384972,35,0,2904,93,No,No,18338
West Virginia,2020/7/1,74.11384972,75,0,2979,93,No,No,19056
West Virginia,2020/7/2,74.11384972,74,0,3053,93,No,No,19056
West Virginia,2020/7/3,74.11384972,73,0,3126,93,No,No,19056
West Virginia,2020/7/4,74.11384972,79,1,3205,94,No,No,19056
West Virginia,2020/7/5,74.11384972,130,1,3335,95,No,No,19056
West Virginia,2020/7/6,74.11384972,107,0,3442,95,No,No,19056
West Virginia,2020/7/7,74.11384972,63,0,3505,95,No,Yes,19056
West Virginia,2020/7/8,74.11384972,202,0,3707,95,No,Yes,20563
West Virginia,2020/7/9,74.11384972,119,0,3826,95,No,Yes,20563
West Virginia,2020/7/10,74.11384972,157,0,3983,95,No,Yes,20563
West Virginia,2020/7/11,74.11384972,163,1,4146,96,No,Yes,20563
West Virginia,2020/7/12,74.11384972,98,0,4244,96,No,Yes,20563
West Virginia,2020/7/13,74.11384972,69,1,4313,97,No,Yes,20563
West Virginia,2020/7/14,74.11384972,94,0,4407,97,No,Yes,20563
West Virginia,2020/7/15,74.11384972,150,1,4557,98,No,Yes,23676
West Virginia,2020/7/16,74.11384972,100,1,4657,99,No,Yes,23676
West Virginia,2020/7/17,74.11384972,126,1,4783,100,No,Yes,23676
West Virginia,2020/7/18,74.11384972,139,0,4922,100,No,Yes,23676
West Virginia,2020/7/19,74.11384972,120,0,5042,100,No,Yes,23676
West Virginia,2020/7/20,74.11384972,100,0,5142,100,No,Yes,23676
West Virginia,2020/7/21,74.11384972,57,1,5199,101,No,Yes,23676
West Virginia,2020/7/22,74.11384972,262,1,5461,102,No,Yes,17437
West Virginia,2020/7/23,74.11384972,89,1,5550,103,No,Yes,17437
West Virginia,2020/7/24,74.11384972,145,0,5695,103,No,Yes,17437
West Virginia,2020/7/25,74.11384972,126,0,5821,103,No,Yes,17437
West Virginia,2020/7/26,74.11384972,139,0,5960,103,No,Yes,17437
West Virginia,2020/7/27,74.11384972,94,3,6054,106,No,Yes,17437
West Virginia,2020/7/28,74.11384972,119,5,6173,111,No,Yes,17437
West Virginia,2020/7/29,74.11384972,153,1,6326,112,No,Yes,11690
West Virginia,2020/7/30,74.11384972,96,3,6422,115,No,Yes,11690
West Virginia,2020/7/31,74.11384972,220,1,6642,116,No,Yes,11690
West Virginia,2020/8/1,74.11384972,93,0,6735,116,No,Yes,11690
West Virginia,2020/8/2,74.11384972,119,1,6854,117,No,Yes,11690
West Virginia,2020/8/3,74.11384972,119,0,6973,117,No,Yes,11690
West Virginia,2020/8/4,74.11384972,78,7,7051,124,No,Yes,11690
West Virginia,2020/8/5,74.11384972,108,0,7159,124,No,Yes,9467
West Virginia,2020/8/6,74.11384972,118,0,7277,124,No,Yes,9467
West Virginia,2020/8/7,74.11384972,156,3,7433,127,No,Yes,9467
West Virginia,2020/8/8,74.11384972,130,4,7563,131,No,Yes,9467
West Virginia,2020/8/9,74.11384972,131,8,7694,139,No,Yes,9467
West Virginia,2020/8/10,74.11384972,60,2,7754,141,No,Yes,9467
West Virginia,2020/8/11,74.11384972,121,6,7875,147,No,Yes,9467
West Virginia,2020/8/12,74.11384972,133,6,8008,153,No,Yes,11047
West Virginia,2020/8/13,74.11384972,143,0,8151,153,No,Yes,11047
West Virginia,2020/8/14,74.11384972,123,4,8274,157,No,Yes,11047
West Virginia,2020/8/15,74.11384972,183,3,8457,160,No,Yes,11047
West Virginia,2020/8/16,74.11384972,107,0,8564,160,No,Yes,11047
West Virginia,2020/8/17,74.11384972,68,0,8632,160,No,Yes,11047
West Virginia,2020/8/18,74.11384972,99,4,8731,164,No,Yes,11047
West Virginia,2020/8/19,74.11384972,70,2,8801,166,No,Yes,8676
West Virginia,2020/8/20,74.11384972,181,0,8982,166,No,Yes,8676
West Virginia,2020/8/21,74.11384972,84,4,9066,170,No,Yes,8676
West Virginia,2020/8/22,74.11384972,119,6,9185,176,No,Yes,8676
West Virginia,2020/8/23,74.11384972,87,2,9272,178,No,Yes,8676
West Virginia,2020/8/24,74.11384972,40,1,9312,179,No,Yes,8676
West Virginia,2020/8/25,74.11384972,83,8,9395,187,No,Yes,8676
West Virginia,2020/8/26,74.11384972,145,3,9540,190,No,Yes,8511
West Virginia,2020/8/27,74.11384972,93,9,9633,199,No,Yes,8511
West Virginia,2020/8/28,74.11384972,191,3,9824,202,No,Yes,8511
West Virginia,2020/8/29,74.11384972,143,10,9967,212,No,Yes,8511
West Virginia,2020/8/30,74.11384972,143,1,10110,213,No,Yes,8511
West Virginia,2020/8/31,74.11384972,140,1,10250,214,No,Yes,8511
West Virginia,2020/9/1,74.11384972,257,8,10507,222,No,Yes,8511
West Virginia,2020/9/2,74.11384972,135,8,10642,230,No,Yes,8901
West Virginia,2020/9/3,74.11384972,203,7,10845,237,No,Yes,8901
West Virginia,2020/9/4,74.11384972,192,6,11037,243,No,Yes,8901
West Virginia,2020/9/5,74.11384972,252,0,11289,243,No,Yes,8901
West Virginia,2020/9/6,74.11384972,123,3,11412,246,No,Yes,8901
West Virginia,2020/9/7,74.11384972,163,1,11575,247,No,Yes,8901
West Virginia,2020/9/8,74.11384972,86,3,11661,250,No,Yes,8901
West Virginia,2020/9/9,74.11384972,147,4,11808,254,No,Yes,8848
West Virginia,2020/9/10,74.11384972,209,3,12017,257,No,Yes,8848
West Virginia,2020/9/11,74.11384972,157,6,12174,263,No,Yes,8848
West Virginia,2020/9/12,74.11384972,347,2,12521,265,No,Yes,8848
West Virginia,2020/9/13,74.11384972,178,1,12699,266,No,Yes,8848
West Virginia,2020/9/14,74.11384972,121,9,12820,275,No,Yes,8848
West Virginia,2020/9/15,74.11384972,156,5,12976,280,No,Yes,8848
West Virginia,2020/9/16,74.11384972,220,10,13196,290,No,Yes,8679
West Virginia,2020/9/17,74.11384972,234,4,13430,294,No,Yes,8679
West Virginia,2020/9/18,74.11384972,253,3,13683,297,No,Yes,8679
West Virginia,2020/9/19,74.11384972,191,11,13874,308,No,Yes,8679
West Virginia,2020/9/20,74.11384972,180,2,14054,310,No,Yes,8679
West Virginia,2020/9/21,74.11384972,117,2,14171,312,No,Yes,8679
West Virginia,2020/9/22,74.11384972,213,5,14384,317,No,Yes,8679
West Virginia,2020/9/23,74.11384972,120,2,14504,319,No,Yes,8805
West Virginia,2020/9/24,74.11384972,202,6,14706,325,No,Yes,8805
West Virginia,2020/9/25,74.11384972,247,5,14953,330,No,Yes,8805
West Virginia,2020/9/26,74.11384972,205,2,15158,332,No,Yes,8805
West Virginia,2020/9/27,74.11384972,190,2,15348,334,No,Yes,8805
West Virginia,2020/9/28,74.11384972,164,3,15512,337,No,Yes,8805
West Virginia,2020/9/29,74.11384972,180,8,15692,345,No,Yes,8805
West Virginia,2020/9/30,74.11384972,156,5,15848,350,No,Yes,7732
West Virginia,2020/10/1,74.11384972,176,4,16024,354,No,Yes,7732
West Virginia,2020/10/2,74.11384972,283,1,16307,355,No,Yes,7732
West Virginia,2020/10/3,74.11384972,161,2,16468,357,No,Yes,7732
West Virginia,2020/10/4,74.11384972,160,1,16628,358,No,Yes,7732
West Virginia,2020/10/5,74.11384972,114,3,16742,361,No,Yes,7732
West Virginia,2020/10/6,74.11384972,194,3,16936,364,No,Yes,7732
West Virginia,2020/10/7,74.11384972,203,5,17139,369,No,Yes,8581
West Virginia,2020/10/8,74.11384972,186,1,17325,370,No,Yes,8581
West Virginia,2020/10/9,74.11384972,382,6,17707,376,No,Yes,8581
West Virginia,2020/10/10,74.11384972,206,5,17913,381,No,Yes,8581
West Virginia,2020/10/11,74.11384972,215,1,18128,382,No,Yes,8581
West Virginia,2020/10/12,74.11384972,153,3,18281,385,No,Yes,8581
West Virginia,2020/10/13,74.11384972,274,2,18555,387,No,Yes,8581
West Virginia,2020/10/14,74.11384972,263,4,18818,391,No,Yes,7964
West Virginia,2020/10/15,74.11384972,264,2,19082,393,No,Yes,7964
West Virginia,2020/10/16,74.11384972,498,3,19580,396,No,Yes,7964
West Virginia,2020/10/17,74.11384972,221,3,19801,399,No,Yes,7964
West Virginia,2020/10/18,74.11384972,280,0,20081,399,No,Yes,7964
West Virginia,2020/10/19,74.11384972,212,0,20293,399,No,Yes,7964
West Virginia,2020/10/20,74.11384972,226,9,20519,408,No,Yes,7964
West Virginia,2020/10/21,74.11384972,215,5,20734,413,No,Yes,7126
West Virginia,2020/10/22,74.11384972,323,5,21057,418,No,Yes,7126
West Virginia,2020/10/23,74.11384972,335,4,21392,422,No,Yes,7126
West Virginia,2020/10/24,74.11384972,320,0,21712,422,No,Yes,7126
West Virginia,2020/10/25,74.11384972,194,1,21906,423,No,Yes,7126
West Virginia,2020/10/26,74.11384972,317,1,22223,424,No,Yes,7126
West Virginia,2020/10/27,74.11384972,483,8,22706,432,No,Yes,7126
West Virginia,2020/10/28,74.11384972,358,4,23064,436,No,Yes,7060
West Virginia,2020/10/29,74.11384972,402,7,23466,443,No,Yes,7060
West Virginia,2020/10/30,74.11384972,524,8,23990,451,No,Yes,7060
West Virginia,2020/10/31,74.11384972,470,6,24460,457,No,Yes,7060
West Virginia,2020/11/1,74.11384972,423,0,24883,457,No,Yes,7060
West Virginia,2020/11/2,74.11384972,352,1,25235,458,No,Yes,7060
West Virginia,2020/11/3,74.11384972,358,11,25593,469,No,Yes,7060
West Virginia,2020/11/4,74.11384972,394,3,25987,472,No,Yes,8764
West Virginia,2020/11/5,74.11384972,560,8,26547,480,No,Yes,8764
West Virginia,2020/11/6,74.11384972,540,7,27087,487,No,Yes,8764
West Virginia,2020/11/7,74.11384972,655,15,27742,502,No,Yes,8764
West Virginia,2020/11/8,74.11384972,662,0,28404,502,No,Yes,8764
West Virginia,2020/11/9,74.11384972,401,28,28805,530,No,Yes,8764
West Virginia,2020/11/10,74.11384972,511,16,29316,546,No,Yes,8764
West Virginia,2020/11/11,74.11384972,885,7,30201,553,No,Yes,9262
West Virginia,2020/11/12,74.11384972,696,2,30897,555,No,Yes,9262
West Virginia,2020/11/13,74.11384972,742,10,31639,565,No,Yes,9262
West Virginia,2020/11/14,74.11384972,1153,9,32792,574,No,Yes,9262
West Virginia,2020/11/15,74.11384972,867,8,33659,582,No,Yes,9262
West Virginia,2020/11/16,74.11384972,801,3,34460,585,No,Yes,9262
West Virginia,2020/11/17,74.11384972,864,13,35324,598,No,Yes,9262
West Virginia,2020/11/18,74.11384972,953,14,36277,612,No,Yes,11813
West Virginia,2020/11/19,74.11384972,1122,11,37399,623,No,Yes,11813
West Virginia,2020/11/20,74.11384972,1081,16,38480,639,No,Yes,11813
West Virginia,2020/11/21,74.11384972,1118,19,39598,658,No,Yes,11813
West Virginia,2020/11/22,74.11384972,880,4,40478,662,No,Yes,11813
West Virginia,2020/11/23,74.11384972,636,5,41114,667,No,Yes,11813
West Virginia,2020/11/24,74.11384972,969,15,42083,682,No,Yes,11813
West Virginia,2020/11/25,74.11384972,967,13,43050,695,No,Yes,7061
West Virginia,2020/11/26,74.11384972,1130,17,44180,712,No,Yes,7061
West Virginia,2020/11/27,74.11384972,866,0,45046,712,No,Yes,7061
West Virginia,2020/11/28,74.11384972,799,6,45845,718,No,Yes,7061
West Virginia,2020/11/29,74.11384972,1152,11,46997,729,No,Yes,7061
West Virginia,2020/11/30,74.11384972,845,6,47842,735,No,Yes,7061
West Virginia,2020/12/1,74.11384972,976,23,48818,758,No,Yes,7061
West Virginia,2020/12/2,74.11384972,1087,20,49905,778,No,Yes,7656
West Virginia,2020/12/3,74.11384972,1120,11,51025,789,No,Yes,7656
West Virginia,2020/12/4,74.11384972,1147,10,52172,799,No,Yes,7656
West Virginia,2020/12/5,74.11384972,1400,30,53572,829,No,Yes,7656
West Virginia,2020/12/6,74.11384972,1425,9,54997,838,No,Yes,7656
West Virginia,2020/12/7,74.11384972,1131,3,56128,841,No,Yes,7656
West Virginia,2020/12/8,74.11384972,932,29,57060,870,No,Yes,7656
West Virginia,2020/12/9,74.11384972,1402,31,58462,901,No,Yes,7568
West Virginia,2020/12/10,74.11384972,1233,20,59695,921,No,Yes,7568
West Virginia,2020/12/11,74.11384972,942,17,60637,938,No,Yes,7568
West Virginia,2020/12/12,74.11384972,1514,28,62151,966,No,Yes,7568
West Virginia,2020/12/13,74.11384972,1066,2,63217,968,No,Yes,7568
West Virginia,2020/12/14,74.11384972,1177,10,64394,978,No,Yes,7568
West Virginia,2020/12/15,74.11384972,1314,34,65708,1012,No,Yes,7568
West Virginia,2020/12/16,74.11384972,1141,27,66849,1039,No,Yes,7543
West Virginia,2020/12/17,74.11384972,1636,32,68485,1071,No,Yes,7543
West Virginia,2020/12/18,74.11384972,1266,20,69751,1091,No,Yes,7543
West Virginia,2020/12/19,74.11384972,1464,31,71215,1122,No,Yes,7543
West Virginia,2020/12/20,74.11384972,1127,6,72342,1128,No,Yes,7543
West Virginia,2020/12/21,74.11384972,995,1,73337,1129,No,Yes,7543
West Virginia,2020/12/22,74.11384972,1400,42,74737,1171,No,Yes,7543
West Virginia,2020/12/23,74.11384972,1199,23,75936,1194,No,Yes,5506
West Virginia,2020/12/24,74.11384972,1303,34,77239,1228,No,Yes,5506
West Virginia,2020/12/25,74.11384972,1597,19,78836,1247,No,Yes,5506
West Virginia,2020/12/26,74.11384972,1341,6,80177,1253,No,Yes,5506
West Virginia,2020/12/27,74.11384972,533,1,80710,1254,No,Yes,5506
West Virginia,2020/12/28,74.11384972,726,9,81436,1263,No,Yes,5506
West Virginia,2020/12/29,74.11384972,1337,21,82773,1284,No,Yes,5506
West Virginia,2020/12/30,74.11384972,1452,34,84225,1318,No,Yes,10986
West Virginia,2020/12/31,74.11384972,1109,20,85334,1338,No,Yes,10986
West Virginia,2021/1/1,74.11384972,2486,23,87820,1361,No,Yes,10986
West Virginia,2021/1/2,74.11384972,1507,12,89327,1373,No,Yes,10986
West Virginia,2021/1/3,74.11384972,1731,3,91058,1376,No,Yes,10986
West Virginia,2021/1/4,74.11384972,828,20,91886,1396,No,Yes,10986
West Virginia,2021/1/5,74.11384972,1276,46,93162,1442,No,Yes,10986
West Virginia,2021/1/6,74.11384972,1516,39,94678,1481,No,Yes,14084
West Virginia,2021/1/7,74.11384972,1324,37,96002,1518,No,Yes,14084
West Virginia,2021/1/8,74.11384972,1896,36,97898,1554,No,Yes,14084
West Virginia,2021/1/9,74.11384972,1880,16,99778,1570,No,Yes,14084
West Virginia,2021/1/10,74.11384972,1434,12,101212,1582,No,Yes,14084
West Virginia,2021/1/11,74.11384972,1070,12,102282,1594,No,Yes,14084
West Virginia,2021/1/12,74.11384972,921,40,103203,1634,No,Yes,14084
West Virginia,2021/1/13,74.11384972,1189,37,104392,1671,No,Yes,11980
West Virginia,2021/1/14,74.11384972,827,31,105219,1702,No,Yes,11980
West Virginia,2021/1/15,74.11384972,1430,31,106649,1733,No,Yes,11980
West Virginia,2021/1/16,74.11384972,1475,28,108124,1761,No,Yes,11980
West Virginia,2021/1/17,74.11384972,697,15,108821,1776,No,Yes,11980
West Virginia,2021/1/18,74.11384972,988,8,109809,1784,No,Yes,11980
West Virginia,2021/1/19,74.11384972,1011,31,110820,1815,No,Yes,11980
West Virginia,2021/1/20,74.11384972,857,21,111677,1836,No,Yes,11615
West Virginia,2021/1/21,74.11384972,940,13,112617,1849,No,Yes,11615
West Virginia,2021/1/22,74.11384972,998,7,113615,1856,No,Yes,11615
West Virginia,2021/1/23,74.11384972,1137,16,114752,1872,No,Yes,11615
West Virginia,2021/1/24,74.11384972,555,23,115307,1895,No,Yes,11615
West Virginia,2021/1/25,74.11384972,532,4,115839,1899,No,Yes,11615
West Virginia,2021/1/26,74.11384972,1139,29,116978,1928,No,Yes,11615
West Virginia,2021/1/27,74.11384972,797,25,117775,1953,No,Yes,12664
West Virginia,2021/1/28,74.11384972,787,30,118562,1983,No,Yes,12664
West Virginia,2021/1/29,74.11384972,905,23,119467,2006,No,Yes,12664
West Virginia,2021/1/30,74.11384972,873,9,120340,2015,No,Yes,12664
West Virginia,2021/1/31,74.11384972,661,9,121001,2024,No,Yes,12664
West Virginia,2021/2/1,74.11384972,424,4,121425,2028,No,Yes,12664
West Virginia,2021/2/2,74.11384972,510,3,121935,2031,No,Yes,12664
West Virginia,2021/2/3,74.11384972,535,27,122470,2058,No,Yes,13464
West Virginia,2021/2/4,74.11384972,574,22,123044,2080,No,Yes,13464
West Virginia,2021/2/5,74.11384972,597,20,123641,2100,No,Yes,13464
West Virginia,2021/2/6,74.11384972,549,19,124190,2119,No,Yes,13464
West Virginia,2021/2/7,74.11384972,518,10,124708,2129,No,Yes,13464
West Virginia,2021/2/8,74.11384972,398,2,125106,2131,No,Yes,13464
West Virginia,2021/2/9,74.11384972,416,19,125522,2150,No,Yes,13464
West Virginia,2021/2/10,74.11384972,429,25,125951,2175,No,Yes,12087
West Virginia,2021/2/11,74.11384972,469,12,126420,2187,No,Yes,12087
West Virginia,2021/2/12,74.11384972,467,13,126887,2200,No,Yes,12087
West Virginia,2021/2/13,74.11384972,395,1,127282,2201,No,Yes,12087
West Virginia,2021/2/14,74.11384972,306,9,127588,2210,No,Yes,12087
West Virginia,2021/2/15,74.11384972,301,2,127889,2212,No,Yes,12087
West Virginia,2021/2/16,74.11384972,228,4,128117,2216,No,Yes,12087
West Virginia,2021/2/17,74.11384972,288,9,128405,2225,No,Yes,11395
West Virginia,2021/2/18,74.11384972,355,11,128760,2236,No,Yes,11395
West Virginia,2021/2/19,74.11384972,295,12,129055,2248,No,Yes,11395
West Virginia,2021/2/20,74.11384972,309,6,129364,2254,No,Yes,11395
West Virginia,2021/2/21,74.11384972,252,7,129616,2261,No,Yes,11395
West Virginia,2021/2/22,74.11384972,238,2,129854,2263,No,Yes,11395
West Virginia,2021/2/23,74.11384972,285,11,130139,2274,No,Yes,11395
West Virginia,2021/2/24,74.11384972,243,11,130382,2285,No,Yes,11395
West Virginia,2021/2/25,74.11384972,431,5,130813,2290,No,Yes,11395
West Virginia,2021/2/26,74.11384972,421,1,131234,2291,No,Yes,11395
West Virginia,2021/2/27,74.11384972,346,6,131580,2297,No,Yes,11395
West Virginia,2021/2/28,74.11384972,275,3,131855,2300,No,Yes,11395
West Virginia,2021/3/1,74.11384972,193,0,132048,2300,No,Yes,11395
West Virginia,2021/3/2,74.11384972,136,1,132184,2301,No,Yes,11395
West Virginia,2021/3/3,74.11384972,232,8,132416,2309,No,Yes,11395
West Virginia,2021/3/4,74.11384972,261,0,132677,2309,No,Yes,11395
Wisconsin,2020/3/1,103.6868967,1,0,1,0,No,No,1575
Wisconsin,2020/3/2,103.6868967,0,0,1,0,No,No,1575
Wisconsin,2020/3/3,103.6868967,0,0,1,0,No,No,1575
Wisconsin,2020/3/4,103.6868967,0,0,1,0,No,No,1663
Wisconsin,2020/3/5,103.6868967,0,0,1,0,No,No,1663
Wisconsin,2020/3/6,103.6868967,0,0,1,0,No,No,1663
Wisconsin,2020/3/7,103.6868967,0,0,1,0,No,No,1663
Wisconsin,2020/3/8,103.6868967,0,0,1,0,No,No,1663
Wisconsin,2020/3/9,103.6868967,1,0,2,0,No,No,1663
Wisconsin,2020/3/10,103.6868967,1,0,3,0,No,No,1663
Wisconsin,2020/3/11,103.6868967,3,0,6,0,No,No,1819
Wisconsin,2020/3/12,103.6868967,2,0,8,0,No,No,1819
Wisconsin,2020/3/13,103.6868967,11,0,19,0,No,No,1819
Wisconsin,2020/3/14,103.6868967,8,0,27,0,No,No,1819
Wisconsin,2020/3/15,103.6868967,6,0,33,0,No,No,1819
Wisconsin,2020/3/16,103.6868967,14,0,47,0,No,No,1819
Wisconsin,2020/3/17,103.6868967,25,0,72,0,No,No,1819
Wisconsin,2020/3/18,103.6868967,34,0,106,0,No,No,10892
Wisconsin,2020/3/19,103.6868967,49,2,155,2,No,No,10892
Wisconsin,2020/3/20,103.6868967,61,1,216,3,No,No,10892
Wisconsin,2020/3/21,103.6868967,65,1,281,4,No,No,10892
Wisconsin,2020/3/22,103.6868967,101,0,382,4,No,No,10892
Wisconsin,2020/3/23,103.6868967,36,1,418,5,No,No,10892
Wisconsin,2020/3/24,103.6868967,63,0,481,5,No,No,10892
Wisconsin,2020/3/25,103.6868967,142,2,623,7,Yes,No,80984
Wisconsin,2020/3/26,103.6868967,131,3,754,10,Yes,No,80984
Wisconsin,2020/3/27,103.6868967,176,6,930,16,Yes,No,80984
Wisconsin,2020/3/28,103.6868967,112,1,1042,17,Yes,No,80984
Wisconsin,2020/3/29,103.6868967,78,0,1120,17,Yes,No,80984
Wisconsin,2020/3/30,103.6868967,149,3,1269,20,Yes,No,80984
Wisconsin,2020/3/31,103.6868967,82,5,1351,25,Yes,No,80984
Wisconsin,2020/4/1,103.6868967,201,8,1552,33,Yes,No,106739
Wisconsin,2020/4/2,103.6868967,178,4,1730,37,Yes,No,106739
Wisconsin,2020/4/3,103.6868967,186,13,1916,50,Yes,No,106739
Wisconsin,2020/4/4,103.6868967,196,10,2112,60,Yes,No,106739
Wisconsin,2020/4/5,103.6868967,155,13,2267,73,Yes,No,106739
Wisconsin,2020/4/6,103.6868967,173,10,2440,83,Yes,No,106739
Wisconsin,2020/4/7,103.6868967,138,11,2578,94,Yes,No,106739
Wisconsin,2020/4/8,103.6868967,178,13,2756,107,Yes,No,77515
Wisconsin,2020/4/9,103.6868967,129,9,2885,116,Yes,No,77515
Wisconsin,2020/4/10,103.6868967,183,15,3068,131,Yes,No,77515
Wisconsin,2020/4/11,103.6868967,145,10,3213,141,Yes,No,77515
Wisconsin,2020/4/12,103.6868967,128,4,3341,145,Yes,No,77515
Wisconsin,2020/4/13,103.6868967,87,10,3428,155,Yes,No,77515
Wisconsin,2020/4/14,103.6868967,127,17,3555,172,Yes,No,77515
Wisconsin,2020/4/15,103.6868967,166,12,3721,184,Yes,No,66432
Wisconsin,2020/4/16,103.6868967,154,13,3875,197,Yes,No,66432
Wisconsin,2020/4/17,103.6868967,170,8,4045,205,Yes,No,66432
Wisconsin,2020/4/18,103.6868967,154,7,4199,212,Yes,No,66432
Wisconsin,2020/4/19,103.6868967,147,10,4346,222,Yes,No,66432
Wisconsin,2020/4/20,103.6868967,218,9,4564,231,Yes,No,66432
Wisconsin,2020/4/21,103.6868967,127,12,4691,243,Yes,No,66432
Wisconsin,2020/4/22,103.6868967,224,4,4915,247,Yes,No,74966
Wisconsin,2020/4/23,103.6868967,210,10,5125,257,Yes,No,74966
Wisconsin,2020/4/24,103.6868967,306,5,5431,262,Yes,No,74966
Wisconsin,2020/4/25,103.6868967,331,4,5762,266,Yes,No,74966
Wisconsin,2020/4/26,103.6868967,224,8,5986,274,Yes,No,74966
Wisconsin,2020/4/27,103.6868967,178,7,6164,281,Yes,No,74966
Wisconsin,2020/4/28,103.6868967,225,19,6389,300,Yes,No,74966
Wisconsin,2020/4/29,103.6868967,232,8,6621,308,Yes,No,28985
Wisconsin,2020/4/30,103.6868967,352,8,6973,316,Yes,No,28985
Wisconsin,2020/5/1,103.6868967,466,11,7439,327,Yes,No,28985
Wisconsin,2020/5/2,103.6868967,346,7,7785,334,Yes,No,28985
Wisconsin,2020/5/3,103.6868967,304,5,8089,339,Yes,No,28985
Wisconsin,2020/5/4,103.6868967,273,1,8362,340,Yes,No,28985
Wisconsin,2020/5/5,103.6868967,334,13,8696,353,Yes,No,28985
Wisconsin,2020/5/6,103.6868967,356,9,9052,362,Yes,No,26666
Wisconsin,2020/5/7,103.6868967,317,12,9369,374,Yes,No,26666
Wisconsin,2020/5/8,103.6868967,381,10,9750,384,Yes,No,26666
Wisconsin,2020/5/9,103.6868967,349,14,10099,398,Yes,No,26666
Wisconsin,2020/5/10,103.6868967,280,2,10379,400,Yes,No,26666
Wisconsin,2020/5/11,103.6868967,202,9,10581,409,Yes,No,26666
Wisconsin,2020/5/12,103.6868967,200,9,10781,418,Yes,No,26666
Wisconsin,2020/5/13,103.6868967,290,3,11071,421,Yes,No,25150
Wisconsin,2020/5/14,103.6868967,378,13,11449,434,No,No,25150
Wisconsin,2020/5/15,103.6868967,588,11,12037,445,No,No,25150
Wisconsin,2020/5/16,103.6868967,514,8,12551,453,No,No,25150
Wisconsin,2020/5/17,103.6868967,203,0,12754,453,No,No,25150
Wisconsin,2020/5/18,103.6868967,158,6,12912,459,No,No,25150
Wisconsin,2020/5/19,103.6868967,288,8,13200,467,No,No,25150
Wisconsin,2020/5/20,103.6868967,579,14,13779,481,No,No,27919
Wisconsin,2020/5/21,103.6868967,393,6,14172,487,No,No,27919
Wisconsin,2020/5/22,103.6868967,596,9,14768,496,No,No,27919
Wisconsin,2020/5/23,103.6868967,428,11,15196,507,No,No,27919
Wisconsin,2020/5/24,103.6868967,377,3,15573,510,No,No,27919
Wisconsin,2020/5/25,103.6868967,284,4,15857,514,No,No,27919
Wisconsin,2020/5/26,103.6868967,284,3,16141,517,No,No,27919
Wisconsin,2020/5/27,103.6868967,645,22,16786,539,No,No,21335
Wisconsin,2020/5/28,103.6868967,690,11,17476,550,No,No,21335
Wisconsin,2020/5/29,103.6868967,574,19,18050,569,No,No,21335
Wisconsin,2020/5/30,103.6868967,465,19,18515,588,No,No,21335
Wisconsin,2020/5/31,103.6868967,169,6,18684,594,No,No,21335
Wisconsin,2020/6/1,103.6868967,141,3,18825,597,No,No,21335
Wisconsin,2020/6/2,103.6868967,398,13,19223,610,No,No,21335
Wisconsin,2020/6/3,103.6868967,673,8,19896,618,No,No,19949
Wisconsin,2020/6/4,103.6868967,463,9,20359,627,No,No,19949
Wisconsin,2020/6/5,103.6868967,364,7,20723,634,No,No,19949
Wisconsin,2020/6/6,103.6868967,274,12,20997,646,No,No,19949
Wisconsin,2020/6/7,103.6868967,249,2,21246,648,No,No,19949
Wisconsin,2020/6/8,103.6868967,217,2,21463,650,No,No,19949
Wisconsin,2020/6/9,103.6868967,275,12,21738,662,No,No,19949
Wisconsin,2020/6/10,103.6868967,2353,17,24091,679,No,No,18367
Wisconsin,2020/6/11,103.6868967,320,12,24411,691,No,No,18367
Wisconsin,2020/6/12,103.6868967,322,7,24733,698,No,No,18367
Wisconsin,2020/6/13,103.6868967,293,2,25026,700,No,No,18367
Wisconsin,2020/6/14,103.6868967,281,2,25307,702,No,No,18367
Wisconsin,2020/6/15,103.6868967,223,1,25530,703,No,No,18367
Wisconsin,2020/6/16,103.6868967,299,7,25829,710,No,No,18367
Wisconsin,2020/6/17,103.6868967,338,9,26167,719,No,No,18671
Wisconsin,2020/6/18,103.6868967,444,6,26611,725,No,No,18671
Wisconsin,2020/6/19,103.6868967,302,11,26913,736,No,No,18671
Wisconsin,2020/6/20,103.6868967,401,15,27314,751,No,No,18671
Wisconsin,2020/6/21,103.6868967,284,0,27598,751,No,No,18671
Wisconsin,2020/6/22,103.6868967,251,0,27849,751,No,No,18671
Wisconsin,2020/6/23,103.6868967,338,7,28187,758,No,No,18671
Wisconsin,2020/6/24,103.6868967,465,11,28652,769,No,No,18338
Wisconsin,2020/6/25,103.6868967,552,6,29204,775,No,No,18338
Wisconsin,2020/6/26,103.6868967,514,0,29718,775,No,No,18338
Wisconsin,2020/6/27,103.6868967,517,11,30235,786,No,No,18338
Wisconsin,2020/6/28,103.6868967,481,0,30716,786,No,No,18338
Wisconsin,2020/6/29,103.6868967,387,0,31103,786,No,No,18338
Wisconsin,2020/6/30,103.6868967,620,7,31723,793,No,No,18338
Wisconsin,2020/7/1,103.6868967,584,1,32307,794,No,No,19056
Wisconsin,2020/7/2,103.6868967,569,7,32876,801,No,No,19056
Wisconsin,2020/7/3,103.6868967,689,3,33565,804,No,No,19056
Wisconsin,2020/7/4,103.6868967,678,0,34243,804,No,No,19056
Wisconsin,2020/7/5,103.6868967,507,0,34750,804,No,No,19056
Wisconsin,2020/7/6,103.6868967,568,1,35318,805,No,No,19056
Wisconsin,2020/7/7,103.6868967,516,12,35834,817,No,No,19056
Wisconsin,2020/7/8,103.6868967,692,1,36526,818,No,No,20563
Wisconsin,2020/7/9,103.6868967,832,3,37358,821,No,No,20563
Wisconsin,2020/7/10,103.6868967,1056,4,38414,825,No,No,20563
Wisconsin,2020/7/11,103.6868967,681,4,39095,829,No,No,20563
Wisconsin,2020/7/12,103.6868967,806,-1,39901,828,No,No,20563
Wisconsin,2020/7/13,103.6868967,702,0,40603,828,No,No,20563
Wisconsin,2020/7/14,103.6868967,913,6,41516,834,No,No,20563
Wisconsin,2020/7/15,103.6868967,893,1,42409,835,No,No,23676
Wisconsin,2020/7/16,103.6868967,952,4,43361,839,No,No,23676
Wisconsin,2020/7/17,103.6868967,882,3,44243,842,No,No,23676
Wisconsin,2020/7/18,103.6868967,875,10,45118,852,No,No,23676
Wisconsin,2020/7/19,103.6868967,835,1,45953,853,No,No,23676
Wisconsin,2020/7/20,103.6868967,801,2,46754,855,No,No,23676
Wisconsin,2020/7/21,103.6868967,1139,13,47893,868,No,No,23676
Wisconsin,2020/7/22,103.6868967,884,6,48777,874,No,No,17437
Wisconsin,2020/7/23,103.6868967,974,13,49751,887,No,No,17437
Wisconsin,2020/7/24,103.6868967,1144,0,50895,887,No,No,17437
Wisconsin,2020/7/25,103.6868967,840,13,51735,900,No,No,17437
Wisconsin,2020/7/26,103.6868967,950,1,52685,901,No,No,17437
Wisconsin,2020/7/27,103.6868967,638,4,53323,905,No,No,17437
Wisconsin,2020/7/28,103.6868967,791,11,54114,916,No,No,17437
Wisconsin,2020/7/29,103.6868967,1005,4,55119,920,No,No,11690
Wisconsin,2020/7/30,103.6868967,992,8,56111,928,No,No,11690
Wisconsin,2020/7/31,103.6868967,909,15,57020,943,No,No,11690
Wisconsin,2020/8/1,103.6868967,1044,12,58064,955,No,Yes,11690
Wisconsin,2020/8/2,103.6868967,926,1,58990,956,No,Yes,11690
Wisconsin,2020/8/3,103.6868967,481,4,59471,960,No,Yes,11690
Wisconsin,2020/8/4,103.6868967,792,10,60263,970,No,Yes,11690
Wisconsin,2020/8/5,103.6868967,984,9,61247,979,No,Yes,9467
Wisconsin,2020/8/6,103.6868967,892,9,62139,988,No,Yes,9467
Wisconsin,2020/8/7,103.6868967,1117,13,63256,1001,No,Yes,9467
Wisconsin,2020/8/8,103.6868967,975,6,64231,1007,No,Yes,9467
Wisconsin,2020/8/9,103.6868967,604,2,64835,1009,No,Yes,9467
Wisconsin,2020/8/10,103.6868967,592,0,65427,1009,No,Yes,9467
Wisconsin,2020/8/11,103.6868967,719,8,66146,1017,No,Yes,9467
Wisconsin,2020/8/12,103.6868967,559,5,66705,1022,No,Yes,11047
Wisconsin,2020/8/13,103.6868967,1076,7,67781,1029,No,Yes,11047
Wisconsin,2020/8/14,103.6868967,980,6,68761,1035,No,Yes,11047
Wisconsin,2020/8/15,103.6868967,799,12,69560,1047,No,Yes,11047
Wisconsin,2020/8/16,103.6868967,686,1,70246,1048,No,Yes,11047
Wisconsin,2020/8/17,103.6868967,550,2,70796,1050,No,Yes,11047
Wisconsin,2020/8/18,103.6868967,721,13,71517,1063,No,Yes,11047
Wisconsin,2020/8/19,103.6868967,687,8,72204,1071,No,Yes,8676
Wisconsin,2020/8/20,103.6868967,863,6,73067,1077,No,Yes,8676
Wisconsin,2020/8/21,103.6868967,828,2,73895,1079,No,Yes,8676
Wisconsin,2020/8/22,103.6868967,845,13,74740,1092,No,Yes,8676
Wisconsin,2020/8/23,103.6868967,465,0,75205,1092,No,Yes,8676
Wisconsin,2020/8/24,103.6868967,550,1,75755,1093,No,Yes,8676
Wisconsin,2020/8/25,103.6868967,698,13,76453,1106,No,Yes,8676
Wisconsin,2020/8/26,103.6868967,767,6,77220,1112,No,Yes,8511
Wisconsin,2020/8/27,103.6868967,916,9,78136,1121,No,Yes,8511
Wisconsin,2020/8/28,103.6868967,848,2,78984,1123,No,Yes,8511
Wisconsin,2020/8/29,103.6868967,783,6,79767,1129,No,Yes,8511
Wisconsin,2020/8/30,103.6868967,544,3,80311,1132,No,Yes,8511
Wisconsin,2020/8/31,103.6868967,422,0,80733,1132,No,Yes,8511
Wisconsin,2020/9/1,103.6868967,955,9,81688,1141,No,Yes,8511
Wisconsin,2020/9/2,103.6868967,573,10,82261,1151,No,Yes,8901
Wisconsin,2020/9/3,103.6868967,858,4,83119,1155,No,Yes,8901
Wisconsin,2020/9/4,103.6868967,1400,9,84519,1164,No,Yes,8901
Wisconsin,2020/9/5,103.6868967,998,13,85517,1177,No,Yes,8901
Wisconsin,2020/9/6,103.6868967,889,0,86406,1177,No,Yes,8901
Wisconsin,2020/9/7,103.6868967,575,0,86981,1177,No,Yes,8901
Wisconsin,2020/9/8,103.6868967,749,2,87730,1179,No,Yes,8901
Wisconsin,2020/9/9,103.6868967,913,14,88643,1193,No,Yes,8848
Wisconsin,2020/9/10,103.6868967,1589,9,90232,1202,No,Yes,8848
Wisconsin,2020/9/11,103.6868967,1440,4,91672,1206,No,Yes,8848
Wisconsin,2020/9/12,103.6868967,1430,12,93102,1218,No,Yes,8848
Wisconsin,2020/9/13,103.6868967,1621,1,94723,1219,No,Yes,8848
Wisconsin,2020/9/14,103.6868967,841,0,95564,1219,No,Yes,8848
Wisconsin,2020/9/15,103.6868967,1438,11,97002,1230,No,Yes,8848
Wisconsin,2020/9/16,103.6868967,1499,8,98501,1238,No,Yes,8679
Wisconsin,2020/9/17,103.6868967,2118,2,100619,1240,No,Yes,8679
Wisconsin,2020/9/18,103.6868967,2592,7,103211,1247,No,Yes,8679
Wisconsin,2020/9/19,103.6868967,2398,2,105609,1249,No,Yes,8679
Wisconsin,2020/9/20,103.6868967,1734,1,107343,1250,No,Yes,8679
Wisconsin,2020/9/21,103.6868967,1313,3,108656,1253,No,Yes,8679
Wisconsin,2020/9/22,103.6868967,1737,6,110393,1259,No,Yes,8679
Wisconsin,2020/9/23,103.6868967,1883,10,112276,1269,No,Yes,8805
Wisconsin,2020/9/24,103.6868967,2467,6,114743,1275,No,Yes,8805
Wisconsin,2020/9/25,103.6868967,2612,10,117355,1285,No,Yes,8805
Wisconsin,2020/9/26,103.6868967,2894,6,120249,1291,No,Yes,8805
Wisconsin,2020/9/27,103.6868967,2249,0,122498,1291,No,Yes,8805
Wisconsin,2020/9/28,103.6868967,1822,2,124320,1293,No,Yes,8805
Wisconsin,2020/9/29,103.6868967,2424,19,126744,1312,No,Yes,8805
Wisconsin,2020/9/30,103.6868967,2428,26,129172,1338,No,Yes,7732
Wisconsin,2020/10/1,103.6868967,3004,20,132176,1358,No,Yes,7732
Wisconsin,2020/10/2,103.6868967,2820,6,134996,1364,No,Yes,7732
Wisconsin,2020/10/3,103.6868967,3022,19,138018,1383,No,Yes,7732
Wisconsin,2020/10/4,103.6868967,1923,5,139941,1388,No,Yes,7732
Wisconsin,2020/10/5,103.6868967,1839,5,141780,1393,No,Yes,7732
Wisconsin,2020/10/6,103.6868967,2106,17,143886,1410,No,Yes,7732
Wisconsin,2020/10/7,103.6868967,2490,17,146376,1427,No,Yes,8581
Wisconsin,2020/10/8,103.6868967,3237,9,149613,1436,No,Yes,8581
Wisconsin,2020/10/9,103.6868967,3218,17,152831,1453,No,Yes,8581
Wisconsin,2020/10/10,103.6868967,2921,17,155752,1470,No,Yes,8581
Wisconsin,2020/10/11,103.6868967,2674,7,158426,1477,No,Yes,8581
Wisconsin,2020/10/12,103.6868967,2229,11,160655,1488,No,Yes,8581
Wisconsin,2020/10/13,103.6868967,3482,33,164137,1521,No,Yes,8581
Wisconsin,2020/10/14,103.6868967,3304,28,167441,1549,No,Yes,7964
Wisconsin,2020/10/15,103.6868967,4039,19,171480,1568,No,Yes,7964
Wisconsin,2020/10/16,103.6868967,4172,20,175652,1588,No,Yes,7964
Wisconsin,2020/10/17,103.6868967,0,0,175652,1588,No,Yes,7964
Wisconsin,2020/10/18,103.6868967,0,0,175652,1588,No,Yes,7964
Wisconsin,2020/10/19,103.6868967,7525,36,183177,1624,No,Yes,7964
Wisconsin,2020/10/20,103.6868967,4721,36,187898,1660,No,Yes,7964
Wisconsin,2020/10/21,103.6868967,4327,47,192225,1707,No,Yes,7126
Wisconsin,2020/10/22,103.6868967,3628,23,195853,1730,No,Yes,7126
Wisconsin,2020/10/23,103.6868967,4626,46,200479,1776,No,Yes,7126
Wisconsin,2020/10/24,103.6868967,4660,28,205139,1804,No,Yes,7126
Wisconsin,2020/10/25,103.6868967,3778,10,208917,1814,No,Yes,7126
Wisconsin,2020/10/26,103.6868967,3199,11,212116,1825,No,Yes,7126
Wisconsin,2020/10/27,103.6868967,5331,71,217447,1896,No,Yes,7126
Wisconsin,2020/10/28,103.6868967,4131,57,221578,1953,No,Yes,7060
Wisconsin,2020/10/29,103.6868967,5134,55,226712,2008,No,Yes,7060
Wisconsin,2020/10/30,103.6868967,5380,26,232092,2034,No,Yes,7060
Wisconsin,2020/10/31,103.6868967,5778,58,237870,2092,No,Yes,7060
Wisconsin,2020/11/1,103.6868967,3553,18,241423,2110,No,Yes,7060
Wisconsin,2020/11/2,103.6868967,3551,7,244974,2117,No,Yes,7060
Wisconsin,2020/11/3,103.6868967,6253,62,251227,2179,No,Yes,7060
Wisconsin,2020/11/4,103.6868967,6138,58,257365,2237,No,Yes,8764
Wisconsin,2020/11/5,103.6868967,6275,36,263640,2273,No,Yes,8764
Wisconsin,2020/11/6,103.6868967,6434,67,270074,2340,No,Yes,8764
Wisconsin,2020/11/7,103.6868967,7494,45,277568,2385,No,Yes,8764
Wisconsin,2020/11/8,103.6868967,4342,11,281910,2396,No,Yes,8764
Wisconsin,2020/11/9,103.6868967,4536,25,286446,2421,No,Yes,8764
Wisconsin,2020/11/10,103.6868967,7416,76,293862,2497,No,Yes,8764
Wisconsin,2020/11/11,103.6868967,7487,65,301349,2562,No,Yes,9262
Wisconsin,2020/11/12,103.6868967,8256,64,309605,2626,No,Yes,9262
Wisconsin,2020/11/13,103.6868967,8418,68,318023,2694,No,Yes,9262
Wisconsin,2020/11/14,103.6868967,5581,54,323604,2748,No,Yes,9262
Wisconsin,2020/11/15,103.6868967,6320,11,329924,2759,No,Yes,9262
Wisconsin,2020/11/16,103.6868967,4716,16,334640,2775,No,Yes,9262
Wisconsin,2020/11/17,103.6868967,7515,101,342155,2876,No,Yes,9262
Wisconsin,2020/11/18,103.6868967,8510,63,350665,2939,No,Yes,11813
Wisconsin,2020/11/19,103.6868967,7448,82,358113,3021,No,Yes,11813
Wisconsin,2020/11/20,103.6868967,7077,85,365190,3106,No,Yes,11813
Wisconsin,2020/11/21,103.6868967,7029,49,372219,3155,No,Yes,11813
Wisconsin,2020/11/22,103.6868967,4019,7,376238,3162,No,No,11813
Wisconsin,2020/11/23,103.6868967,3455,13,379693,3175,No,No,11813
Wisconsin,2020/11/24,103.6868967,6748,120,386441,3295,No,No,11813
Wisconsin,2020/11/25,103.6868967,6002,68,392443,3363,No,No,7061
Wisconsin,2020/11/26,103.6868967,5661,68,398104,3431,No,No,7061
Wisconsin,2020/11/27,103.6868967,1453,13,399557,3444,No,No,7061
Wisconsin,2020/11/28,103.6868967,5442,30,404999,3474,No,No,7061
Wisconsin,2020/11/29,103.6868967,4055,22,409054,3496,No,No,7061
Wisconsin,2020/11/30,103.6868967,2676,8,411730,3504,No,No,7061
Wisconsin,2020/12/1,103.6868967,4635,124,416365,3628,No,No,7061
Wisconsin,2020/12/2,103.6868967,4565,87,420930,3715,No,No,7656
Wisconsin,2020/12/3,103.6868967,5604,66,426534,3781,No,No,7656
Wisconsin,2020/12/4,103.6868967,5683,66,432217,3847,No,No,7656
Wisconsin,2020/12/5,103.6868967,5701,91,437918,3938,No,No,7656
Wisconsin,2020/12/6,103.6868967,3149,18,441067,3956,No,No,7656
Wisconsin,2020/12/7,103.6868967,2348,23,443415,3979,No,No,7656
Wisconsin,2020/12/8,103.6868967,4594,80,448009,4059,No,No,7656
Wisconsin,2020/12/9,103.6868967,4171,90,452180,4149,No,No,7568
Wisconsin,2020/12/10,103.6868967,4709,67,456889,4216,No,No,7568
Wisconsin,2020/12/11,103.6868967,4478,56,461367,4272,No,No,7568
Wisconsin,2020/12/12,103.6868967,4624,57,465991,4329,No,No,7568
Wisconsin,2020/12/13,103.6868967,2965,15,468956,4344,No,No,7568
Wisconsin,2020/12/14,103.6868967,2329,15,471285,4359,No,No,7568
Wisconsin,2020/12/15,103.6868967,4055,53,475340,4412,No,No,7568
Wisconsin,2020/12/16,103.6868967,2822,87,478162,4499,No,No,7543
Wisconsin,2020/12/17,103.6868967,4281,67,482443,4566,No,No,7543
Wisconsin,2020/12/18,103.6868967,3921,69,486364,4635,No,No,7543
Wisconsin,2020/12/19,103.6868967,4315,89,490679,4724,No,No,7543
Wisconsin,2020/12/20,103.6868967,2045,21,492724,4745,No,No,7543
Wisconsin,2020/12/21,103.6868967,1629,9,494353,4754,No,No,7543
Wisconsin,2020/12/22,103.6868967,3027,128,497380,4882,No,No,7543
Wisconsin,2020/12/23,103.6868967,3063,74,500443,4956,No,No,5506
Wisconsin,2020/12/24,103.6868967,3263,66,503706,5022,No,No,5506
Wisconsin,2020/12/25,103.6868967,1639,6,505345,5028,No,No,5506
Wisconsin,2020/12/26,103.6868967,677,4,506022,5032,No,No,5506
Wisconsin,2020/12/27,103.6868967,2558,10,508580,5042,No,No,5506
Wisconsin,2020/12/28,103.6868967,1557,23,510137,5065,No,No,5506
Wisconsin,2020/12/29,103.6868967,2919,92,513056,5157,No,No,5506
Wisconsin,2020/12/30,103.6868967,3170,38,516226,5195,No,No,10986
Wisconsin,2020/12/31,103.6868967,4212,50,520438,5245,No,No,10986
Wisconsin,2021/1/1,103.6868967,2085,12,522523,5257,No,No,10986
Wisconsin,2021/1/2,103.6868967,1129,2,523652,5259,No,No,10986
Wisconsin,2021/1/3,103.6868967,2593,5,526245,5264,No,No,10986
Wisconsin,2021/1/4,103.6868967,1626,9,527871,5273,No,No,10986
Wisconsin,2021/1/5,103.6868967,4019,97,531890,5370,No,No,10986
Wisconsin,2021/1/6,103.6868967,4109,72,535999,5442,No,No,14084
Wisconsin,2021/1/7,103.6868967,4509,43,540508,5485,No,No,14084
Wisconsin,2021/1/8,103.6868967,4110,45,544618,5530,No,No,14084
Wisconsin,2021/1/9,103.6868967,3516,38,548134,5568,No,No,14084
Wisconsin,2021/1/10,103.6868967,2126,3,550260,5571,No,No,14084
Wisconsin,2021/1/11,103.6868967,1682,5,551942,5576,No,No,14084
Wisconsin,2021/1/12,103.6868967,3307,59,555249,5635,No,No,14084
Wisconsin,2021/1/13,103.6868967,2771,44,558020,5679,No,No,11980
Wisconsin,2021/1/14,103.6868967,3140,50,561160,5729,No,No,11980
Wisconsin,2021/1/15,103.6868967,2706,42,563866,5771,No,No,11980
Wisconsin,2021/1/16,103.6868967,2409,135,566275,5906,No,No,11980
Wisconsin,2021/1/17,103.6868967,1891,1,568166,5907,No,No,11980
Wisconsin,2021/1/18,103.6868967,1169,23,569335,5930,No,No,11980
Wisconsin,2021/1/19,103.6868967,1933,44,571268,5974,No,No,11980
Wisconsin,2021/1/20,103.6868967,1851,62,573119,6036,No,No,11615
Wisconsin,2021/1/21,103.6868967,2569,55,575688,6091,No,No,11615
Wisconsin,2021/1/22,103.6868967,2303,49,577991,6140,No,No,11615
Wisconsin,2021/1/23,103.6868967,2012,47,580003,6187,No,No,11615
Wisconsin,2021/1/24,103.6868967,1374,6,581377,6193,No,No,11615
Wisconsin,2021/1/25,103.6868967,1100,10,582477,6203,No,No,11615
Wisconsin,2021/1/26,103.6868967,1564,65,584041,6268,No,No,11615
Wisconsin,2021/1/27,103.6868967,1559,38,585600,6306,No,No,12664
Wisconsin,2021/1/28,103.6868967,1980,33,587580,6339,No,No,12664
Wisconsin,2021/1/29,103.6868967,1804,54,589384,6393,No,No,12664
Wisconsin,2021/1/30,103.6868967,1613,40,590997,6433,No,No,12664
Wisconsin,2021/1/31,103.6868967,1143,4,592140,6437,No,No,12664
Wisconsin,2021/2/1,103.6868967,781,2,592921,6439,No,No,12664
Wisconsin,2021/2/2,103.6868967,1296,46,594217,6485,No,No,12664
Wisconsin,2021/2/3,103.6868967,1539,15,595756,6500,No,No,13464
Wisconsin,2021/2/4,103.6868967,1719,49,597475,6549,No,No,13464
Wisconsin,2021/2/5,103.6868967,1427,30,598902,6579,No,No,13464
Wisconsin,2021/2/6,103.6868967,1114,36,600016,6615,No,No,13464
Wisconsin,2021/2/7,103.6868967,766,2,600782,6617,No,No,13464
Wisconsin,2021/2/8,103.6868967,609,2,601391,6619,No,No,13464
Wisconsin,2021/2/9,103.6868967,865,50,602256,6669,No,No,13464
Wisconsin,2021/2/10,103.6868967,1001,39,603257,6708,No,No,12087
Wisconsin,2021/2/11,103.6868967,1426,17,604683,6725,No,No,12087
Wisconsin,2021/2/12,103.6868967,1102,12,605785,6737,No,No,12087
Wisconsin,2021/2/13,103.6868967,866,10,606651,6747,No,No,12087
Wisconsin,2021/2/14,103.6868967,562,1,607213,6748,No,No,12087
Wisconsin,2021/2/15,103.6868967,426,5,607639,6753,No,No,12087
Wisconsin,2021/2/16,103.6868967,781,39,608420,6792,No,No,12087
Wisconsin,2021/2/17,103.6868967,772,11,609192,6803,No,No,11395
Wisconsin,2021/2/18,103.6868967,864,17,610056,6820,No,No,11395
Wisconsin,2021/2/19,103.6868967,918,36,610974,6856,No,No,11395
Wisconsin,2021/2/20,103.6868967,815,19,611789,6875,No,No,11395
Wisconsin,2021/2/21,103.6868967,451,0,612240,6875,No,No,11395
Wisconsin,2021/2/22,103.6868967,473,1,612713,6876,No,No,11395
Wisconsin,2021/2/23,103.6868967,714,38,613427,6914,No,No,11395
Wisconsin,2021/2/24,103.6868967,844,26,614271,6940,No,No,11395
Wisconsin,2021/2/25,103.6868967,962,58,615233,6998,No,No,11395
Wisconsin,2021/2/26,103.6868967,796,6,616029,7004,No,No,11395
Wisconsin,2021/2/27,103.6868967,870,15,616899,7019,No,No,11395
Wisconsin,2021/2/28,103.6868967,481,0,617380,7019,No,No,11395
Wisconsin,2021/3/1,103.6868967,320,0,617700,7019,No,No,11395
Wisconsin,2021/3/2,103.6868967,610,36,618310,7055,No,No,11395
Wisconsin,2021/3/3,103.6868967,779,19,619089,7074,No,No,11395
Wisconsin,2021/3/4,103.6868967,853,13,619942,7087,No,No,11395
Wyoming,2020/3/1,5.91089119,0,0,0,0,No,No,1575
Wyoming,2020/3/2,5.91089119,0,0,0,0,No,No,1575
Wyoming,2020/3/3,5.91089119,0,0,0,0,No,No,1575
Wyoming,2020/3/4,5.91089119,0,0,0,0,No,No,1663
Wyoming,2020/3/5,5.91089119,0,0,0,0,No,No,1663
Wyoming,2020/3/6,5.91089119,0,0,0,0,No,No,1663
Wyoming,2020/3/7,5.91089119,0,0,0,0,No,No,1663
Wyoming,2020/3/8,5.91089119,0,0,0,0,No,No,1663
Wyoming,2020/3/9,5.91089119,0,0,0,0,No,No,1663
Wyoming,2020/3/10,5.91089119,0,0,0,0,No,No,1663
Wyoming,2020/3/11,5.91089119,1,0,1,0,No,No,1819
Wyoming,2020/3/12,5.91089119,0,0,1,0,No,No,1819
Wyoming,2020/3/13,5.91089119,1,0,2,0,No,No,1819
Wyoming,2020/3/14,5.91089119,1,0,3,0,No,No,1819
Wyoming,2020/3/15,5.91089119,0,0,3,0,No,No,1819
Wyoming,2020/3/16,5.91089119,7,0,10,0,No,No,1819
Wyoming,2020/3/17,5.91089119,5,0,15,0,No,No,1819
Wyoming,2020/3/18,5.91089119,2,0,17,0,No,No,10892
Wyoming,2020/3/19,5.91089119,1,0,18,0,No,No,10892
Wyoming,2020/3/20,5.91089119,4,0,22,0,No,No,10892
Wyoming,2020/3/21,5.91089119,2,0,24,0,No,No,10892
Wyoming,2020/3/22,5.91089119,2,0,26,0,No,No,10892
Wyoming,2020/3/23,5.91089119,2,0,28,0,No,No,10892
Wyoming,2020/3/24,5.91089119,9,0,37,0,No,No,10892
Wyoming,2020/3/25,5.91089119,12,0,49,0,No,No,80984
Wyoming,2020/3/26,5.91089119,7,0,56,0,No,No,80984
Wyoming,2020/3/27,5.91089119,18,0,74,0,No,No,80984
Wyoming,2020/3/28,5.91089119,11,0,85,0,No,No,80984
Wyoming,2020/3/29,5.91089119,3,0,88,0,No,No,80984
Wyoming,2020/3/30,5.91089119,8,0,96,0,No,No,80984
Wyoming,2020/3/31,5.91089119,25,0,121,0,No,No,80984
Wyoming,2020/4/1,5.91089119,17,0,138,0,No,No,106739
Wyoming,2020/4/2,5.91089119,16,0,154,0,No,No,106739
Wyoming,2020/4/3,5.91089119,13,0,167,0,No,No,106739
Wyoming,2020/4/4,5.91089119,22,0,189,0,No,No,106739
Wyoming,2020/4/5,5.91089119,11,0,200,0,No,No,106739
Wyoming,2020/4/6,5.91089119,13,0,213,0,No,No,106739
Wyoming,2020/4/7,5.91089119,8,0,221,0,No,No,106739
Wyoming,2020/4/8,5.91089119,9,0,230,0,No,No,77515
Wyoming,2020/4/9,5.91089119,73,0,303,0,No,No,77515
Wyoming,2020/4/10,5.91089119,17,0,320,0,No,No,77515
Wyoming,2020/4/11,5.91089119,23,0,343,0,No,No,77515
Wyoming,2020/4/12,5.91089119,21,0,364,0,No,No,77515
Wyoming,2020/4/13,5.91089119,9,1,373,1,No,No,77515
Wyoming,2020/4/14,5.91089119,0,0,373,1,No,No,77515
Wyoming,2020/4/15,5.91089119,19,1,392,2,No,No,66432
Wyoming,2020/4/16,5.91089119,1,0,393,2,No,No,66432
Wyoming,2020/4/17,5.91089119,8,0,401,2,No,No,66432
Wyoming,2020/4/18,5.91089119,11,0,412,2,No,No,66432
Wyoming,2020/4/19,5.91089119,10,0,422,2,No,No,66432
Wyoming,2020/4/20,5.91089119,4,0,426,2,No,No,66432
Wyoming,2020/4/21,5.91089119,16,4,442,6,No,No,66432
Wyoming,2020/4/22,5.91089119,5,0,447,6,No,No,74966
Wyoming,2020/4/23,5.91089119,6,1,453,7,No,No,74966
Wyoming,2020/4/24,5.91089119,20,0,473,7,No,No,74966
Wyoming,2020/4/25,5.91089119,4,0,477,7,No,No,74966
Wyoming,2020/4/26,5.91089119,25,0,502,7,No,No,74966
Wyoming,2020/4/27,5.91089119,18,0,520,7,No,No,74966
Wyoming,2020/4/28,5.91089119,16,0,536,7,No,No,74966
Wyoming,2020/4/29,5.91089119,8,0,544,7,No,No,28985
Wyoming,2020/4/30,5.91089119,15,0,559,7,No,No,28985
Wyoming,2020/5/1,5.91089119,7,0,566,7,No,No,28985
Wyoming,2020/5/2,5.91089119,13,0,579,7,No,No,28985
Wyoming,2020/5/3,5.91089119,7,0,586,7,No,No,28985
Wyoming,2020/5/4,5.91089119,10,0,596,7,No,No,28985
Wyoming,2020/5/5,5.91089119,8,0,604,7,No,No,28985
Wyoming,2020/5/6,5.91089119,27,0,631,7,No,No,26666
Wyoming,2020/5/7,5.91089119,4,0,635,7,No,No,26666
Wyoming,2020/5/8,5.91089119,9,0,644,7,No,No,26666
Wyoming,2020/5/9,5.91089119,9,0,653,7,No,No,26666
Wyoming,2020/5/10,5.91089119,9,0,662,7,No,No,26666
Wyoming,2020/5/11,5.91089119,7,0,669,7,No,No,26666
Wyoming,2020/5/12,5.91089119,6,0,675,7,No,No,26666
Wyoming,2020/5/13,5.91089119,13,0,688,7,No,No,25150
Wyoming,2020/5/14,5.91089119,13,0,701,7,No,No,25150
Wyoming,2020/5/15,5.91089119,15,0,716,7,No,No,25150
Wyoming,2020/5/16,5.91089119,25,0,741,7,No,No,25150
Wyoming,2020/5/17,5.91089119,13,1,754,8,No,No,25150
Wyoming,2020/5/18,5.91089119,12,2,766,10,No,No,25150
Wyoming,2020/5/19,5.91089119,10,0,776,10,No,No,25150
Wyoming,2020/5/20,5.91089119,11,1,787,11,No,No,27919
Wyoming,2020/5/21,5.91089119,14,1,801,12,No,No,27919
Wyoming,2020/5/22,5.91089119,2,0,803,12,No,No,27919
Wyoming,2020/5/23,5.91089119,10,0,813,12,No,No,27919
Wyoming,2020/5/24,5.91089119,0,0,813,12,No,No,27919
Wyoming,2020/5/25,5.91089119,30,0,843,12,No,No,27919
Wyoming,2020/5/26,5.91089119,7,1,850,13,No,No,27919
Wyoming,2020/5/27,5.91089119,10,1,860,14,No,No,21335
Wyoming,2020/5/28,5.91089119,16,1,876,15,No,No,21335
Wyoming,2020/5/29,5.91089119,15,0,891,15,No,No,21335
Wyoming,2020/5/30,5.91089119,7,1,898,16,No,No,21335
Wyoming,2020/5/31,5.91089119,5,0,903,16,No,No,21335
Wyoming,2020/6/1,5.91089119,7,1,910,17,No,No,21335
Wyoming,2020/6/2,5.91089119,2,0,912,17,No,No,21335
Wyoming,2020/6/3,5.91089119,3,0,915,17,No,No,19949
Wyoming,2020/6/4,5.91089119,6,0,921,17,No,No,19949
Wyoming,2020/6/5,5.91089119,12,0,933,17,No,No,19949
Wyoming,2020/6/6,5.91089119,6,0,939,17,No,No,19949
Wyoming,2020/6/7,5.91089119,8,0,947,17,No,No,19949
Wyoming,2020/6/8,5.91089119,13,0,960,17,No,No,19949
Wyoming,2020/6/9,5.91089119,10,0,970,17,No,No,19949
Wyoming,2020/6/10,5.91089119,10,1,980,18,No,No,18367
Wyoming,2020/6/11,5.91089119,29,0,1009,18,No,No,18367
Wyoming,2020/6/12,5.91089119,18,0,1027,18,No,No,18367
Wyoming,2020/6/13,5.91089119,23,0,1050,18,No,No,18367
Wyoming,2020/6/14,5.91089119,10,0,1060,18,No,No,18367
Wyoming,2020/6/15,5.91089119,19,0,1079,18,No,No,18367
Wyoming,2020/6/16,5.91089119,10,0,1089,18,No,No,18367
Wyoming,2020/6/17,5.91089119,25,0,1114,18,No,No,18671
Wyoming,2020/6/18,5.91089119,30,0,1144,18,No,No,18671
Wyoming,2020/6/19,5.91089119,29,2,1173,20,No,No,18671
Wyoming,2020/6/20,5.91089119,6,0,1179,20,No,No,18671
Wyoming,2020/6/21,5.91089119,18,0,1197,20,No,No,18671
Wyoming,2020/6/22,5.91089119,33,0,1230,20,No,No,18671
Wyoming,2020/6/23,5.91089119,24,0,1254,20,No,No,18671
Wyoming,2020/6/24,5.91089119,28,0,1282,20,No,No,18338
Wyoming,2020/6/25,5.91089119,44,0,1326,20,No,No,18338
Wyoming,2020/6/26,5.91089119,42,0,1368,20,No,No,18338
Wyoming,2020/6/27,5.91089119,24,0,1392,20,No,No,18338
Wyoming,2020/6/28,5.91089119,25,0,1417,20,No,No,18338
Wyoming,2020/6/29,5.91089119,33,0,1450,20,No,No,18338
Wyoming,2020/6/30,5.91089119,37,0,1487,20,No,No,18338
Wyoming,2020/7/1,5.91089119,27,0,1514,20,No,No,19056
Wyoming,2020/7/2,5.91089119,36,0,1550,20,No,No,19056
Wyoming,2020/7/3,5.91089119,32,0,1582,20,No,No,19056
Wyoming,2020/7/4,5.91089119,24,0,1606,20,No,No,19056
Wyoming,2020/7/5,5.91089119,28,0,1634,20,No,No,19056
Wyoming,2020/7/6,5.91089119,41,0,1675,20,No,No,19056
Wyoming,2020/7/7,5.91089119,36,1,1711,21,No,No,19056
Wyoming,2020/7/8,5.91089119,29,0,1740,21,No,No,20563
Wyoming,2020/7/9,5.91089119,34,0,1774,21,No,No,20563
Wyoming,2020/7/10,5.91089119,16,0,1790,21,No,No,20563
Wyoming,2020/7/11,5.91089119,49,0,1839,21,No,No,20563
Wyoming,2020/7/12,5.91089119,23,0,1862,21,No,No,20563
Wyoming,2020/7/13,5.91089119,41,0,1903,21,No,No,20563
Wyoming,2020/7/14,5.91089119,48,1,1951,22,No,No,20563
Wyoming,2020/7/15,5.91089119,34,0,1985,22,No,No,23676
Wyoming,2020/7/16,5.91089119,41,2,2026,24,No,No,23676
Wyoming,2020/7/17,5.91089119,43,0,2069,24,No,No,23676
Wyoming,2020/7/18,5.91089119,39,0,2108,24,No,No,23676
Wyoming,2020/7/19,5.91089119,18,0,2126,24,No,No,23676
Wyoming,2020/7/20,5.91089119,61,0,2187,24,No,No,23676
Wyoming,2020/7/21,5.91089119,51,1,2238,25,No,No,23676
Wyoming,2020/7/22,5.91089119,50,0,2288,25,No,No,17437
Wyoming,2020/7/23,5.91089119,59,0,2347,25,No,No,17437
Wyoming,2020/7/24,5.91089119,58,0,2405,25,No,No,17437
Wyoming,2020/7/25,5.91089119,41,0,2446,25,No,No,17437
Wyoming,2020/7/26,5.91089119,29,0,2475,25,No,No,17437
Wyoming,2020/7/27,5.91089119,45,0,2520,25,No,No,17437
Wyoming,2020/7/28,5.91089119,69,1,2589,26,No,No,17437
Wyoming,2020/7/29,5.91089119,39,0,2628,26,No,No,11690
Wyoming,2020/7/30,5.91089119,58,0,2686,26,No,No,11690
Wyoming,2020/7/31,5.91089119,40,0,2726,26,No,No,11690
Wyoming,2020/8/1,5.91089119,43,0,2769,26,No,No,11690
Wyoming,2020/8/2,5.91089119,39,0,2808,26,No,No,11690
Wyoming,2020/8/3,5.91089119,40,1,2848,27,No,No,11690
Wyoming,2020/8/4,5.91089119,36,0,2884,27,No,No,11690
Wyoming,2020/8/5,5.91089119,39,0,2923,27,No,No,9467
Wyoming,2020/8/6,5.91089119,35,0,2958,27,No,No,9467
Wyoming,2020/8/7,5.91089119,42,1,3000,28,No,No,9467
Wyoming,2020/8/8,5.91089119,13,0,3013,28,No,No,9467
Wyoming,2020/8/9,5.91089119,37,0,3050,28,No,No,9467
Wyoming,2020/8/10,5.91089119,-8,0,3042,28,No,No,9467
Wyoming,2020/8/11,5.91089119,31,1,3073,29,No,No,9467
Wyoming,2020/8/12,5.91089119,13,0,3086,29,No,No,11047
Wyoming,2020/8/13,5.91089119,33,0,3119,29,No,No,11047
Wyoming,2020/8/14,5.91089119,64,1,3183,30,No,No,11047
Wyoming,2020/8/15,5.91089119,44,0,3227,30,No,No,11047
Wyoming,2020/8/16,5.91089119,59,0,3286,30,No,No,11047
Wyoming,2020/8/17,5.91089119,45,3,3331,33,No,No,11047
Wyoming,2020/8/18,5.91089119,29,1,3360,34,No,No,11047
Wyoming,2020/8/19,5.91089119,70,0,3430,34,No,No,8676
Wyoming,2020/8/20,5.91089119,38,0,3468,34,No,No,8676
Wyoming,2020/8/21,5.91089119,56,3,3524,37,No,No,8676
Wyoming,2020/8/22,5.91089119,19,0,3543,37,No,No,8676
Wyoming,2020/8/23,5.91089119,36,0,3579,37,No,No,8676
Wyoming,2020/8/24,5.91089119,24,0,3603,37,No,No,8676
Wyoming,2020/8/25,5.91089119,31,0,3634,37,No,No,8676
Wyoming,2020/8/26,5.91089119,50,0,3684,37,No,No,8511
Wyoming,2020/8/27,5.91089119,38,0,3722,37,No,No,8511
Wyoming,2020/8/28,5.91089119,41,0,3763,37,No,No,8511
Wyoming,2020/8/29,5.91089119,21,0,3784,37,No,No,8511
Wyoming,2020/8/30,5.91089119,36,0,3820,37,No,No,8511
Wyoming,2020/8/31,5.91089119,22,0,3842,37,No,No,8511
Wyoming,2020/9/1,5.91089119,24,4,3866,41,No,No,8511
Wyoming,2020/9/2,5.91089119,45,0,3911,41,No,No,8901
Wyoming,2020/9/3,5.91089119,28,0,3939,41,No,No,8901
Wyoming,2020/9/4,5.91089119,50,1,3989,42,No,No,8901
Wyoming,2020/9/5,5.91089119,17,0,4006,42,No,No,8901
Wyoming,2020/9/6,5.91089119,26,0,4032,42,No,No,8901
Wyoming,2020/9/7,5.91089119,0,0,4032,42,No,No,8901
Wyoming,2020/9/8,5.91089119,71,0,4103,42,No,No,8901
Wyoming,2020/9/9,5.91089119,48,0,4151,42,No,No,8848
Wyoming,2020/9/10,5.91089119,48,0,4199,42,No,No,8848
Wyoming,2020/9/11,5.91089119,65,0,4264,42,No,No,8848
Wyoming,2020/9/12,5.91089119,33,0,4297,42,No,No,8848
Wyoming,2020/9/13,5.91089119,49,0,4346,42,No,No,8848
Wyoming,2020/9/14,5.91089119,46,4,4392,46,No,No,8848
Wyoming,2020/9/15,5.91089119,46,0,4438,46,No,No,8848
Wyoming,2020/9/16,5.91089119,128,0,4566,46,No,No,8679
Wyoming,2020/9/17,5.91089119,86,3,4652,49,No,No,8679
Wyoming,2020/9/18,5.91089119,95,0,4747,49,No,No,8679
Wyoming,2020/9/19,5.91089119,33,0,4780,49,No,No,8679
Wyoming,2020/9/20,5.91089119,91,0,4871,49,No,No,8679
Wyoming,2020/9/21,5.91089119,73,0,4944,49,No,No,8679
Wyoming,2020/9/22,5.91089119,72,0,5016,49,No,No,8679
Wyoming,2020/9/23,5.91089119,153,1,5169,50,No,No,8805
Wyoming,2020/9/24,5.91089119,136,0,5305,50,No,No,8805
Wyoming,2020/9/25,5.91089119,115,0,5420,50,No,No,8805
Wyoming,2020/9/26,5.91089119,45,0,5465,50,No,No,8805
Wyoming,2020/9/27,5.91089119,168,0,5633,50,No,No,8805
Wyoming,2020/9/28,5.91089119,121,0,5754,50,No,No,8805
Wyoming,2020/9/29,5.91089119,67,0,5821,50,No,No,8805
Wyoming,2020/9/30,5.91089119,127,0,5948,50,No,No,7732
Wyoming,2020/10/1,5.91089119,135,3,6083,53,No,No,7732
Wyoming,2020/10/2,5.91089119,131,0,6214,53,No,No,7732
Wyoming,2020/10/3,5.91089119,151,0,6365,53,No,No,7732
Wyoming,2020/10/4,5.91089119,139,0,6504,53,No,No,7732
Wyoming,2020/10/5,5.91089119,125,0,6629,53,No,No,7732
Wyoming,2020/10/6,5.91089119,141,0,6770,53,No,No,7732
Wyoming,2020/10/7,5.91089119,129,0,6899,53,No,No,8581
Wyoming,2020/10/8,5.91089119,193,1,7092,54,No,No,8581
Wyoming,2020/10/9,5.91089119,243,0,7335,54,No,No,8581
Wyoming,2020/10/10,5.91089119,120,0,7455,54,No,No,8581
Wyoming,2020/10/11,5.91089119,156,0,7611,54,No,No,8581
Wyoming,2020/10/12,5.91089119,191,0,7802,54,No,No,8581
Wyoming,2020/10/13,5.91089119,162,3,7964,57,No,No,8581
Wyoming,2020/10/14,5.91089119,213,0,8177,57,No,No,7964
Wyoming,2020/10/15,5.91089119,198,0,8375,57,No,No,7964
Wyoming,2020/10/16,5.91089119,290,0,8665,57,No,No,7964
Wyoming,2020/10/17,5.91089119,151,0,8816,57,No,No,7964
Wyoming,2020/10/18,5.91089119,209,0,9025,57,No,No,7964
Wyoming,2020/10/19,5.91089119,286,0,9311,57,No,No,7964
Wyoming,2020/10/20,5.91089119,215,4,9526,61,No,No,7964
Wyoming,2020/10/21,5.91089119,322,0,9848,61,No,No,7126
Wyoming,2020/10/22,5.91089119,271,7,10119,68,No,No,7126
Wyoming,2020/10/23,5.91089119,426,0,10545,68,No,No,7126
Wyoming,2020/10/24,5.91089119,260,0,10805,68,No,No,7126
Wyoming,2020/10/25,5.91089119,236,0,11041,68,No,No,7126
Wyoming,2020/10/26,5.91089119,436,9,11477,77,No,No,7126
Wyoming,2020/10/27,5.91089119,329,0,11806,77,No,No,7126
Wyoming,2020/10/28,5.91089119,340,0,12146,77,No,No,7060
Wyoming,2020/10/29,5.91089119,361,10,12507,87,No,No,7060
Wyoming,2020/10/30,5.91089119,521,0,13028,87,No,No,7060
Wyoming,2020/10/31,5.91089119,270,0,13298,87,No,No,7060
Wyoming,2020/11/1,5.91089119,425,0,13723,87,No,No,7060
Wyoming,2020/11/2,5.91089119,444,0,14167,87,No,No,7060
Wyoming,2020/11/3,5.91089119,452,6,14619,93,No,No,7060
Wyoming,2020/11/4,5.91089119,425,12,15044,105,No,No,8764
Wyoming,2020/11/5,5.91089119,365,0,15409,105,No,No,8764
Wyoming,2020/11/6,5.91089119,996,0,16405,105,No,No,8764
Wyoming,2020/11/7,5.91089119,192,0,16597,105,No,No,8764
Wyoming,2020/11/8,5.91089119,713,9,17310,114,No,No,8764
Wyoming,2020/11/9,5.91089119,700,0,18010,114,No,No,8764
Wyoming,2020/11/10,5.91089119,1232,13,19242,127,No,No,8764
Wyoming,2020/11/11,5.91089119,132,0,19374,127,No,No,9262
Wyoming,2020/11/12,5.91089119,1105,0,20479,127,No,No,9262
Wyoming,2020/11/13,5.91089119,862,0,21341,127,No,No,9262
Wyoming,2020/11/14,5.91089119,540,17,21881,144,No,No,9262
Wyoming,2020/11/15,5.91089119,613,0,22494,144,No,No,9262
Wyoming,2020/11/16,5.91089119,699,0,23193,144,No,No,9262
Wyoming,2020/11/17,5.91089119,1260,11,24453,155,No,No,9262
Wyoming,2020/11/18,5.91089119,822,0,25275,155,No,No,11813
Wyoming,2020/11/19,5.91089119,894,21,26169,176,No,No,11813
Wyoming,2020/11/20,5.91089119,960,0,27129,176,No,No,11813
Wyoming,2020/11/21,5.91089119,281,0,27410,176,No,No,11813
Wyoming,2020/11/22,5.91089119,759,0,28169,176,No,No,11813
Wyoming,2020/11/23,5.91089119,1262,26,29431,202,No,No,11813
Wyoming,2020/11/24,5.91089119,528,0,29959,202,No,No,11813
Wyoming,2020/11/25,5.91089119,802,13,30761,215,No,No,7061
Wyoming,2020/11/26,5.91089119,0,0,30761,215,No,No,7061
Wyoming,2020/11/27,5.91089119,1012,0,31773,215,No,No,7061
Wyoming,2020/11/28,5.91089119,156,0,31929,215,No,No,7061
Wyoming,2020/11/29,5.91089119,560,0,32489,215,No,No,7061
Wyoming,2020/11/30,5.91089119,816,0,33305,215,No,No,7061
Wyoming,2020/12/1,5.91089119,500,15,33805,230,No,No,7061
Wyoming,2020/12/2,5.91089119,702,0,34507,230,No,No,7656
Wyoming,2020/12/3,5.91089119,571,27,35078,257,No,No,7656
Wyoming,2020/12/4,5.91089119,659,0,35737,257,No,No,7656
Wyoming,2020/12/5,5.91089119,204,0,35941,257,No,No,7656
Wyoming,2020/12/6,5.91089119,376,0,36317,257,No,No,7656
Wyoming,2020/12/7,5.91089119,668,23,36985,280,No,No,7656
Wyoming,2020/12/8,5.91089119,490,0,37475,280,No,No,7656
Wyoming,2020/12/9,5.91089119,410,19,37885,299,No,No,7568
Wyoming,2020/12/10,5.91089119,338,0,38223,299,No,No,7568
Wyoming,2020/12/11,5.91089119,562,22,38785,321,No,No,7568
Wyoming,2020/12/12,5.91089119,122,0,38907,321,No,No,7568
Wyoming,2020/12/13,5.91089119,453,0,39360,321,No,No,7568
Wyoming,2020/12/14,5.91089119,415,0,39775,321,No,No,7568
Wyoming,2020/12/15,5.91089119,289,7,40064,328,No,No,7568
Wyoming,2020/12/16,5.91089119,246,0,40310,328,No,No,7543
Wyoming,2020/12/17,5.91089119,283,23,40593,351,No,No,7543
Wyoming,2020/12/18,5.91089119,766,0,41359,351,No,No,7543
Wyoming,2020/12/19,5.91089119,129,0,41488,351,No,No,7543
Wyoming,2020/12/20,5.91089119,174,0,41662,351,No,No,7543
Wyoming,2020/12/21,5.91089119,456,0,42118,351,No,No,7543
Wyoming,2020/12/22,5.91089119,261,22,42379,373,No,No,7543
Wyoming,2020/12/23,5.91089119,285,0,42664,373,No,No,5506
Wyoming,2020/12/24,5.91089119,0,0,42664,373,No,No,5506
Wyoming,2020/12/25,5.91089119,0,0,42664,373,No,No,5506
Wyoming,2020/12/26,5.91089119,482,0,43146,373,No,No,5506
Wyoming,2020/12/27,5.91089119,54,0,43200,373,No,No,5506
Wyoming,2020/12/28,5.91089119,504,32,43704,405,No,No,5506
Wyoming,2020/12/29,5.91089119,219,0,43923,405,No,No,5506
Wyoming,2020/12/30,5.91089119,210,0,44133,405,No,No,10986
Wyoming,2020/12/31,5.91089119,276,33,44409,438,No,No,10986
Wyoming,2021/1/1,5.91089119,0,0,44409,438,No,No,10986
Wyoming,2021/1/2,5.91089119,164,0,44573,438,No,No,10986
Wyoming,2021/1/3,5.91089119,302,0,44875,438,No,No,10986
Wyoming,2021/1/4,5.91089119,372,0,45247,438,No,No,10986
Wyoming,2021/1/5,5.91089119,322,26,45569,464,No,No,10986
Wyoming,2021/1/6,5.91089119,321,0,45890,464,No,No,14084
Wyoming,2021/1/7,5.91089119,278,25,46168,489,No,No,14084
Wyoming,2021/1/8,5.91089119,479,0,46647,489,No,No,14084
Wyoming,2021/1/9,5.91089119,72,0,46719,489,No,No,14084
Wyoming,2021/1/10,5.91089119,113,0,46832,489,No,No,14084
Wyoming,2021/1/11,5.91089119,563,0,47395,489,No,No,14084
Wyoming,2021/1/12,5.91089119,677,33,48072,522,No,No,14084
Wyoming,2021/1/13,5.91089119,217,0,48289,522,No,No,11980
Wyoming,2021/1/14,5.91089119,412,0,48701,522,No,No,11980
Wyoming,2021/1/15,5.91089119,208,0,48909,522,No,No,11980
Wyoming,2021/1/16,5.91089119,159,0,49068,522,No,No,11980
Wyoming,2021/1/17,5.91089119,295,0,49363,522,No,No,11980
Wyoming,2021/1/18,5.91089119,345,0,49708,522,No,No,11980
Wyoming,2021/1/19,5.91089119,214,28,49922,550,No,No,11980
Wyoming,2021/1/20,5.91089119,202,0,50124,550,No,No,11615
Wyoming,2021/1/21,5.91089119,300,0,50424,550,No,No,11615
Wyoming,2021/1/22,5.91089119,159,21,50583,571,No,No,11615
Wyoming,2021/1/23,5.91089119,0,0,50583,571,No,No,11615
Wyoming,2021/1/24,5.91089119,315,0,50898,571,No,No,11615
Wyoming,2021/1/25,5.91089119,164,0,51062,571,No,No,11615
Wyoming,2021/1/26,5.91089119,90,25,51152,596,No,No,11615
Wyoming,2021/1/27,5.91089119,216,0,51368,596,No,No,12664
Wyoming,2021/1/28,5.91089119,62,0,51430,596,No,No,12664
Wyoming,2021/1/29,5.91089119,260,0,51690,596,No,No,12664
Wyoming,2021/1/30,5.91089119,14,0,51704,596,No,No,12664
Wyoming,2021/1/31,5.91089119,208,0,51912,596,No,No,12664
Wyoming,2021/2/1,5.91089119,145,0,52057,596,No,No,12664
Wyoming,2021/2/2,5.91089119,71,28,52128,624,No,No,12664
Wyoming,2021/2/3,5.91089119,160,0,52288,624,No,No,13464
Wyoming,2021/2/4,5.91089119,180,0,52468,624,No,No,13464
Wyoming,2021/2/5,5.91089119,108,0,52576,624,No,No,13464
Wyoming,2021/2/6,5.91089119,42,0,52618,624,No,No,13464
Wyoming,2021/2/7,5.91089119,9,0,52627,624,No,No,13464
Wyoming,2021/2/8,5.91089119,157,0,52784,624,No,No,13464
Wyoming,2021/2/9,5.91089119,46,23,52830,647,No,No,13464
Wyoming,2021/2/10,5.91089119,44,0,52874,647,No,No,12087
Wyoming,2021/2/11,5.91089119,105,0,52979,647,No,No,12087
Wyoming,2021/2/12,5.91089119,107,0,53086,647,No,No,12087
Wyoming,2021/2/13,5.91089119,0,0,53086,647,No,No,12087
Wyoming,2021/2/14,5.91089119,50,0,53136,647,No,No,12087
Wyoming,2021/2/15,5.91089119,0,0,53136,647,No,No,12087
Wyoming,2021/2/16,5.91089119,215,15,53351,662,No,No,12087
Wyoming,2021/2/17,5.91089119,99,0,53450,662,No,No,11395
Wyoming,2021/2/18,5.91089119,81,0,53531,662,No,No,11395
Wyoming,2021/2/19,5.91089119,152,0,53683,662,No,No,11395
Wyoming,2021/2/20,5.91089119,0,0,53683,662,No,No,11395
Wyoming,2021/2/21,5.91089119,112,0,53795,662,No,No,11395
Wyoming,2021/2/22,5.91089119,105,0,53900,662,No,No,11395
Wyoming,2021/2/23,5.91089119,44,9,53944,671,No,No,11395
Wyoming,2021/2/24,5.91089119,44,0,53988,671,No,No,11395
Wyoming,2021/2/25,5.91089119,214,0,54202,671,No,No,11395
Wyoming,2021/2/26,5.91089119,148,0,54350,671,No,No,11395
Wyoming,2021/2/27,5.91089119,0,0,54350,671,No,No,11395
Wyoming,2021/2/28,5.91089119,44,0,54394,671,No,No,11395
Wyoming,2021/3/1,5.91089119,77,0,54471,671,No,No,11395
Wyoming,2021/3/2,5.91089119,56,11,54527,682,No,No,11395
Wyoming,2021/3/3,5.91089119,89,0,54616,682,No,No,11395
Wyoming,2021/3/4,5.91089119,69,0,54685,682,No,No,11395
